month,ii,jj,count_positions,n_individuals,lat,lon,eddy_count_cyclonic,eddy_count_anticyclonic,eddy_count_total
2009-06,0,46,0,0,18.125,-86.375,0,3,3
2009-06,0,47,0,0,18.125,-86.125,0,1,1
2009-06,0,52,0,0,18.125,-84.875,1,0,1
2009-06,0,53,0,0,18.125,-84.625,4,0,4
2009-06,0,54,0,0,18.125,-84.375,1,0,1
2009-06,1,47,0,0,18.375,-86.125,0,3,3
2009-06,1,48,0,0,18.375,-85.875,0,2,2
2009-06,1,50,0,0,18.375,-85.375,1,0,1
2009-06,1,51,0,0,18.375,-85.125,2,0,2
2009-06,1,52,0,0,18.375,-84.875,3,0,3
2009-06,1,54,0,0,18.375,-84.375,6,0,6
2009-06,1,55,0,0,18.375,-84.125,2,0,2
2009-06,2,54,0,0,18.625,-84.375,1,0,1
2009-06,2,55,0,0,18.625,-84.125,2,0,2
2009-06,2,56,0,0,18.625,-83.875,6,0,6
2009-06,2,57,0,0,18.625,-83.625,1,0,1
2009-06,10,53,0,0,20.625,-84.625,0,1,1
2009-06,10,54,0,0,20.625,-84.375,0,4,4
2009-06,10,55,0,0,20.625,-84.125,0,3,3
2009-06,10,56,0,0,20.625,-83.875,0,1,1
2009-06,10,57,0,0,20.625,-83.625,0,3,3
2009-06,10,58,0,0,20.625,-83.375,0,4,4
2009-06,10,59,0,0,20.625,-83.125,0,2,2
2009-06,10,60,0,0,20.625,-82.875,0,1,1
2009-06,10,61,0,0,20.625,-82.625,0,3,3
2009-06,10,62,0,0,20.625,-82.375,0,1,1
2009-06,10,66,0,0,20.625,-81.375,1,0,1
2009-06,10,67,0,0,20.625,-81.125,5,0,5
2009-06,10,68,0,0,20.625,-80.875,1,0,1
2009-06,10,69,0,0,20.625,-80.625,1,0,1
2009-06,11,52,0,0,20.875,-84.875,0,5,5
2009-06,11,56,0,0,20.875,-83.875,0,2,2
2009-06,11,67,0,0,20.875,-81.125,3,0,3
2009-06,11,68,0,0,20.875,-80.875,5,0,5
2009-06,13,9,0,0,21.375,-95.625,0,7,7
2009-06,13,10,0,0,21.375,-95.375,0,7,7
2009-06,13,11,0,0,21.375,-95.125,0,10,10
2009-06,13,16,0,0,21.375,-93.875,6,0,6
2009-06,14,11,0,0,21.625,-95.125,0,3,3
2009-06,14,12,0,0,21.625,-94.875,0,3,3
2009-06,14,16,0,0,21.625,-93.875,6,0,6
2009-06,18,17,0,0,22.625,-93.625,1,0,1
2009-06,18,18,0,0,22.625,-93.375,2,0,2
2009-06,19,14,0,0,22.875,-94.375,1,0,1
2009-06,19,15,0,0,22.875,-94.125,2,0,2
2009-06,19,16,0,0,22.875,-93.875,3,0,3
2009-06,19,18,0,0,22.875,-93.375,3,0,3
2009-06,19,19,0,0,22.875,-93.125,5,0,5
2009-06,20,6,0,0,23.125,-96.375,5,0,5
2009-06,20,7,0,0,23.125,-96.125,4,0,4
2009-06,20,19,0,0,23.125,-93.125,1,0,1
2009-06,22,12,0,0,23.625,-94.875,1,0,1
2009-06,22,13,0,0,23.625,-94.625,1,0,1
2009-06,23,10,0,0,23.875,-95.375,1,0,1
2009-06,23,11,0,0,23.875,-95.125,2,0,2
2009-06,23,12,0,0,23.875,-94.875,1,0,1
2009-06,23,52,0,0,23.875,-84.875,9,0,9
2009-06,23,53,0,0,23.875,-84.625,8,0,8
2009-06,24,26,0,0,24.125,-91.375,1,0,1
2009-06,24,27,0,0,24.125,-91.125,1,0,1
2009-06,24,54,0,0,24.125,-84.375,12,0,12
2009-06,25,27,0,0,24.375,-91.125,1,0,1
2009-06,25,29,1,1,24.375,-90.625,0,0,0
2009-06,25,54,0,0,24.375,-84.375,1,0,1
2009-06,26,8,0,0,24.625,-95.875,0,4,4
2009-06,26,9,0,0,24.625,-95.625,0,7,7
2009-06,27,9,0,0,24.875,-95.625,0,6,6
2009-06,27,30,1,1,24.875,-90.375,0,0,0
2009-06,27,31,1,1,24.875,-90.125,0,0,0
2009-06,28,20,0,0,25.125,-92.875,0,7,7
2009-06,28,31,2,1,25.125,-90.125,0,0,0
2009-06,29,21,0,0,25.375,-92.625,0,8,8
2009-06,29,31,1,1,25.375,-90.125,0,0,0
2009-06,30,21,0,0,25.625,-92.625,0,2,2
2009-06,30,22,0,0,25.625,-92.375,0,13,13
2009-06,30,31,1,1,25.625,-90.125,0,0,0
2009-06,30,46,0,0,25.625,-86.375,0,20,20
2009-06,31,8,0,0,25.875,-95.875,10,0,10
2009-06,31,31,3,1,25.875,-90.125,0,0,0
2009-06,31,46,0,0,25.875,-86.375,0,3,3
2009-06,31,47,0,0,25.875,-86.125,0,7,7
2009-06,32,31,2,1,26.125,-90.125,0,0,0
2009-06,33,14,0,0,26.375,-94.375,1,0,1
2009-06,33,15,0,0,26.375,-94.125,12,0,12
2009-06,33,30,1,1,26.375,-90.375,0,0,0
2009-06,33,34,0,0,26.375,-89.375,3,0,3
2009-06,33,35,0,0,26.375,-89.125,3,0,3
2009-06,33,36,0,0,26.375,-88.875,1,0,1
2009-06,33,37,0,0,26.375,-88.625,8,0,8
2009-06,34,23,2,1,26.625,-92.125,0,0,0
2009-06,34,24,1,1,26.625,-91.875,0,0,0
2009-06,34,35,0,0,26.625,-89.125,10,0,10
2009-06,34,36,0,0,26.625,-88.875,3,0,3
2009-06,34,37,0,0,26.625,-88.625,2,0,2
2009-06,35,24,1,1,26.875,-91.875,0,0,0
2009-06,35,26,1,1,26.875,-91.375,0,0,0
2009-06,35,29,1,1,26.875,-90.625,0,0,0
2009-06,36,24,6,1,27.125,-91.875,0,0,0
2009-06,36,29,1,1,27.125,-90.625,0,0,0
2009-06,37,25,1,1,27.375,-91.625,0,0,0
2009-06,37,28,1,1,27.375,-90.875,0,0,0
2009-06,37,29,1,1,27.375,-90.625,0,0,0
2009-06,38,23,1,1,27.625,-92.125,0,0,0
2009-06,38,24,1,1,27.625,-91.875,0,0,0
2009-06,38,26,2,1,27.625,-91.375,0,0,0
2009-06,38,27,1,1,27.625,-91.125,0,0,0
2009-06,38,45,0,0,27.625,-86.625,2,0,2
2009-06,38,46,0,0,27.625,-86.375,4,0,4
2009-06,39,28,2,1,27.875,-90.875,0,0,0
2009-06,40,28,4,2,28.125,-90.875,0,0,0
2009-06,42,38,0,0,28.625,-88.375,0,2,2
2009-06,42,39,0,0,28.625,-88.125,0,1,1
2009-06,43,37,0,0,28.875,-88.625,0,1,1
2009-06,43,38,0,0,28.875,-88.375,0,2,2
2009-06,43,39,0,0,28.875,-88.125,0,2,2
2009-06,44,40,0,0,29.125,-87.875,0,3,3
2009-06,44,41,0,0,29.125,-87.625,0,17,17
2009-07,0,46,0,0,18.125,-86.375,4,0,4
2009-07,0,47,0,0,18.125,-86.125,4,0,4
2009-07,0,52,0,0,18.125,-84.875,0,1,1
2009-07,0,53,0,0,18.125,-84.625,0,1,1
2009-07,1,47,0,0,18.375,-86.125,1,0,1
2009-07,1,48,0,0,18.375,-85.875,4,0,4
2009-07,1,49,0,0,18.375,-85.625,5,0,5
2009-07,1,50,0,0,18.375,-85.375,2,0,2
2009-07,1,71,0,0,18.375,-80.125,0,3,3
2009-07,2,54,0,0,18.625,-84.375,0,2,2
2009-07,2,56,0,0,18.625,-83.875,0,1,1
2009-07,2,71,0,0,18.625,-80.125,0,3,3
2009-07,3,53,0,0,18.875,-84.625,0,1,1
2009-07,3,54,0,0,18.875,-84.375,0,2,2
2009-07,3,56,0,0,18.875,-83.875,0,2,2
2009-07,3,57,0,0,18.875,-83.625,0,4,4
2009-07,3,70,0,0,18.875,-80.375,0,5,5
2009-07,3,71,0,0,18.875,-80.125,0,1,1
2009-07,5,63,0,0,19.375,-82.125,3,0,3
2009-07,5,64,0,0,19.375,-81.875,2,0,2
2009-07,6,62,0,0,19.625,-82.375,3,0,3
2009-07,6,63,0,0,19.625,-82.125,1,0,1
2009-07,6,65,0,0,19.625,-81.625,3,0,3
2009-07,6,66,0,0,19.625,-81.375,4,0,4
2009-07,7,62,0,0,19.875,-82.375,1,0,1
2009-07,7,66,0,0,19.875,-81.375,2,0,2
2009-07,7,67,0,0,19.875,-81.125,1,0,1
2009-07,8,66,0,0,20.125,-81.375,1,0,1
2009-07,9,55,0,0,20.375,-84.125,0,1,1
2009-07,10,54,0,0,20.625,-84.375,0,1,1
2009-07,10,62,0,0,20.625,-82.375,2,0,2
2009-07,10,66,0,0,20.625,-81.375,6,0,6
2009-07,11,7,0,0,20.875,-96.125,0,4,4
2009-07,11,8,0,0,20.875,-95.875,0,7,7
2009-07,11,13,0,0,20.875,-94.625,1,0,1
2009-07,11,52,0,0,20.875,-84.875,0,1,1
2009-07,11,53,0,0,20.875,-84.625,0,3,3
2009-07,11,54,0,0,20.875,-84.375,0,1,1
2009-07,12,6,0,0,21.125,-96.375,0,2,2
2009-07,12,7,0,0,21.125,-96.125,0,4,4
2009-07,12,8,0,0,21.125,-95.875,0,9,9
2009-07,12,9,0,0,21.125,-95.625,0,2,2
2009-07,12,53,0,0,21.125,-84.625,0,1,1
2009-07,13,9,0,0,21.375,-95.625,0,2,2
2009-07,13,14,0,0,21.375,-94.375,1,0,1
2009-07,13,15,0,0,21.375,-94.125,2,0,2
2009-07,13,16,0,0,21.375,-93.875,1,0,1
2009-07,14,15,0,0,21.625,-94.125,6,0,6
2009-07,14,16,0,0,21.625,-93.875,2,0,2
2009-07,18,13,0,0,22.625,-94.625,0,3,3
2009-07,19,13,0,0,22.875,-94.625,0,4,4
2009-07,19,14,0,0,22.875,-94.375,0,2,2
2009-07,20,14,0,0,23.125,-94.375,0,5,5
2009-07,21,47,0,0,23.375,-86.125,1,0,1
2009-07,21,48,0,0,23.375,-85.875,6,0,6
2009-07,21,49,0,0,23.375,-85.625,5,0,5
2009-07,21,50,0,0,23.375,-85.375,2,0,2
2009-07,22,48,0,0,23.625,-85.875,1,0,1
2009-07,22,50,0,0,23.625,-85.375,5,0,5
2009-07,22,51,0,0,23.625,-85.125,4,0,4
2009-07,23,8,0,0,23.875,-95.875,4,0,4
2009-07,23,9,0,0,23.875,-95.625,4,0,4
2009-07,23,10,0,0,23.875,-95.375,1,0,1
2009-07,23,19,0,0,23.875,-93.125,1,0,1
2009-07,23,20,0,0,23.875,-92.875,3,0,3
2009-07,23,21,0,0,23.875,-92.625,3,0,3
2009-07,23,22,0,0,23.875,-92.375,2,0,2
2009-07,23,23,0,0,23.875,-92.125,5,0,5
2009-07,23,24,0,0,23.875,-91.875,5,0,5
2009-07,23,25,0,0,23.875,-91.625,6,0,6
2009-07,23,26,0,0,23.875,-91.375,4,0,4
2009-07,23,48,0,0,23.875,-85.875,1,0,1
2009-07,23,51,0,0,23.875,-85.125,2,0,2
2009-07,23,52,0,0,23.875,-84.875,4,0,4
2009-07,23,56,0,0,23.875,-83.875,0,2,2
2009-07,24,9,0,0,24.125,-95.625,3,0,3
2009-07,24,10,0,0,24.125,-95.375,3,0,3
2009-07,24,17,0,0,24.125,-93.625,0,2,2
2009-07,24,26,0,0,24.125,-91.375,2,0,2
2009-07,25,2,8,1,24.375,-97.375,0,0,0
2009-07,25,3,2,1,24.375,-97.125,0,0,0
2009-07,25,17,0,0,24.375,-93.625,0,3,3
2009-07,25,18,0,0,24.375,-93.375,0,1,1
2009-07,25,29,4,1,24.375,-90.625,0,0,0
2009-07,26,2,3,1,24.625,-97.375,0,0,0
2009-07,26,3,1,1,24.625,-97.125,0,0,0
2009-07,26,18,0,0,24.625,-93.375,0,4,4
2009-07,26,60,0,0,24.625,-82.875,1,0,1
2009-07,26,61,0,0,24.625,-82.625,3,0,3
2009-07,27,3,3,1,24.875,-97.125,0,0,0
2009-07,27,19,0,0,24.875,-93.125,0,5,5
2009-07,27,29,1,1,24.875,-90.625,0,0,0
2009-07,27,61,0,0,24.875,-82.625,1,0,1
2009-07,28,20,0,0,25.125,-92.875,0,2,2
2009-07,28,30,1,1,25.125,-90.375,0,0,0
2009-07,29,4,1,1,25.375,-96.875,0,0,0
2009-07,30,20,0,0,25.625,-92.875,0,5,5
2009-07,30,31,2,1,25.625,-90.125,0,0,0
2009-07,30,42,0,0,25.625,-87.375,0,4,4
2009-07,30,43,0,0,25.625,-87.125,0,9,9
2009-07,30,44,0,0,25.625,-86.875,0,4,4
2009-07,30,45,0,0,25.625,-86.625,0,6,6
2009-07,30,46,0,0,25.625,-86.375,0,8,8
2009-07,30,51,0,0,25.625,-85.125,1,0,1
2009-07,31,5,1,1,25.875,-96.625,0,0,0
2009-07,31,20,0,0,25.875,-92.875,0,5,5
2009-07,31,21,0,0,25.875,-92.625,0,2,2
2009-07,31,31,1,1,25.875,-90.125,0,0,0
2009-07,31,32,1,1,25.875,-89.875,0,0,0
2009-07,31,52,0,0,25.875,-84.875,1,0,1
2009-07,31,53,0,0,25.875,-84.625,1,0,1
2009-07,32,10,0,0,26.125,-95.375,0,1,1
2009-07,32,21,0,0,26.125,-92.625,0,2,2
2009-07,32,30,0,0,26.125,-90.375,5,0,5
2009-07,32,31,0,0,26.125,-90.125,1,0,1
2009-07,32,32,2,1,26.125,-89.875,0,0,0
2009-07,32,52,0,0,26.125,-84.875,2,0,2
2009-07,33,6,1,1,26.375,-96.375,0,0,0
2009-07,33,10,0,0,26.375,-95.375,0,10,10
2009-07,33,11,0,0,26.375,-95.125,0,9,9
2009-07,33,15,0,0,26.375,-94.125,10,0,10
2009-07,33,17,0,0,26.375,-93.625,3,0,3
2009-07,33,30,0,0,26.375,-90.375,1,0,1
2009-07,33,31,2,1,26.375,-90.125,0,0,0
2009-07,33,34,0,0,26.375,-89.375,11,0,11
2009-07,33,35,0,0,26.375,-89.125,1,0,1
2009-07,34,9,1,1,26.625,-95.625,0,0,0
2009-07,34,10,0,0,26.625,-95.375,0,3,3
2009-07,34,16,0,0,26.625,-93.875,15,0,15
2009-07,34,17,0,0,26.625,-93.625,3,0,3
2009-07,34,31,2,1,26.625,-90.125,0,0,0
2009-07,34,32,3,1,26.625,-89.875,0,0,0
2009-07,34,35,0,0,26.625,-89.125,7,0,7
2009-07,34,51,0,0,26.625,-85.125,1,0,1
2009-07,34,52,0,0,26.625,-84.875,2,0,2
2009-07,35,11,1,1,26.875,-95.125,0,0,0
2009-07,35,32,1,1,26.875,-89.875,0,0,0
2009-07,35,35,0,0,26.875,-89.125,5,0,5
2009-07,35,51,0,0,26.875,-85.125,3,0,3
2009-07,36,13,1,1,27.125,-94.625,0,0,0
2009-07,36,49,0,0,27.125,-85.625,1,0,1
2009-07,36,50,0,0,27.125,-85.375,4,0,4
2009-07,37,14,1,1,27.375,-94.375,0,0,0
2009-07,37,16,1,1,27.375,-93.875,0,0,0
2009-07,37,32,1,1,27.375,-89.875,0,0,0
2009-07,37,38,0,0,27.375,-88.375,2,0,2
2009-07,37,39,0,0,27.375,-88.125,2,0,2
2009-07,37,40,0,0,27.375,-87.875,2,0,2
2009-07,37,48,0,0,27.375,-85.875,1,0,1
2009-07,37,49,0,0,27.375,-85.625,3,0,3
2009-07,38,18,1,1,27.625,-93.375,0,0,0
2009-07,38,20,1,1,27.625,-92.875,0,0,0
2009-07,38,21,2,1,27.625,-92.625,0,0,0
2009-07,38,22,1,1,27.625,-92.375,0,0,0
2009-07,38,33,1,1,27.625,-89.625,0,0,0
2009-07,38,40,0,0,27.625,-87.875,1,0,1
2009-07,38,46,0,0,27.625,-86.375,4,0,4
2009-07,38,47,0,0,27.625,-86.125,4,0,4
2009-07,38,48,0,0,27.625,-85.875,1,0,1
2009-07,39,20,1,1,27.875,-92.875,0,0,0
2009-07,39,34,1,1,27.875,-89.375,0,0,0
2009-07,40,30,0,0,28.125,-90.375,0,3,3
2009-07,40,31,0,0,28.125,-90.125,0,4,4
2009-07,40,32,0,0,28.125,-89.875,0,3,3
2009-07,41,36,1,1,28.375,-88.875,0,0,0
2009-07,42,39,3,1,28.625,-88.125,0,0,0
2009-07,42,40,1,1,28.625,-87.875,0,0,0
2009-07,42,41,1,1,28.625,-87.625,0,0,0
2009-07,43,37,0,0,28.875,-88.625,0,2,2
2009-07,43,42,1,1,28.875,-87.375,0,0,0
2009-07,45,46,1,1,29.375,-86.375,0,0,0
2009-08,0,50,0,0,18.125,-85.375,0,3,3
2009-08,0,51,0,0,18.125,-85.125,0,8,8
2009-08,0,67,0,0,18.125,-81.125,3,0,3
2009-08,0,69,0,0,18.125,-80.625,1,0,1
2009-08,0,70,0,0,18.125,-80.375,2,0,2
2009-08,0,71,0,0,18.125,-80.125,4,0,4
2009-08,1,47,0,0,18.375,-86.125,0,1,1
2009-08,1,48,0,0,18.375,-85.875,0,4,4
2009-08,1,49,0,0,18.375,-85.625,0,4,4
2009-08,1,50,0,0,18.375,-85.375,0,1,1
2009-08,1,51,0,0,18.375,-85.125,0,1,1
2009-08,1,53,0,0,18.375,-84.625,0,1,1
2009-08,1,54,0,0,18.375,-84.375,0,1,1
2009-08,1,67,0,0,18.375,-81.125,1,0,1
2009-08,2,53,0,0,18.625,-84.625,0,3,3
2009-08,2,54,0,0,18.625,-84.375,0,2,2
2009-08,2,67,0,0,18.625,-81.125,1,0,1
2009-08,3,67,0,0,18.875,-81.125,2,0,2
2009-08,4,66,0,0,19.125,-81.375,5,0,5
2009-08,4,69,0,0,19.125,-80.625,0,1,1
2009-08,4,70,0,0,19.125,-80.375,0,7,7
2009-08,4,71,0,0,19.125,-80.125,0,5,5
2009-08,5,51,0,0,19.375,-85.125,1,0,1
2009-08,5,65,0,0,19.375,-81.625,3,0,3
2009-08,6,51,0,0,19.625,-85.125,6,0,6
2009-08,6,52,0,0,19.625,-84.875,2,0,2
2009-08,7,50,0,0,19.875,-85.375,2,0,2
2009-08,7,51,0,0,19.875,-85.125,6,0,6
2009-08,8,50,0,0,20.125,-85.375,10,0,10
2009-08,8,51,0,0,20.125,-85.125,1,0,1
2009-08,10,53,0,0,20.625,-84.625,0,2,2
2009-08,10,61,0,0,20.625,-82.625,1,0,1
2009-08,10,63,0,0,20.625,-82.125,0,1,1
2009-08,10,64,0,0,20.625,-81.875,0,1,1
2009-08,11,52,0,0,20.875,-84.875,0,2,2
2009-08,11,53,0,0,20.875,-84.625,0,7,7
2009-08,11,58,0,0,20.875,-83.375,7,0,7
2009-08,11,59,0,0,20.875,-83.125,10,0,10
2009-08,11,60,0,0,20.875,-82.875,11,0,11
2009-08,11,61,0,0,20.875,-82.625,1,0,1
2009-08,11,64,0,0,20.875,-81.875,0,1,1
2009-08,12,53,0,0,21.125,-84.625,0,11,11
2009-08,13,52,0,0,21.375,-84.875,0,4,4
2009-08,13,53,0,0,21.375,-84.625,0,4,4
2009-08,14,10,0,0,21.625,-95.375,0,6,6
2009-08,15,11,0,0,21.875,-95.125,0,8,8
2009-08,15,12,0,0,21.875,-94.875,0,2,2
2009-08,16,12,0,0,22.125,-94.875,0,4,4
2009-08,16,13,0,0,22.125,-94.625,0,1,1
2009-08,17,13,0,0,22.375,-94.625,0,6,6
2009-08,18,2,2,1,22.625,-97.375,0,0,0
2009-08,18,13,0,0,22.625,-94.625,0,4,4
2009-08,19,2,3,1,22.875,-97.375,0,0,0
2009-08,19,3,1,1,22.875,-97.125,0,0,0
2009-08,20,2,2,1,23.125,-97.375,0,0,0
2009-08,20,4,1,1,23.125,-96.875,0,0,0
2009-08,21,2,5,1,23.375,-97.375,0,0,0
2009-08,21,4,1,1,23.375,-96.875,0,0,0
2009-08,21,5,1,1,23.375,-96.625,0,0,0
2009-08,21,15,0,0,23.375,-94.125,2,0,2
2009-08,21,16,0,0,23.375,-93.875,1,0,1
2009-08,22,2,1,1,23.625,-97.375,0,0,0
2009-08,22,5,1,1,23.625,-96.625,0,0,0
2009-08,22,15,0,0,23.625,-94.125,4,0,4
2009-08,22,16,0,0,23.625,-93.875,3,0,3
2009-08,23,2,3,1,23.875,-97.375,0,0,0
2009-08,23,6,1,1,23.875,-96.375,0,0,0
2009-08,23,16,0,0,23.875,-93.875,4,0,4
2009-08,23,17,0,0,23.875,-93.625,4,0,4
2009-08,23,18,0,0,23.875,-93.375,5,0,5
2009-08,23,19,0,0,23.875,-93.125,2,0,2
2009-08,23,28,0,0,23.875,-90.875,0,1,1
2009-08,23,29,0,0,23.875,-90.625,0,14,14
2009-08,23,46,0,0,23.875,-86.375,4,0,4
2009-08,23,47,0,0,23.875,-86.125,10,0,10
2009-08,23,48,0,0,23.875,-85.875,4,0,4
2009-08,23,56,0,0,23.875,-83.875,0,27,27
2009-08,23,63,0,0,23.875,-82.125,4,0,4
2009-08,23,64,0,0,23.875,-81.875,11,0,11
2009-08,24,2,2,1,24.125,-97.375,0,0,0
2009-08,24,6,1,1,24.125,-96.375,0,0,0
2009-08,24,48,0,0,24.125,-85.875,11,0,11
2009-08,24,55,0,0,24.125,-84.125,0,1,1
2009-08,24,64,0,0,24.125,-81.875,8,0,8
2009-08,25,2,1,1,24.375,-97.375,0,0,0
2009-08,25,62,0,0,24.375,-82.375,1,0,1
2009-08,25,63,0,0,24.375,-82.125,1,0,1
2009-08,26,2,1,1,24.625,-97.375,0,0,0
2009-08,26,3,4,1,24.625,-97.125,0,0,0
2009-08,26,54,0,0,24.625,-84.375,0,1,1
2009-08,26,62,0,0,24.625,-82.375,1,0,1
2009-08,27,54,0,0,24.875,-84.375,0,2,2
2009-08,27,61,0,0,24.875,-82.625,4,0,4
2009-08,27,62,0,0,24.875,-82.375,1,0,1
2009-08,29,36,0,0,25.375,-88.875,0,2,2
2009-08,29,37,0,0,25.375,-88.625,0,10,10
2009-08,29,38,0,0,25.375,-88.375,0,6,6
2009-08,29,39,0,0,25.375,-88.125,0,2,2
2009-08,29,40,0,0,25.375,-87.875,0,2,2
2009-08,29,41,0,0,25.375,-87.625,0,2,2
2009-08,30,30,0,0,25.625,-90.375,8,0,8
2009-08,30,41,0,0,25.625,-87.625,0,3,3
2009-08,30,42,0,0,25.625,-87.375,0,4,4
2009-08,31,21,0,0,25.875,-92.625,0,1,1
2009-08,31,29,0,0,25.875,-90.625,4,0,4
2009-08,31,30,0,0,25.875,-90.375,3,0,3
2009-08,32,21,0,0,26.125,-92.625,0,22,22
2009-08,32,28,0,0,26.125,-90.875,11,0,11
2009-08,32,29,0,0,26.125,-90.625,5,0,5
2009-08,32,44,0,0,26.125,-86.875,3,0,3
2009-08,33,11,0,0,26.375,-95.125,0,24,24
2009-08,33,12,0,0,26.375,-94.875,0,2,2
2009-08,33,13,0,0,26.375,-94.625,0,5,5
2009-08,33,17,0,0,26.375,-93.625,3,0,3
2009-08,33,21,0,0,26.375,-92.625,0,3,3
2009-08,33,44,0,0,26.375,-86.875,5,0,5
2009-08,34,45,0,0,26.625,-86.625,2,0,2
2009-08,35,44,0,0,26.875,-86.875,2,0,2
2009-08,36,43,0,0,27.125,-87.125,1,0,1
2009-08,36,44,0,0,27.125,-86.875,1,0,1
2009-08,37,42,0,0,27.375,-87.375,2,0,2
2009-08,37,43,0,0,27.375,-87.125,1,0,1
2009-08,38,39,0,0,27.625,-88.125,1,0,1
2009-08,38,40,0,0,27.625,-87.875,7,0,7
2009-08,38,41,0,0,27.625,-87.625,3,0,3
2009-08,38,42,0,0,27.625,-87.375,1,0,1
2009-08,40,29,0,0,28.125,-90.625,0,3,3
2009-08,40,30,0,0,28.125,-90.375,0,1,1
2009-08,41,21,0,0,28.375,-92.625,0,1,1
2009-08,41,22,0,0,28.375,-92.375,0,3,3
2009-08,41,23,0,0,28.375,-92.125,0,3,3
2009-08,41,27,0,0,28.375,-91.125,0,2,2
2009-08,41,28,0,0,28.375,-90.875,0,2,2
2009-08,41,29,0,0,28.375,-90.625,0,1,1
2009-08,45,47,1,1,29.375,-86.125,0,0,0
2009-09,2,44,0,0,18.625,-86.875,0,4,4
2009-09,2,45,0,0,18.625,-86.625,0,4,4
2009-09,2,46,0,0,18.625,-86.375,0,7,7
2009-09,2,47,0,0,18.625,-86.125,0,1,1
2009-09,5,46,0,0,19.375,-86.375,0,1,1
2009-09,5,51,0,0,19.375,-85.125,1,0,1
2009-09,5,65,0,0,19.375,-81.625,2,0,2
2009-09,5,71,0,0,19.375,-80.125,6,0,6
2009-09,6,17,0,0,19.625,-93.625,1,0,1
2009-09,6,51,0,0,19.625,-85.125,3,0,3
2009-09,6,65,0,0,19.625,-81.625,7,0,7
2009-09,7,18,0,0,19.875,-93.375,8,0,8
2009-09,7,19,0,0,19.875,-93.125,1,0,1
2009-09,7,50,0,0,19.875,-85.375,1,0,1
2009-09,7,51,0,0,19.875,-85.125,1,0,1
2009-09,8,18,0,0,20.125,-93.375,9,0,9
2009-09,9,61,0,0,20.375,-82.625,0,3,3
2009-09,9,64,0,0,20.375,-81.875,0,3,3
2009-09,9,68,0,0,20.375,-80.875,0,1,1
2009-09,10,51,0,0,20.625,-85.125,0,1,1
2009-09,10,55,0,0,20.625,-84.125,4,0,4
2009-09,10,56,0,0,20.625,-83.875,4,0,4
2009-09,10,57,0,0,20.625,-83.625,13,0,13
2009-09,10,64,0,0,20.625,-81.875,0,2,2
2009-09,10,65,0,0,20.625,-81.625,0,3,3
2009-09,10,66,0,0,20.625,-81.375,0,5,5
2009-09,10,67,0,0,20.625,-81.125,0,1,1
2009-09,11,48,0,0,20.875,-85.875,0,4,4
2009-09,11,49,0,0,20.875,-85.625,0,1,1
2009-09,11,50,0,0,20.875,-85.375,0,2,2
2009-09,11,51,0,0,20.875,-85.125,0,1,1
2009-09,11,52,0,0,20.875,-84.875,0,1,1
2009-09,11,57,0,0,20.875,-83.625,7,0,7
2009-09,11,58,0,0,20.875,-83.375,2,0,2
2009-09,11,64,0,0,20.875,-81.875,0,1,1
2009-09,11,65,0,0,20.875,-81.625,0,6,6
2009-09,12,48,0,0,21.125,-85.875,0,3,3
2009-09,14,7,0,0,21.625,-96.125,0,7,7
2009-09,14,8,0,0,21.625,-95.875,0,10,10
2009-09,14,9,0,0,21.625,-95.625,0,7,7
2009-09,14,10,0,0,21.625,-95.375,0,6,6
2009-09,18,41,0,0,22.625,-87.625,0,1,1
2009-09,18,42,0,0,22.625,-87.375,0,1,1
2009-09,19,29,0,0,22.875,-90.625,1,0,1
2009-09,19,30,0,0,22.875,-90.375,1,0,1
2009-09,19,41,0,0,22.875,-87.625,0,4,4
2009-09,19,42,0,0,22.875,-87.375,0,5,5
2009-09,20,30,0,0,23.125,-90.375,15,0,15
2009-09,20,41,0,0,23.125,-87.625,0,4,4
2009-09,21,12,0,0,23.375,-94.875,2,0,2
2009-09,21,13,0,0,23.375,-94.625,5,0,5
2009-09,21,14,0,0,23.375,-94.375,6,0,6
2009-09,21,15,0,0,23.375,-94.125,7,0,7
2009-09,21,30,0,0,23.375,-90.375,6,0,6
2009-09,21,41,0,0,23.375,-87.625,0,5,5
2009-09,22,30,0,0,23.625,-90.375,2,0,2
2009-09,23,27,0,0,23.875,-91.125,0,2,2
2009-09,23,28,0,0,23.875,-90.875,0,10,10
2009-09,23,39,0,0,23.875,-88.125,0,1,1
2009-09,23,65,0,0,23.875,-81.625,4,0,4
2009-09,23,66,0,0,23.875,-81.375,2,0,2
2009-09,23,67,0,0,23.875,-81.125,1,0,1
2009-09,23,68,0,0,23.875,-80.875,2,0,2
2009-09,24,27,0,0,24.125,-91.125,0,2,2
2009-09,24,28,0,0,24.125,-90.875,0,1,1
2009-09,24,70,0,0,24.125,-80.375,4,0,4
2009-09,24,71,0,0,24.125,-80.125,5,0,5
2009-09,25,7,1,1,24.375,-96.125,0,0,0
2009-09,25,8,1,1,24.375,-95.875,0,0,0
2009-09,25,71,0,0,24.375,-80.125,1,0,1
2009-09,26,8,1,1,24.625,-95.875,0,0,0
2009-09,26,9,2,1,24.625,-95.625,0,0,0
2009-09,26,46,0,0,24.625,-86.375,10,0,10
2009-09,26,54,0,0,24.625,-84.375,0,3,3
2009-09,26,55,0,0,24.625,-84.125,0,7,7
2009-09,27,9,4,1,24.875,-95.625,0,0,0
2009-09,27,10,2,1,24.875,-95.375,0,0,0
2009-09,27,45,0,0,24.875,-86.625,1,0,1
2009-09,27,46,0,0,24.875,-86.375,4,0,4
2009-09,27,54,0,0,24.875,-84.375,0,20,20
2009-09,28,9,2,1,25.125,-95.625,0,0,0
2009-09,28,45,0,0,25.125,-86.625,14,0,14
2009-09,29,8,1,1,25.375,-95.875,0,0,0
2009-09,29,36,0,0,25.375,-88.875,0,9,9
2009-09,30,34,0,0,25.625,-89.375,0,11,11
2009-09,30,35,0,0,25.625,-89.125,0,10,10
2009-09,31,9,1,1,25.875,-95.625,0,0,0
2009-09,31,12,0,0,25.875,-94.875,0,1,1
2009-09,32,10,1,1,26.125,-95.375,0,0,0
2009-09,32,12,0,0,26.125,-94.875,0,11,11
2009-09,32,26,0,0,26.125,-91.375,6,0,6
2009-09,32,27,0,0,26.125,-91.125,7,0,7
2009-09,32,28,0,0,26.125,-90.875,2,0,2
2009-09,33,9,1,1,26.375,-95.625,0,0,0
2009-09,33,12,0,0,26.375,-94.875,0,17,17
2009-09,33,13,0,0,26.375,-94.625,0,1,1
2009-09,33,25,0,0,26.375,-91.625,4,0,4
2009-09,33,26,0,0,26.375,-91.375,6,0,6
2009-09,34,9,1,1,26.625,-95.625,0,0,0
2009-09,34,26,0,0,26.625,-91.375,5,0,5
2009-09,35,9,1,1,26.875,-95.625,0,0,0
2009-09,35,10,2,1,26.875,-95.375,0,0,0
2009-09,35,11,6,1,26.875,-95.125,0,0,0
2009-09,36,10,1,1,27.125,-95.375,0,0,0
2009-09,36,11,1,1,27.125,-95.125,0,0,0
2009-09,36,16,0,0,27.125,-93.875,7,0,7
2009-09,37,10,1,1,27.375,-95.375,0,0,0
2009-09,37,16,0,0,27.375,-93.875,7,0,7
2009-09,37,17,0,0,27.375,-93.625,1,0,1
2009-09,38,17,0,0,27.625,-93.625,4,0,4
2009-09,39,16,0,0,27.875,-93.875,2,0,2
2009-09,39,41,0,0,27.875,-87.625,1,0,1
2009-09,40,16,0,0,28.125,-93.875,5,0,5
2009-09,41,16,0,0,28.375,-93.875,1,0,1
2009-10,0,60,0,0,18.125,-82.875,0,6,6
2009-10,0,61,0,0,18.125,-82.625,0,3,3
2009-10,0,63,0,0,18.125,-82.125,0,1,1
2009-10,0,64,0,0,18.125,-81.875,0,2,2
2009-10,1,48,0,0,18.375,-85.875,4,0,4
2009-10,1,49,0,0,18.375,-85.625,3,0,3
2009-10,2,49,0,0,18.625,-85.625,2,0,2
2009-10,2,50,0,0,18.625,-85.375,2,0,2
2009-10,3,68,0,0,18.875,-80.875,3,0,3
2009-10,3,69,0,0,18.875,-80.625,3,0,3
2009-10,3,70,0,0,18.875,-80.375,3,0,3
2009-10,3,71,0,0,18.875,-80.125,2,0,2
2009-10,4,62,0,0,19.125,-82.375,1,0,1
2009-10,4,63,0,0,19.125,-82.125,2,0,2
2009-10,4,64,0,0,19.125,-81.875,3,0,3
2009-10,4,65,0,0,19.125,-81.625,2,0,2
2009-10,4,66,0,0,19.125,-81.375,3,0,3
2009-10,4,67,0,0,19.125,-81.125,2,0,2
2009-10,6,60,0,0,19.625,-82.875,2,0,2
2009-10,8,18,0,0,20.125,-93.375,1,0,1
2009-10,9,18,0,0,20.375,-93.375,7,0,7
2009-10,9,63,0,0,20.375,-82.125,0,2,2
2009-10,10,18,0,0,20.625,-93.375,8,0,8
2009-10,10,54,0,0,20.625,-84.375,3,0,3
2009-10,10,55,0,0,20.625,-84.125,11,0,11
2009-10,10,63,0,0,20.625,-82.125,0,11,11
2009-10,10,64,0,0,20.625,-81.875,0,17,17
2009-10,10,69,0,0,20.625,-80.625,1,0,1
2009-10,11,18,0,0,20.875,-93.375,1,0,1
2009-10,11,55,0,0,20.875,-84.125,4,0,4
2009-10,11,69,0,0,20.875,-80.625,1,0,1
2009-10,12,56,0,0,21.125,-83.875,4,0,4
2009-10,12,57,0,0,21.125,-83.625,3,0,3
2009-10,13,58,0,0,21.375,-83.375,1,0,1
2009-10,14,6,0,0,21.625,-96.375,0,9,9
2009-10,14,7,0,0,21.625,-96.125,0,9,9
2009-10,15,6,0,0,21.875,-96.375,0,8,8
2009-10,15,7,0,0,21.875,-96.125,0,5,5
2009-10,19,10,0,0,22.875,-95.375,2,0,2
2009-10,19,11,0,0,22.875,-95.125,8,0,8
2009-10,19,42,0,0,22.875,-87.375,0,4,4
2009-10,20,9,0,0,23.125,-95.625,3,0,3
2009-10,20,10,0,0,23.125,-95.375,1,0,1
2009-10,20,30,0,0,23.125,-90.375,4,0,4
2009-10,20,41,0,0,23.125,-87.625,0,2,2
2009-10,20,42,0,0,23.125,-87.375,0,1,1
2009-10,21,9,0,0,23.375,-95.625,2,0,2
2009-10,21,10,0,0,23.375,-95.375,5,0,5
2009-10,21,11,0,0,23.375,-95.125,6,0,6
2009-10,21,12,0,0,23.375,-94.875,4,0,4
2009-10,21,30,0,0,23.375,-90.375,3,0,3
2009-10,22,30,0,0,23.625,-90.375,4,0,4
2009-10,22,31,0,0,23.625,-90.125,2,0,2
2009-10,23,30,0,0,23.875,-90.375,4,0,4
2009-10,23,55,0,0,23.875,-84.125,0,1,1
2009-10,24,55,0,0,24.125,-84.125,0,4,4
2009-10,24,56,0,0,24.125,-83.875,0,8,8
2009-10,25,55,0,0,24.375,-84.125,0,8,8
2009-10,25,56,0,0,24.375,-83.875,0,3,3
2009-10,26,55,0,0,24.625,-84.125,0,6,6
2009-10,26,56,0,0,24.625,-83.875,0,1,1
2009-10,27,32,0,0,24.875,-89.875,0,8,8
2009-10,27,33,0,0,24.875,-89.625,0,3,3
2009-10,27,45,0,0,24.875,-86.625,11,0,11
2009-10,28,33,0,0,25.125,-89.625,0,5,5
2009-10,28,34,0,0,25.125,-89.375,0,6,6
2009-10,28,45,0,0,25.125,-86.625,20,0,20
2009-10,29,34,0,0,25.375,-89.375,0,8,8
2009-10,30,8,0,0,25.625,-95.875,0,11,11
2009-10,30,9,0,0,25.625,-95.625,0,5,5
2009-10,30,16,0,0,25.625,-93.875,4,0,4
2009-10,30,17,0,0,25.625,-93.625,4,0,4
2009-10,30,34,0,0,25.625,-89.375,0,1,1
2009-10,31,8,0,0,25.875,-95.875,0,13,13
2009-10,31,18,0,0,25.875,-93.375,1,0,1
2009-10,32,9,0,0,26.125,-95.625,0,2,2
2009-10,32,24,3,1,26.125,-91.875,0,0,0
2009-10,34,23,1,1,26.625,-92.125,0,0,0
2009-10,34,25,0,0,26.625,-91.625,9,0,9
2009-10,34,26,0,0,26.625,-91.375,17,0,17
2009-10,35,13,0,0,26.875,-94.625,2,0,2
2009-10,35,16,1,1,26.875,-93.875,0,0,0
2009-10,35,26,0,0,26.875,-91.375,1,0,1
2009-10,35,27,0,0,26.875,-91.125,4,0,4
2009-10,36,13,0,0,27.125,-94.625,4,0,4
2009-10,36,14,1,1,27.125,-94.375,1,0,1
2009-10,36,15,0,0,27.125,-94.125,1,0,1
2009-10,36,16,1,1,27.125,-93.875,3,0,3
2009-10,36,17,1,1,27.125,-93.625,0,0,0
2009-10,36,20,1,1,27.125,-92.875,0,0,0
2009-10,36,53,0,0,27.125,-84.625,0,1,1
2009-10,36,54,0,0,27.125,-84.375,0,2,2
2009-10,37,10,5,1,27.375,-95.375,0,0,0
2009-10,37,11,3,1,27.375,-95.125,0,0,0
2009-10,37,12,0,0,27.375,-94.875,1,0,1
2009-10,37,13,0,0,27.375,-94.625,2,0,2
2009-10,37,14,0,0,27.375,-94.375,3,0,3
2009-10,37,18,1,1,27.375,-93.375,0,0,0
2009-10,40,41,0,0,28.125,-87.625,1,0,1
2009-10,40,42,0,0,28.125,-87.375,3,0,3
2009-10,40,43,0,0,28.125,-87.125,6,0,6
2009-10,40,44,0,0,28.125,-86.875,13,0,13
2009-10,40,45,0,0,28.125,-86.625,4,0,4
2009-10,40,46,0,0,28.125,-86.375,4,0,4
2009-11,0,43,0,0,18.125,-87.125,2,0,2
2009-11,0,44,0,0,18.125,-86.875,7,0,7
2009-11,0,45,0,0,18.125,-86.625,1,0,1
2009-11,1,45,0,0,18.375,-86.625,1,0,1
2009-11,1,46,0,0,18.375,-86.375,9,0,9
2009-11,1,47,0,0,18.375,-86.125,8,0,8
2009-11,1,70,0,0,18.375,-80.375,4,0,4
2009-11,1,71,0,0,18.375,-80.125,5,0,5
2009-11,6,59,0,0,19.625,-83.125,1,0,1
2009-11,6,60,0,0,19.625,-82.875,1,0,1
2009-11,7,56,0,0,19.875,-83.875,1,0,1
2009-11,7,57,0,0,19.875,-83.625,2,0,2
2009-11,7,58,0,0,19.875,-83.375,3,0,3
2009-11,7,59,0,0,19.875,-83.125,1,0,1
2009-11,8,55,0,0,20.125,-84.125,1,0,1
2009-11,8,56,0,0,20.125,-83.875,3,0,3
2009-11,8,65,0,0,20.125,-81.625,1,0,1
2009-11,9,51,0,0,20.375,-85.125,4,0,4
2009-11,9,52,0,0,20.375,-84.875,4,0,4
2009-11,9,53,0,0,20.375,-84.625,3,0,3
2009-11,9,54,0,0,20.375,-84.375,1,0,1
2009-11,9,55,0,0,20.375,-84.125,3,0,3
2009-11,9,60,0,0,20.375,-82.875,0,2,2
2009-11,9,62,0,0,20.375,-82.375,0,1,1
2009-11,9,65,0,0,20.375,-81.625,2,0,2
2009-11,9,66,0,0,20.375,-81.375,8,0,8
2009-11,9,67,0,0,20.375,-81.125,1,0,1
2009-11,10,60,0,0,20.625,-82.875,0,3,3
2009-11,10,61,0,0,20.625,-82.625,0,7,7
2009-11,10,62,0,0,20.625,-82.375,0,9,9
2009-11,10,63,0,0,20.625,-82.125,0,5,5
2009-11,10,64,0,0,20.625,-81.875,0,2,2
2009-11,10,67,0,0,20.625,-81.125,3,0,3
2009-11,10,68,0,0,20.625,-80.875,6,0,6
2009-11,10,69,0,0,20.625,-80.625,7,0,7
2009-11,11,68,0,0,20.875,-80.875,1,0,1
2009-11,14,5,0,0,21.625,-96.625,0,2,2
2009-11,14,6,0,0,21.625,-96.375,0,3,3
2009-11,15,45,0,0,21.875,-86.625,0,7,7
2009-11,15,46,0,0,21.875,-86.375,0,1,1
2009-11,16,10,0,0,22.125,-95.375,3,0,3
2009-11,16,11,0,0,22.125,-95.125,7,0,7
2009-11,16,44,0,0,22.125,-86.875,0,3,3
2009-11,17,10,0,0,22.375,-95.375,6,0,6
2009-11,17,11,0,0,22.375,-95.125,1,0,1
2009-11,17,43,0,0,22.375,-87.125,0,4,4
2009-11,17,44,0,0,22.375,-86.875,0,3,3
2009-11,18,10,0,0,22.625,-95.375,3,0,3
2009-11,18,11,0,0,22.625,-95.125,7,0,7
2009-11,18,42,0,0,22.625,-87.375,0,3,3
2009-11,19,11,0,0,22.875,-95.125,3,0,3
2009-11,23,55,0,0,23.875,-84.125,0,9,9
2009-11,23,56,0,0,23.875,-83.875,0,3,3
2009-11,24,55,0,0,24.125,-84.125,0,4,4
2009-11,24,56,0,0,24.125,-83.875,0,12,12
2009-11,25,56,0,0,24.375,-83.875,0,2,2
2009-11,27,17,0,0,24.875,-93.625,5,0,5
2009-11,27,30,0,0,24.875,-90.375,0,3,3
2009-11,27,31,0,0,24.875,-90.125,0,21,21
2009-11,27,32,0,0,24.875,-89.875,0,6,6
2009-11,27,45,0,0,24.875,-86.625,2,0,2
2009-11,28,45,0,0,25.125,-86.625,25,0,25
2009-11,29,10,0,0,25.375,-95.375,0,1,1
2009-11,29,11,0,0,25.375,-95.125,0,5,5
2009-11,29,17,0,0,25.375,-93.625,2,0,2
2009-11,29,45,0,0,25.375,-86.625,3,0,3
2009-11,30,9,0,0,25.625,-95.625,0,1,1
2009-11,30,10,0,0,25.625,-95.375,0,7,7
2009-11,30,11,0,0,25.625,-95.125,0,6,6
2009-11,30,16,0,0,25.625,-93.875,4,0,4
2009-11,30,17,0,0,25.625,-93.625,9,0,9
2009-11,30,18,0,0,25.625,-93.375,1,0,1
2009-11,31,9,0,0,25.875,-95.625,0,2,2
2009-11,31,10,0,0,25.875,-95.375,0,7,7
2009-11,31,11,0,0,25.875,-95.125,0,1,1
2009-11,31,16,0,0,25.875,-93.875,7,0,7
2009-11,31,17,0,0,25.875,-93.625,1,0,1
2009-11,34,50,0,0,26.625,-85.375,0,2,2
2009-11,35,31,0,0,26.875,-90.125,2,0,2
2009-11,35,32,0,0,26.875,-89.875,2,0,2
2009-11,35,34,0,0,26.875,-89.375,4,0,4
2009-11,35,53,0,0,26.875,-84.625,0,1,1
2009-11,36,28,0,0,27.125,-90.875,4,0,4
2009-11,36,29,0,0,27.125,-90.625,8,0,8
2009-11,36,30,0,0,27.125,-90.375,2,0,2
2009-11,36,31,0,0,27.125,-90.125,3,0,3
2009-11,36,34,0,0,27.125,-89.375,1,0,1
2009-11,36,50,0,0,27.125,-85.375,0,4,4
2009-11,37,50,0,0,27.375,-85.375,0,1,1
2009-11,37,51,0,0,27.375,-85.125,0,1,1
2009-11,38,47,0,0,27.625,-86.125,0,2,2
2009-11,38,51,0,0,27.625,-85.125,0,3,3
2009-11,38,52,0,0,27.625,-84.875,0,6,6
2009-11,40,44,0,0,28.125,-86.875,2,0,2
2009-11,40,46,0,0,28.125,-86.375,1,0,1
2009-11,41,44,0,0,28.375,-86.875,1,0,1
2009-11,41,45,0,0,28.375,-86.625,1,0,1
2009-12,0,43,0,0,18.125,-87.125,3,0,3
2009-12,1,43,0,0,18.375,-87.125,1,0,1
2009-12,1,68,0,0,18.375,-80.875,2,0,2
2009-12,1,69,0,0,18.375,-80.625,2,0,2
2009-12,1,70,0,0,18.375,-80.375,1,0,1
2009-12,2,67,0,0,18.625,-81.125,2,0,2
2009-12,3,65,0,0,18.875,-81.625,3,0,3
2009-12,3,66,0,0,18.875,-81.375,3,0,3
2009-12,4,63,0,0,19.125,-82.125,3,0,3
2009-12,4,64,0,0,19.125,-81.875,2,0,2
2009-12,5,60,0,0,19.375,-82.875,2,0,2
2009-12,5,61,0,0,19.375,-82.625,5,0,5
2009-12,5,62,0,0,19.375,-82.375,6,0,6
2009-12,7,70,0,0,19.875,-80.375,0,5,5
2009-12,7,71,0,0,19.875,-80.125,0,9,9
2009-12,8,65,0,0,20.125,-81.625,5,0,5
2009-12,8,68,0,0,20.125,-80.875,0,2,2
2009-12,8,69,0,0,20.125,-80.625,0,1,1
2009-12,8,70,0,0,20.125,-80.375,0,1,1
2009-12,9,51,0,0,20.375,-85.125,4,0,4
2009-12,9,52,0,0,20.375,-84.875,11,0,11
2009-12,9,58,0,0,20.375,-83.375,0,3,3
2009-12,9,59,0,0,20.375,-83.125,0,2,2
2009-12,9,60,0,0,20.375,-82.875,0,1,1
2009-12,10,51,0,0,20.625,-85.125,6,0,6
2009-12,10,52,0,0,20.625,-84.875,2,0,2
2009-12,10,59,0,0,20.625,-83.125,0,2,2
2009-12,10,60,0,0,20.625,-82.875,0,4,4
2009-12,11,51,0,0,20.875,-85.125,6,0,6
2009-12,11,52,0,0,20.875,-84.875,2,0,2
2009-12,14,10,0,0,21.625,-95.375,7,0,7
2009-12,14,11,0,0,21.625,-95.125,2,0,2
2009-12,15,9,0,0,21.875,-95.625,3,0,3
2009-12,15,10,0,0,21.875,-95.375,1,0,1
2009-12,16,8,0,0,22.125,-95.875,9,0,9
2009-12,16,9,0,0,22.125,-95.625,7,0,7
2009-12,16,10,0,0,22.125,-95.375,2,0,2
2009-12,16,20,0,0,22.125,-92.875,0,1,1
2009-12,17,20,0,0,22.375,-92.875,0,2,2
2009-12,18,16,0,0,22.625,-93.875,0,4,4
2009-12,18,17,0,0,22.625,-93.625,0,1,1
2009-12,18,19,0,0,22.625,-93.125,0,3,3
2009-12,18,42,0,0,22.625,-87.375,0,1,1
2009-12,19,17,0,0,22.875,-93.625,0,3,3
2009-12,19,18,0,0,22.875,-93.375,0,5,5
2009-12,19,19,0,0,22.875,-93.125,0,6,6
2009-12,19,41,0,0,22.875,-87.625,0,6,6
2009-12,19,42,0,0,22.875,-87.375,0,1,1
2009-12,20,41,0,0,23.125,-87.625,0,9,9
2009-12,21,41,0,0,23.375,-87.625,0,1,1
2009-12,23,55,0,0,23.875,-84.125,0,2,2
2009-12,23,56,0,0,23.875,-83.875,0,17,17
2009-12,24,50,0,0,24.125,-85.375,0,3,3
2009-12,24,51,0,0,24.125,-85.125,0,2,2
2009-12,24,52,0,0,24.125,-84.875,0,1,1
2009-12,24,53,0,0,24.125,-84.625,0,1,1
2009-12,24,54,0,0,24.125,-84.375,0,2,2
2009-12,24,55,0,0,24.125,-84.125,0,1,1
2009-12,25,27,0,0,24.375,-91.125,0,7,7
2009-12,25,28,0,0,24.375,-90.875,0,3,3
2009-12,25,51,0,0,24.375,-85.125,0,2,2
2009-12,26,8,0,0,24.625,-95.875,0,3,3
2009-12,26,9,0,0,24.625,-95.625,0,7,7
2009-12,26,28,0,0,24.625,-90.875,0,5,5
2009-12,26,29,0,0,24.625,-90.625,0,10,10
2009-12,27,8,0,0,24.875,-95.875,0,7,7
2009-12,27,9,0,0,24.875,-95.625,0,6,6
2009-12,27,17,0,0,24.875,-93.625,7,0,7
2009-12,27,30,0,0,24.875,-90.375,0,6,6
2009-12,28,9,0,0,25.125,-95.625,0,2,2
2009-12,28,10,0,0,25.125,-95.375,0,3,3
2009-12,29,10,0,0,25.375,-95.375,0,2,2
2009-12,29,15,0,0,25.375,-94.125,12,0,12
2009-12,29,44,0,0,25.375,-86.875,4,0,4
2009-12,29,45,0,0,25.375,-86.625,4,0,4
2009-12,30,14,0,0,25.625,-94.375,1,0,1
2009-12,30,15,0,0,25.625,-94.125,6,0,6
2009-12,30,42,0,0,25.625,-87.375,5,0,5
2009-12,30,43,0,0,25.625,-87.125,6,0,6
2009-12,30,44,0,0,25.625,-86.875,1,0,1
2009-12,31,42,0,0,25.875,-87.375,11,0,11
2009-12,32,21,0,0,26.125,-92.625,0,1,1
2009-12,32,22,0,0,26.125,-92.375,0,1,1
2009-12,33,20,0,0,26.375,-92.875,0,1,1
2009-12,33,21,0,0,26.375,-92.625,0,8,8
2009-12,33,31,0,0,26.375,-90.125,3,0,3
2009-12,34,20,0,0,26.625,-92.875,0,10,10
2009-12,36,56,0,0,27.125,-83.875,0,1,1
2009-12,37,45,0,0,27.375,-86.625,0,1,1
2009-12,37,46,0,0,27.375,-86.375,0,1,1
2009-12,38,43,0,0,27.625,-87.125,0,1,1
2009-12,38,44,0,0,27.625,-86.875,0,6,6
2009-12,38,45,0,0,27.625,-86.625,0,5,5
2009-12,38,46,0,0,27.625,-86.375,0,2,2
2009-12,39,41,0,0,27.875,-87.625,0,2,2
2009-12,40,39,0,0,28.125,-88.125,0,6,6
2009-12,40,41,0,0,28.125,-87.625,0,2,2
2009-12,41,39,0,0,28.375,-88.125,0,4,4
2010-01,4,56,0,0,19.125,-83.875,1,0,1
2010-01,4,57,0,0,19.125,-83.625,1,0,1
2010-01,5,58,0,0,19.375,-83.375,2,0,2
2010-01,5,59,0,0,19.375,-83.125,4,0,4
2010-01,5,60,0,0,19.375,-82.875,2,0,2
2010-01,6,49,0,0,19.625,-85.625,1,0,1
2010-01,6,50,0,0,19.625,-85.375,3,0,3
2010-01,7,49,0,0,19.875,-85.625,3,0,3
2010-01,8,8,0,0,20.125,-95.875,10,0,10
2010-01,8,9,0,0,20.125,-95.625,6,0,6
2010-01,8,50,0,0,20.125,-85.375,3,0,3
2010-01,8,66,0,0,20.125,-81.375,0,2,2
2010-01,8,67,0,0,20.125,-81.125,0,6,6
2010-01,8,68,0,0,20.125,-80.875,0,1,1
2010-01,9,8,0,0,20.375,-95.875,8,0,8
2010-01,9,50,0,0,20.375,-85.375,5,0,5
2010-01,9,51,0,0,20.375,-85.125,6,0,6
2010-01,9,52,0,0,20.375,-84.875,3,0,3
2010-01,9,53,0,0,20.375,-84.625,1,0,1
2010-01,9,65,0,0,20.375,-81.625,0,5,5
2010-01,9,67,0,0,20.375,-81.125,0,2,2
2010-01,9,68,0,0,20.375,-80.875,0,1,1
2010-01,10,51,0,0,20.625,-85.125,4,0,4
2010-01,10,59,0,0,20.625,-83.125,0,4,4
2010-01,10,60,0,0,20.625,-82.875,0,3,3
2010-01,10,61,0,0,20.625,-82.625,0,1,1
2010-01,11,51,0,0,20.875,-85.125,2,0,2
2010-01,11,57,0,0,20.875,-83.625,0,3,3
2010-01,15,11,0,0,21.875,-95.125,0,1,1
2010-01,15,12,0,0,21.875,-94.875,0,3,3
2010-01,15,13,0,0,21.875,-94.625,0,6,6
2010-01,15,22,0,0,21.875,-92.375,1,0,1
2010-01,16,7,0,0,22.125,-96.125,7,0,7
2010-01,16,10,0,0,22.125,-95.375,0,5,5
2010-01,16,11,0,0,22.125,-95.125,0,4,4
2010-01,16,13,0,0,22.125,-94.625,0,1,1
2010-01,16,14,0,0,22.125,-94.375,0,2,2
2010-01,17,14,0,0,22.375,-94.375,0,4,4
2010-01,17,15,0,0,22.375,-94.125,0,3,3
2010-01,18,15,0,0,22.625,-94.125,0,1,1
2010-01,18,16,0,0,22.625,-93.875,0,1,1
2010-01,20,7,0,0,23.125,-96.125,3,0,3
2010-01,21,6,0,0,23.375,-96.375,5,0,5
2010-01,22,6,0,0,23.625,-96.375,4,0,4
2010-01,23,6,0,0,23.875,-96.375,4,0,4
2010-01,23,48,0,0,23.875,-85.875,0,1,1
2010-01,23,49,0,0,23.875,-85.625,0,8,8
2010-01,23,50,0,0,23.875,-85.375,0,3,3
2010-01,24,6,0,0,24.125,-96.375,3,0,3
2010-01,24,7,0,0,24.125,-96.125,2,0,2
2010-01,24,21,0,0,24.125,-92.625,0,5,5
2010-01,24,22,0,0,24.125,-92.375,0,5,5
2010-01,24,23,0,0,24.125,-92.125,0,5,5
2010-01,24,24,0,0,24.125,-91.875,0,4,4
2010-01,24,47,0,0,24.125,-86.125,0,3,3
2010-01,24,48,0,0,24.125,-85.875,0,1,1
2010-01,24,49,0,0,24.125,-85.625,0,3,3
2010-01,24,50,0,0,24.125,-85.375,0,7,7
2010-01,25,24,0,0,24.375,-91.875,0,1,1
2010-01,25,25,0,0,24.375,-91.625,0,6,6
2010-01,25,26,0,0,24.375,-91.375,0,5,5
2010-01,25,47,0,0,24.375,-86.125,0,2,2
2010-01,25,55,0,0,24.375,-84.125,1,0,1
2010-01,26,33,0,0,24.625,-89.625,0,6,6
2010-01,26,47,0,0,24.625,-86.125,0,2,2
2010-01,26,54,0,0,24.625,-84.375,1,0,1
2010-01,26,55,0,0,24.625,-84.125,1,0,1
2010-01,27,9,0,0,24.875,-95.625,0,3,3
2010-01,27,33,0,0,24.875,-89.625,0,4,4
2010-01,27,34,0,0,24.875,-89.375,0,2,2
2010-01,27,47,0,0,24.875,-86.125,0,1,1
2010-01,28,9,0,0,25.125,-95.625,0,8,8
2010-01,29,8,0,0,25.375,-95.875,0,1,1
2010-01,29,9,0,0,25.375,-95.625,0,1,1
2010-01,29,15,0,0,25.375,-94.125,3,0,3
2010-01,30,14,0,0,25.625,-94.375,2,0,2
2010-01,30,15,0,0,25.625,-94.125,9,0,9
2010-01,31,14,0,0,25.875,-94.375,1,0,1
2010-01,31,15,0,0,25.875,-94.125,10,0,10
2010-01,31,16,0,0,25.875,-93.875,6,0,6
2010-01,31,38,0,0,25.875,-88.375,2,0,2
2010-01,31,40,0,0,25.875,-87.875,8,0,8
2010-01,31,41,0,0,25.875,-87.625,4,0,4
2010-01,31,42,0,0,25.875,-87.375,8,0,8
2010-01,31,43,0,0,25.875,-87.125,1,0,1
2010-01,32,37,0,0,26.125,-88.625,2,0,2
2010-01,32,38,0,0,26.125,-88.375,1,0,1
2010-01,32,42,0,0,26.125,-87.375,2,0,2
2010-01,32,43,0,0,26.125,-87.125,3,0,3
2010-01,32,56,0,0,26.125,-83.875,0,3,3
2010-01,33,30,0,0,26.375,-90.375,3,0,3
2010-01,33,31,0,0,26.375,-90.125,22,0,22
2010-01,33,56,0,0,26.375,-83.875,0,5,5
2010-01,34,18,0,0,26.625,-93.375,0,2,2
2010-01,34,19,0,0,26.625,-93.125,0,8,8
2010-01,34,20,0,0,26.625,-92.875,0,2,2
2010-01,34,31,0,0,26.625,-90.125,1,0,1
2010-01,34,56,0,0,26.625,-83.875,0,10,10
2010-01,35,15,0,0,26.875,-94.125,0,2,2
2010-01,35,16,0,0,26.875,-93.875,0,8,8
2010-01,35,17,0,0,26.875,-93.625,0,6,6
2010-01,35,18,0,0,26.875,-93.375,0,3,3
2010-01,35,56,0,0,26.875,-83.875,0,5,5
2010-01,36,56,0,0,27.125,-83.875,0,6,6
2010-01,37,56,0,0,27.375,-83.875,0,1,1
2010-01,39,37,0,0,27.875,-88.625,0,1,1
2010-01,39,40,0,0,27.875,-87.875,0,5,5
2010-01,40,37,0,0,28.125,-88.625,0,1,1
2010-01,40,38,0,0,28.125,-88.375,0,1,1
2010-01,40,39,0,0,28.125,-88.125,0,4,4
2010-01,40,40,0,0,28.125,-87.875,0,3,3
2010-01,41,39,0,0,28.375,-88.125,0,10,10
2010-01,41,40,0,0,28.375,-87.875,0,1,1
2010-01,42,39,0,0,28.625,-88.125,0,3,3
2010-02,0,47,0,0,18.125,-86.125,0,1,1
2010-02,0,48,0,0,18.125,-85.875,0,4,4
2010-02,0,49,0,0,18.125,-85.625,0,4,4
2010-02,0,57,0,0,18.125,-83.625,1,0,1
2010-02,1,46,0,0,18.375,-86.375,0,3,3
2010-02,1,47,0,0,18.375,-86.125,0,2,2
2010-02,1,55,0,0,18.375,-84.125,1,0,1
2010-02,1,56,0,0,18.375,-83.875,1,0,1
2010-02,1,57,0,0,18.375,-83.625,1,0,1
2010-02,1,69,0,0,18.375,-80.625,2,0,2
2010-02,1,70,0,0,18.375,-80.375,1,0,1
2010-02,2,56,0,0,18.625,-83.875,2,0,2
2010-02,2,57,0,0,18.625,-83.625,1,0,1
2010-02,2,69,0,0,18.625,-80.625,2,0,2
2010-02,3,62,0,0,18.875,-82.375,2,0,2
2010-02,3,63,0,0,18.875,-82.125,2,0,2
2010-02,3,64,0,0,18.875,-81.875,3,0,3
2010-02,3,65,0,0,18.875,-81.625,3,0,3
2010-02,3,66,0,0,18.875,-81.375,4,0,4
2010-02,3,67,0,0,18.875,-81.125,1,0,1
2010-02,4,52,0,0,19.125,-84.875,5,0,5
2010-02,4,63,0,0,19.125,-82.125,1,0,1
2010-02,5,52,0,0,19.375,-84.875,1,0,1
2010-02,5,53,0,0,19.375,-84.625,5,0,5
2010-02,5,54,0,0,19.375,-84.375,4,0,4
2010-02,5,55,0,0,19.375,-84.125,4,0,4
2010-02,6,12,0,0,19.625,-94.875,2,0,2
2010-02,7,10,0,0,19.875,-95.375,2,0,2
2010-02,7,11,0,0,19.875,-95.125,5,0,5
2010-02,7,12,0,0,19.875,-94.875,3,0,3
2010-02,7,13,0,0,19.875,-94.625,2,0,2
2010-02,7,14,0,0,19.875,-94.375,1,0,1
2010-02,7,48,0,0,19.875,-85.875,3,0,3
2010-02,7,49,0,0,19.875,-85.625,2,0,2
2010-02,7,55,0,0,19.875,-84.125,0,2,2
2010-02,7,56,0,0,19.875,-83.875,0,6,6
2010-02,7,57,0,0,19.875,-83.625,0,2,2
2010-02,7,58,0,0,19.875,-83.375,0,1,1
2010-02,7,71,0,0,19.875,-80.125,0,1,1
2010-02,8,9,0,0,20.125,-95.625,9,0,9
2010-02,8,10,0,0,20.125,-95.375,4,0,4
2010-02,8,48,0,0,20.125,-85.875,1,0,1
2010-02,8,71,0,0,20.125,-80.125,0,16,16
2010-02,9,56,0,0,20.375,-83.875,0,3,3
2010-02,10,55,0,0,20.625,-84.125,0,4,4
2010-02,10,56,0,0,20.625,-83.875,0,3,3
2010-02,10,58,0,0,20.625,-83.375,0,3,3
2010-02,11,54,0,0,20.875,-84.375,0,1,1
2010-02,11,55,0,0,20.875,-84.125,0,1,1
2010-02,14,20,0,0,21.625,-92.875,4,0,4
2010-02,14,21,0,0,21.625,-92.625,4,0,4
2010-02,14,22,0,0,21.625,-92.375,1,0,1
2010-02,15,9,0,0,21.875,-95.625,0,5,5
2010-02,15,18,0,0,21.875,-93.375,1,0,1
2010-02,15,19,0,0,21.875,-93.125,2,0,2
2010-02,15,22,0,0,21.875,-92.375,2,0,2
2010-02,16,7,0,0,22.125,-96.125,0,10,10
2010-02,16,8,0,0,22.125,-95.875,0,4,4
2010-02,16,9,0,0,22.125,-95.625,0,3,3
2010-02,16,10,0,0,22.125,-95.375,0,2,2
2010-02,16,15,0,0,22.125,-94.125,4,0,4
2010-02,16,16,0,0,22.125,-93.875,5,0,5
2010-02,16,17,0,0,22.125,-93.625,4,0,4
2010-02,16,18,0,0,22.125,-93.375,1,0,1
2010-02,17,6,0,0,22.375,-96.375,0,4,4
2010-02,21,29,0,0,23.375,-90.625,3,0,3
2010-02,21,30,0,0,23.375,-90.375,1,0,1
2010-02,21,31,0,0,23.375,-90.125,2,0,2
2010-02,22,54,0,0,23.625,-84.375,10,0,10
2010-02,22,55,0,0,23.625,-84.125,4,0,4
2010-02,23,14,0,0,23.875,-94.375,0,1,1
2010-02,23,15,0,0,23.875,-94.125,0,3,3
2010-02,23,53,0,0,23.875,-84.625,2,0,2
2010-02,23,54,0,0,23.875,-84.375,8,0,8
2010-02,23,61,0,0,23.875,-82.625,0,1,1
2010-02,23,62,0,0,23.875,-82.375,0,5,5
2010-02,23,63,0,0,23.875,-82.125,0,4,4
2010-02,23,64,0,0,23.875,-81.875,0,8,8
2010-02,24,16,0,0,24.125,-93.875,0,2,2
2010-02,24,17,0,0,24.125,-93.625,0,5,5
2010-02,24,18,0,0,24.125,-93.375,0,6,6
2010-02,24,19,0,0,24.125,-93.125,0,6,6
2010-02,24,20,0,0,24.125,-92.875,0,5,5
2010-02,24,29,0,0,24.125,-90.625,0,7,7
2010-02,24,30,0,0,24.125,-90.375,0,5,5
2010-02,24,54,0,0,24.125,-84.375,2,0,2
2010-02,25,7,0,0,24.375,-96.125,7,0,7
2010-02,25,30,0,0,24.375,-90.375,0,3,3
2010-02,25,31,0,0,24.375,-90.125,0,3,3
2010-02,25,32,0,0,24.375,-89.875,0,2,2
2010-02,25,54,0,0,24.375,-84.375,2,0,2
2010-02,26,7,0,0,24.625,-96.125,2,0,2
2010-02,27,7,0,0,24.875,-96.125,2,0,2
2010-02,27,8,0,0,24.875,-95.875,2,0,2
2010-02,27,47,0,0,24.875,-86.125,0,1,1
2010-02,28,8,0,0,25.125,-95.875,7,0,7
2010-02,28,47,0,0,25.125,-86.125,0,4,4
2010-02,28,48,0,0,25.125,-85.875,0,1,1
2010-02,29,8,0,0,25.375,-95.875,1,0,1
2010-02,29,47,0,0,25.375,-86.125,0,2,2
2010-02,29,48,0,0,25.375,-85.875,0,10,10
2010-02,30,48,0,0,25.625,-85.875,0,10,10
2010-02,31,16,0,0,25.875,-93.875,16,0,16
2010-02,32,16,0,0,26.125,-93.875,8,0,8
2010-02,32,17,0,0,26.125,-93.625,1,0,1
2010-02,32,37,0,0,26.125,-88.625,12,0,12
2010-02,32,38,0,0,26.125,-88.375,15,0,15
2010-02,32,39,0,0,26.125,-88.125,1,0,1
2010-02,33,16,0,0,26.375,-93.875,1,0,1
2010-02,35,10,0,0,26.875,-95.375,0,6,6
2010-02,35,11,0,0,26.875,-95.125,0,3,3
2010-02,35,15,0,0,26.875,-94.125,0,1,1
2010-02,36,9,0,0,27.125,-95.625,0,2,2
2010-02,36,10,0,0,27.125,-95.375,0,10,10
2010-02,36,56,0,0,27.125,-83.875,0,2,2
2010-02,40,35,0,0,28.125,-89.125,0,2,2
2010-02,40,36,0,0,28.125,-88.875,0,1,1
2010-02,40,38,0,0,28.125,-88.375,0,4,4
2010-02,40,39,0,0,28.125,-88.125,0,7,7
2010-02,41,36,0,0,28.375,-88.875,0,2,2
2010-02,41,37,0,0,28.375,-88.625,0,3,3
2010-03,0,44,0,0,18.125,-86.875,0,2,2
2010-03,0,69,0,0,18.125,-80.625,1,0,1
2010-03,1,43,0,0,18.375,-87.125,0,2,2
2010-03,1,44,0,0,18.375,-86.875,0,4,4
2010-03,1,45,0,0,18.375,-86.625,0,3,3
2010-03,1,46,0,0,18.375,-86.375,0,1,1
2010-03,1,69,0,0,18.375,-80.625,1,0,1
2010-03,2,57,0,0,18.625,-83.625,1,0,1
2010-03,2,67,0,0,18.625,-81.125,2,0,2
2010-03,2,68,0,0,18.625,-80.875,4,0,4
2010-03,3,51,0,0,18.875,-85.125,3,0,3
2010-03,3,65,0,0,18.875,-81.625,3,0,3
2010-03,3,66,0,0,18.875,-81.375,3,0,3
2010-03,3,67,0,0,18.875,-81.125,1,0,1
2010-03,4,50,0,0,19.125,-85.375,1,0,1
2010-03,4,51,0,0,19.125,-85.125,1,0,1
2010-03,4,52,0,0,19.125,-84.875,1,0,1
2010-03,4,53,0,0,19.125,-84.625,1,0,1
2010-03,4,58,0,0,19.125,-83.375,1,0,1
2010-03,4,60,0,0,19.125,-82.875,2,0,2
2010-03,5,53,0,0,19.375,-84.625,2,0,2
2010-03,5,54,0,0,19.375,-84.375,2,0,2
2010-03,5,58,0,0,19.375,-83.375,5,0,5
2010-03,6,19,0,0,19.625,-93.125,0,3,3
2010-03,6,54,0,0,19.625,-84.375,1,0,1
2010-03,6,55,0,0,19.625,-84.125,3,0,3
2010-03,6,56,0,0,19.625,-83.875,2,0,2
2010-03,6,57,0,0,19.625,-83.625,4,0,4
2010-03,6,58,0,0,19.625,-83.375,1,0,1
2010-03,7,14,0,0,19.875,-94.375,1,0,1
2010-03,7,19,0,0,19.875,-93.125,0,5,5
2010-03,7,55,0,0,19.875,-84.125,0,1,1
2010-03,7,57,0,0,19.875,-83.625,2,0,2
2010-03,7,71,0,0,19.875,-80.125,0,1,1
2010-03,8,18,0,0,20.125,-93.375,0,1,1
2010-03,8,19,0,0,20.125,-93.125,0,5,5
2010-03,9,18,0,0,20.375,-93.375,0,2,2
2010-03,9,19,0,0,20.375,-93.125,0,2,2
2010-03,9,68,0,0,20.375,-80.875,0,3,3
2010-03,12,13,0,0,21.125,-94.625,5,0,5
2010-03,12,14,0,0,21.125,-94.375,11,0,11
2010-03,13,12,0,0,21.375,-94.875,3,0,3
2010-03,13,13,0,0,21.375,-94.625,3,0,3
2010-03,13,14,0,0,21.375,-94.375,3,0,3
2010-03,15,14,0,0,21.875,-94.375,1,0,1
2010-03,18,6,0,0,22.625,-96.375,0,1,1
2010-03,21,8,0,0,23.375,-95.875,0,3,3
2010-03,21,9,0,0,23.375,-95.625,0,6,6
2010-03,21,26,0,0,23.375,-91.375,1,0,1
2010-03,21,27,0,0,23.375,-91.125,2,0,2
2010-03,21,28,0,0,23.375,-90.875,4,0,4
2010-03,21,29,0,0,23.375,-90.625,2,0,2
2010-03,22,8,0,0,23.625,-95.875,0,8,8
2010-03,22,10,0,0,23.625,-95.375,0,4,4
2010-03,22,11,0,0,23.625,-95.125,0,6,6
2010-03,22,12,0,0,23.625,-94.875,0,3,3
2010-03,22,26,0,0,23.625,-91.375,5,0,5
2010-03,22,54,0,0,23.625,-84.375,4,0,4
2010-03,22,55,0,0,23.625,-84.125,27,0,27
2010-03,23,14,0,0,23.875,-94.375,0,1,1
2010-03,23,24,0,0,23.875,-91.875,4,0,4
2010-03,23,25,0,0,23.875,-91.625,5,0,5
2010-03,23,26,0,0,23.875,-91.375,4,0,4
2010-03,23,64,0,0,23.875,-81.875,0,16,16
2010-03,23,65,0,0,23.875,-81.625,0,7,7
2010-03,24,23,0,0,24.125,-92.125,4,0,4
2010-03,24,28,0,0,24.125,-90.875,0,1,1
2010-03,24,66,0,0,24.125,-81.375,0,3,3
2010-03,25,28,0,0,24.375,-90.875,0,1,1
2010-03,25,65,0,0,24.375,-81.625,0,5,5
2010-03,27,19,0,0,24.875,-93.125,0,1,1
2010-03,28,19,0,0,25.125,-93.125,0,1,1
2010-03,28,20,0,0,25.125,-92.875,0,7,7
2010-03,28,21,0,0,25.125,-92.625,0,3,3
2010-03,29,8,0,0,25.375,-95.875,7,0,7
2010-03,29,9,0,0,25.375,-95.625,10,0,10
2010-03,29,15,0,0,25.375,-94.125,3,0,3
2010-03,29,21,0,0,25.375,-92.625,0,4,4
2010-03,29,47,0,0,25.375,-86.125,0,10,10
2010-03,29,48,0,0,25.375,-85.875,0,4,4
2010-03,30,15,0,0,25.625,-94.125,4,0,4
2010-03,30,47,0,0,25.625,-86.125,0,17,17
2010-03,31,15,0,0,25.875,-94.125,7,0,7
2010-03,31,38,0,0,25.875,-88.375,5,0,5
2010-03,32,16,0,0,26.125,-93.875,12,0,12
2010-03,32,17,0,0,26.125,-93.625,2,0,2
2010-03,32,28,0,0,26.125,-90.875,1,0,1
2010-03,32,29,0,0,26.125,-90.625,10,0,10
2010-03,32,36,0,0,26.125,-88.875,2,0,2
2010-03,32,37,0,0,26.125,-88.625,2,0,2
2010-03,32,38,0,0,26.125,-88.375,12,0,12
2010-03,32,39,0,0,26.125,-88.125,9,0,9
2010-03,33,16,0,0,26.375,-93.875,3,0,3
2010-03,33,28,0,0,26.375,-90.875,2,0,2
2010-03,33,29,0,0,26.375,-90.625,6,0,6
2010-03,33,37,0,0,26.375,-88.625,1,0,1
2010-03,34,9,0,0,26.625,-95.625,0,5,5
2010-03,34,26,0,0,26.625,-91.375,6,0,6
2010-03,34,27,0,0,26.625,-91.125,2,0,2
2010-03,35,9,0,0,26.875,-95.625,0,18,18
2010-03,35,10,0,0,26.875,-95.375,0,1,1
2010-03,35,11,0,0,26.875,-95.125,0,4,4
2010-03,36,11,0,0,27.125,-95.125,0,2,2
2010-03,37,48,0,0,27.375,-85.875,3,0,3
2010-03,37,49,0,0,27.375,-85.625,5,0,5
2010-03,38,48,0,0,27.625,-85.875,7,0,7
2010-03,40,32,0,0,28.125,-89.875,0,3,3
2010-03,40,33,0,0,28.125,-89.625,0,7,7
2010-03,40,34,0,0,28.125,-89.375,0,3,3
2010-03,41,33,0,0,28.375,-89.625,0,1,1
2010-04,1,44,0,0,18.375,-86.875,5,0,5
2010-04,1,67,0,0,18.375,-81.125,1,0,1
2010-04,2,45,0,0,18.625,-86.625,3,0,3
2010-04,2,46,0,0,18.625,-86.375,6,0,6
2010-04,2,47,0,0,18.625,-86.125,5,0,5
2010-04,2,48,0,0,18.625,-85.875,2,0,2
2010-04,2,63,0,0,18.625,-82.125,1,0,1
2010-04,2,64,0,0,18.625,-81.875,7,0,7
2010-04,2,65,0,0,18.625,-81.625,3,0,3
2010-04,2,66,0,0,18.625,-81.375,4,0,4
2010-04,3,51,0,0,18.875,-85.125,1,0,1
2010-04,3,62,0,0,18.875,-82.375,3,0,3
2010-04,3,63,0,0,18.875,-82.125,9,0,9
2010-04,4,49,0,0,19.125,-85.625,3,0,3
2010-04,4,50,0,0,19.125,-85.375,5,0,5
2010-04,6,66,0,0,19.625,-81.375,0,8,8
2010-04,6,67,0,0,19.625,-81.125,0,9,9
2010-04,7,66,0,0,19.875,-81.375,0,5,5
2010-04,8,67,0,0,20.125,-81.125,0,1,1
2010-04,8,68,0,0,20.125,-80.875,0,5,5
2010-04,9,17,0,0,20.375,-93.625,0,12,12
2010-04,9,18,0,0,20.375,-93.375,0,2,2
2010-04,9,68,0,0,20.375,-80.875,0,1,1
2010-04,10,16,0,0,20.625,-93.875,0,3,3
2010-04,10,17,0,0,20.625,-93.625,0,2,2
2010-04,10,18,0,0,20.625,-93.375,0,1,1
2010-04,11,16,0,0,20.875,-93.875,0,2,2
2010-04,11,17,0,0,20.875,-93.625,0,7,7
2010-04,12,17,0,0,21.125,-93.625,0,1,1
2010-04,13,11,0,0,21.375,-95.125,5,0,5
2010-04,13,12,0,0,21.375,-94.875,7,0,7
2010-04,14,10,0,0,21.625,-95.375,4,0,4
2010-04,14,11,0,0,21.625,-95.125,7,0,7
2010-04,16,10,0,0,22.125,-95.375,3,0,3
2010-04,16,11,0,0,22.125,-95.125,2,0,2
2010-04,17,11,0,0,22.375,-95.125,2,0,2
2010-04,20,21,0,0,23.125,-92.625,0,10,10
2010-04,20,22,0,0,23.125,-92.375,0,14,14
2010-04,20,23,0,0,23.125,-92.125,0,2,2
2010-04,22,7,0,0,23.625,-96.125,0,1,1
2010-04,22,8,0,0,23.625,-95.875,0,2,2
2010-04,22,55,0,0,23.625,-84.125,22,0,22
2010-04,22,56,0,0,23.625,-83.875,5,0,5
2010-04,22,57,0,0,23.625,-83.625,3,0,3
2010-04,23,7,0,0,23.875,-96.125,0,13,13
2010-04,24,7,0,0,24.125,-96.125,0,10,10
2010-04,24,8,0,0,24.125,-95.875,0,1,1
2010-04,24,22,0,0,24.125,-92.375,2,0,2
2010-04,24,23,0,0,24.125,-92.125,3,0,3
2010-04,24,66,0,0,24.125,-81.375,0,3,3
2010-04,24,67,0,0,24.125,-81.125,0,1,1
2010-04,25,8,0,0,24.375,-95.875,0,3,3
2010-04,28,15,0,0,25.125,-94.125,8,0,8
2010-04,28,21,0,0,25.125,-92.625,0,8,8
2010-04,28,22,0,0,25.125,-92.375,0,20,20
2010-04,29,15,0,0,25.375,-94.125,3,0,3
2010-04,29,21,0,0,25.375,-92.625,0,2,2
2010-04,29,46,0,0,25.375,-86.375,0,5,5
2010-04,29,47,0,0,25.375,-86.125,0,11,11
2010-04,30,45,0,0,25.625,-86.625,0,5,5
2010-04,30,46,0,0,25.625,-86.375,0,3,3
2010-04,30,47,0,0,25.625,-86.125,0,3,3
2010-04,31,34,0,0,25.875,-89.375,7,0,7
2010-04,31,35,0,0,25.875,-89.125,4,0,4
2010-04,31,44,0,0,25.875,-86.875,0,3,3
2010-04,32,7,0,0,26.125,-96.125,7,0,7
2010-04,32,17,0,0,26.125,-93.625,3,0,3
2010-04,32,34,0,0,26.125,-89.375,7,0,7
2010-04,32,35,0,0,26.125,-89.125,4,0,4
2010-04,32,36,0,0,26.125,-88.875,2,0,2
2010-04,33,7,0,0,26.375,-96.125,14,0,14
2010-04,33,16,0,0,26.375,-93.875,2,0,2
2010-04,33,17,0,0,26.375,-93.625,13,0,13
2010-04,33,36,0,0,26.375,-88.875,3,0,3
2010-04,33,37,0,0,26.375,-88.625,3,0,3
2010-04,34,11,0,0,26.625,-95.125,0,12,12
2010-04,34,25,0,0,26.625,-91.625,5,0,5
2010-04,34,26,0,0,26.625,-91.375,12,0,12
2010-04,34,51,0,0,26.625,-85.125,1,0,1
2010-04,35,11,0,0,26.875,-95.125,0,18,18
2010-04,35,51,0,0,26.875,-85.125,2,0,2
2010-04,36,51,0,0,27.125,-85.125,5,0,5
2010-04,37,49,0,0,27.375,-85.625,4,0,4
2010-04,37,50,0,0,27.375,-85.375,5,0,5
2010-04,37,51,0,0,27.375,-85.125,3,0,3
2010-04,38,33,0,0,27.625,-89.625,0,2,2
2010-04,38,34,0,0,27.625,-89.375,0,1,1
2010-04,38,49,0,0,27.625,-85.625,1,0,1
2010-04,38,50,0,0,27.625,-85.375,7,0,7
2010-04,38,51,0,0,27.625,-85.125,2,0,2
2010-04,39,33,0,0,27.875,-89.625,0,9,9
2010-04,39,34,0,0,27.875,-89.375,0,8,8
2010-04,39,35,0,0,27.875,-89.125,0,4,4
2010-04,40,34,0,0,28.125,-89.375,0,5,5
2010-05,0,47,0,0,18.125,-86.125,0,5,5
2010-05,0,48,0,0,18.125,-85.875,0,3,3
2010-05,0,49,0,0,18.125,-85.625,0,4,4
2010-05,0,50,0,0,18.125,-85.375,0,4,4
2010-05,0,51,0,0,18.125,-85.125,0,3,3
2010-05,1,47,0,0,18.375,-86.125,0,2,2
2010-05,1,48,0,0,18.375,-85.875,0,3,3
2010-05,1,68,0,0,18.375,-80.875,0,1,1
2010-05,2,46,0,0,18.625,-86.375,0,3,3
2010-05,2,47,0,0,18.625,-86.125,0,2,2
2010-05,3,62,0,0,18.875,-82.375,3,0,3
2010-05,3,63,0,0,18.875,-82.125,1,0,1
2010-05,4,59,0,0,19.125,-83.125,3,0,3
2010-05,4,65,0,0,19.125,-81.625,0,3,3
2010-05,5,65,0,0,19.375,-81.625,0,1,1
2010-05,6,14,0,0,19.625,-94.375,0,6,6
2010-05,6,15,0,0,19.625,-94.125,0,1,1
2010-05,6,65,0,0,19.625,-81.625,0,3,3
2010-05,6,66,0,0,19.625,-81.375,0,1,1
2010-05,7,14,0,0,19.875,-94.375,0,3,3
2010-05,7,15,0,0,19.875,-94.125,0,19,19
2010-05,11,17,0,0,20.875,-93.625,0,1,1
2010-05,12,7,0,0,21.125,-96.125,1,0,1
2010-05,12,8,0,0,21.125,-95.875,1,0,1
2010-05,14,18,0,0,21.625,-93.375,0,3,3
2010-05,15,7,0,0,21.875,-96.125,5,0,5
2010-05,15,8,0,0,21.875,-95.875,8,0,8
2010-05,15,9,0,0,21.875,-95.625,8,0,8
2010-05,15,10,0,0,21.875,-95.375,3,0,3
2010-05,15,15,0,0,21.875,-94.125,0,1,1
2010-05,15,16,0,0,21.875,-93.875,0,4,4
2010-05,16,10,0,0,22.125,-95.375,1,0,1
2010-05,16,15,0,0,22.125,-94.125,0,3,3
2010-05,16,17,0,0,22.125,-93.625,0,3,3
2010-05,20,21,0,0,23.125,-92.625,0,5,5
2010-05,22,15,0,0,23.625,-94.125,0,2,2
2010-05,22,57,0,0,23.625,-83.625,3,0,3
2010-05,22,58,0,0,23.625,-83.375,1,0,1
2010-05,23,14,0,0,23.875,-94.375,0,1,1
2010-05,23,15,0,0,23.875,-94.125,0,3,3
2010-05,23,49,0,0,23.875,-85.625,2,0,2
2010-05,23,54,0,0,23.875,-84.375,0,1,1
2010-05,23,55,0,0,23.875,-84.125,0,4,4
2010-05,23,56,0,0,23.875,-83.875,0,5,5
2010-05,23,57,0,0,23.875,-83.625,0,11,11
2010-05,23,63,0,0,23.875,-82.125,1,0,1
2010-05,23,64,0,0,23.875,-81.875,4,0,4
2010-05,23,65,0,0,23.875,-81.625,3,0,3
2010-05,24,13,0,0,24.125,-94.625,0,1,1
2010-05,24,14,0,0,24.125,-94.375,0,4,4
2010-05,24,26,0,0,24.125,-91.375,4,0,4
2010-05,24,50,0,0,24.125,-85.375,2,0,2
2010-05,24,65,0,0,24.125,-81.625,2,0,2
2010-05,25,8,0,0,24.375,-95.875,0,2,2
2010-05,25,13,0,0,24.375,-94.625,0,1,1
2010-05,25,27,0,0,24.375,-91.125,2,0,2
2010-05,25,50,0,0,24.375,-85.375,2,0,2
2010-05,26,9,0,0,24.625,-95.625,0,2,2
2010-05,26,10,0,0,24.625,-95.375,0,3,3
2010-05,26,11,0,0,24.625,-95.125,0,5,5
2010-05,26,12,0,0,24.625,-94.875,0,5,5
2010-05,26,13,0,0,24.625,-94.625,0,2,2
2010-05,26,50,0,0,24.625,-85.375,6,0,6
2010-05,27,50,0,0,24.875,-85.375,5,0,5
2010-05,27,51,0,0,24.875,-85.125,1,0,1
2010-05,28,22,0,0,25.125,-92.375,0,7,7
2010-05,28,51,0,0,25.125,-85.125,3,0,3
2010-05,29,22,0,0,25.375,-92.375,0,9,9
2010-05,29,51,0,0,25.375,-85.125,1,0,1
2010-05,30,23,0,0,25.625,-92.125,0,13,13
2010-05,30,24,0,0,25.625,-91.875,0,2,2
2010-05,30,51,0,0,25.625,-85.125,3,0,3
2010-05,31,16,0,0,25.875,-93.875,4,0,4
2010-05,31,17,0,0,25.875,-93.625,2,0,2
2010-05,31,31,0,0,25.875,-90.125,1,0,1
2010-05,31,32,0,0,25.875,-89.875,2,0,2
2010-05,31,33,0,0,25.875,-89.625,1,0,1
2010-05,31,34,0,0,25.875,-89.375,1,0,1
2010-05,31,44,0,0,25.875,-86.875,0,25,25
2010-05,31,51,0,0,25.875,-85.125,2,0,2
2010-05,32,7,0,0,26.125,-96.125,9,0,9
2010-05,32,8,0,0,26.125,-95.875,3,0,3
2010-05,32,16,0,0,26.125,-93.875,19,0,19
2010-05,32,17,0,0,26.125,-93.625,6,0,6
2010-05,32,30,0,0,26.125,-90.375,1,0,1
2010-05,32,31,0,0,26.125,-90.125,3,0,3
2010-05,32,36,0,0,26.125,-88.875,3,0,3
2010-05,32,44,0,0,26.125,-86.875,0,6,6
2010-05,32,51,0,0,26.125,-85.125,1,0,1
2010-05,33,31,0,0,26.375,-90.125,1,0,1
2010-05,33,32,0,0,26.375,-89.875,6,0,6
2010-05,33,33,0,0,26.375,-89.625,3,0,3
2010-05,33,51,0,0,26.375,-85.125,2,0,2
2010-05,34,51,0,0,26.625,-85.125,1,0,1
2010-05,35,9,0,0,26.875,-95.625,0,3,3
2010-05,35,10,0,0,26.875,-95.375,0,11,11
2010-05,35,11,0,0,26.875,-95.125,0,8,8
2010-05,36,9,0,0,27.125,-95.625,0,2,2
2010-05,36,10,0,0,27.125,-95.375,0,4,4
2010-05,37,10,0,0,27.375,-95.375,0,3,3
2010-05,38,40,0,0,27.625,-87.875,1,0,1
2010-05,38,41,0,0,27.625,-87.625,5,0,5
2010-05,38,45,0,0,27.625,-86.625,1,0,1
2010-05,38,46,0,0,27.625,-86.375,5,0,5
2010-05,38,47,0,0,27.625,-86.125,1,0,1
2010-05,39,34,0,0,27.875,-89.375,0,19,19
2010-05,39,42,0,0,27.875,-87.375,2,0,2
2010-05,39,43,0,0,27.875,-87.125,1,0,1
2010-05,39,44,0,0,27.875,-86.875,1,0,1
2010-05,39,45,0,0,27.875,-86.625,1,0,1
2010-05,40,43,0,0,28.125,-87.125,6,0,6
2010-05,40,44,0,0,28.125,-86.875,1,0,1
2010-05,41,43,0,0,28.375,-87.125,2,0,2
2010-06,0,63,0,0,18.125,-82.125,0,2,2
2010-06,1,63,0,0,18.375,-82.125,0,1,1
2010-06,2,44,0,0,18.625,-86.875,0,4,4
2010-06,2,45,0,0,18.625,-86.625,0,3,3
2010-06,3,46,0,0,18.875,-86.375,0,4,4
2010-06,6,49,0,0,19.625,-85.625,0,5,5
2010-06,7,10,0,0,19.875,-95.375,1,0,1
2010-06,7,11,0,0,19.875,-95.125,4,0,4
2010-06,7,12,0,0,19.875,-94.875,1,0,1
2010-06,7,15,0,0,19.875,-94.125,0,4,4
2010-06,7,16,0,0,19.875,-93.875,0,2,2
2010-06,7,47,0,0,19.875,-86.125,0,1,1
2010-06,7,48,0,0,19.875,-85.875,0,1,1
2010-06,7,49,0,0,19.875,-85.625,0,1,1
2010-06,7,69,0,0,19.875,-80.625,6,0,6
2010-06,7,70,0,0,19.875,-80.375,4,0,4
2010-06,8,9,0,0,20.125,-95.625,3,0,3
2010-06,8,15,0,0,20.125,-94.125,0,4,4
2010-06,8,16,0,0,20.125,-93.875,0,5,5
2010-06,8,17,0,0,20.125,-93.625,0,4,4
2010-06,8,47,0,0,20.125,-86.125,0,6,6
2010-06,8,48,0,0,20.125,-85.875,0,3,3
2010-06,8,49,0,0,20.125,-85.625,0,2,2
2010-06,8,70,0,0,20.125,-80.375,4,0,4
2010-06,9,8,0,0,20.375,-95.875,6,0,6
2010-06,9,50,0,0,20.375,-85.375,0,1,1
2010-06,10,7,0,0,20.625,-96.125,6,0,6
2010-06,11,7,0,0,20.875,-96.125,3,0,3
2010-06,11,8,0,0,20.875,-95.875,2,0,2
2010-06,11,55,0,0,20.875,-84.125,1,0,1
2010-06,12,7,0,0,21.125,-96.125,4,0,4
2010-06,12,56,0,0,21.125,-83.875,4,0,4
2010-06,13,56,0,0,21.375,-83.875,1,0,1
2010-06,13,57,0,0,21.375,-83.625,10,0,10
2010-06,17,10,0,0,22.375,-95.375,0,2,2
2010-06,18,10,0,0,22.625,-95.375,0,1,1
2010-06,18,11,0,0,22.625,-95.125,0,3,3
2010-06,18,12,0,0,22.625,-94.875,0,2,2
2010-06,19,12,0,0,22.875,-94.875,0,2,2
2010-06,19,13,0,0,22.875,-94.625,0,4,4
2010-06,20,13,0,0,23.125,-94.625,0,1,1
2010-06,20,14,0,0,23.125,-94.375,0,5,5
2010-06,21,14,0,0,23.375,-94.375,0,2,2
2010-06,21,15,0,0,23.375,-94.125,0,3,3
2010-06,21,30,0,0,23.375,-90.375,0,5,5
2010-06,21,31,0,0,23.375,-90.125,0,11,11
2010-06,21,49,0,0,23.375,-85.625,22,0,22
2010-06,22,15,0,0,23.625,-94.125,0,5,5
2010-06,22,33,0,0,23.625,-89.625,0,2,2
2010-06,22,49,0,0,23.625,-85.625,6,0,6
2010-06,23,22,0,0,23.875,-92.375,2,0,2
2010-06,23,23,0,0,23.875,-92.125,9,0,9
2010-06,23,24,0,0,23.875,-91.875,6,0,6
2010-06,23,33,0,0,23.875,-89.625,0,9,9
2010-06,23,49,0,0,23.875,-85.625,2,0,2
2010-06,23,57,0,0,23.875,-83.625,0,24,24
2010-06,24,24,0,0,24.125,-91.875,4,0,4
2010-06,24,25,0,0,24.125,-91.625,8,0,8
2010-06,24,26,0,0,24.125,-91.375,1,0,1
2010-06,24,33,0,0,24.125,-89.625,0,3,3
2010-06,24,57,0,0,24.125,-83.625,0,1,1
2010-06,24,66,0,0,24.125,-81.375,5,0,5
2010-06,24,67,0,0,24.125,-81.125,5,0,5
2010-06,25,56,0,0,24.375,-83.875,0,3,3
2010-06,25,67,0,0,24.375,-81.125,1,0,1
2010-06,25,68,0,0,24.375,-80.875,4,0,4
2010-06,25,69,0,0,24.375,-80.625,2,0,2
2010-06,26,56,0,0,24.625,-83.875,0,2,2
2010-06,26,69,0,0,24.625,-80.625,2,0,2
2010-06,26,71,0,0,24.625,-80.125,1,0,1
2010-06,27,8,0,0,24.875,-95.875,4,0,4
2010-06,27,9,0,0,24.875,-95.625,7,0,7
2010-06,28,9,0,0,25.125,-95.625,5,0,5
2010-06,28,10,0,0,25.125,-95.375,5,0,5
2010-06,28,40,0,0,25.125,-87.875,0,7,7
2010-06,28,41,0,0,25.125,-87.625,0,9,9
2010-06,28,42,0,0,25.125,-87.375,0,1,1
2010-06,29,25,0,0,25.375,-91.625,0,4,4
2010-06,29,26,0,0,25.375,-91.375,0,5,5
2010-06,29,42,0,0,25.375,-87.375,0,4,4
2010-06,29,43,0,0,25.375,-87.125,0,3,3
2010-06,30,18,0,0,25.625,-93.375,13,0,13
2010-06,30,24,0,0,25.625,-91.875,0,20,20
2010-06,30,43,0,0,25.625,-87.125,0,4,4
2010-06,30,44,0,0,25.625,-86.875,0,2,2
2010-06,31,17,0,0,25.875,-93.625,7,0,7
2010-06,31,18,0,0,25.875,-93.375,6,0,6
2010-06,31,24,0,0,25.875,-91.875,0,1,1
2010-06,32,17,0,0,26.125,-93.625,2,0,2
2010-06,32,47,0,0,26.125,-86.125,1,0,1
2010-06,33,33,0,0,26.375,-89.625,2,0,2
2010-06,33,34,0,0,26.375,-89.375,15,0,15
2010-06,33,47,0,0,26.375,-86.125,2,0,2
2010-06,34,6,0,0,26.625,-96.375,0,2,2
2010-06,34,7,0,0,26.625,-96.125,0,3,3
2010-06,34,34,0,0,26.625,-89.375,10,0,10
2010-06,34,35,0,0,26.625,-89.125,3,0,3
2010-06,34,46,0,0,26.625,-86.375,2,0,2
2010-06,34,47,0,0,26.625,-86.125,4,0,4
2010-06,35,7,0,0,26.875,-96.125,0,2,2
2010-06,35,8,0,0,26.875,-95.875,0,14,14
2010-06,35,9,0,0,26.875,-95.625,0,3,3
2010-06,35,46,0,0,26.875,-86.375,7,0,7
2010-06,36,46,0,0,27.125,-86.375,6,0,6
2010-06,37,46,0,0,27.375,-86.375,7,0,7
2010-06,38,46,0,0,27.625,-86.375,1,0,1
2010-06,40,26,4,1,28.125,-91.375,0,0,0
2010-06,40,27,9,2,28.125,-91.125,0,0,0
2010-06,40,28,10,2,28.125,-90.875,0,0,0
2010-06,40,29,1,1,28.125,-90.625,0,0,0
2010-06,41,25,3,1,28.375,-91.625,0,0,0
2010-06,41,28,1,1,28.375,-90.875,0,0,0
2010-07,0,45,0,0,18.125,-86.625,5,0,5
2010-07,0,46,0,0,18.125,-86.375,6,0,6
2010-07,0,47,0,0,18.125,-86.125,5,0,5
2010-07,0,48,0,0,18.125,-85.875,1,0,1
2010-07,0,62,0,0,18.125,-82.375,0,1,1
2010-07,1,61,0,0,18.375,-82.625,0,1,1
2010-07,1,62,0,0,18.375,-82.375,0,1,1
2010-07,2,54,0,0,18.625,-84.375,0,3,3
2010-07,2,55,0,0,18.625,-84.125,0,3,3
2010-07,2,56,0,0,18.625,-83.875,0,4,4
2010-07,2,57,0,0,18.625,-83.625,0,3,3
2010-07,2,58,0,0,18.625,-83.375,0,2,2
2010-07,3,53,0,0,18.875,-84.625,0,4,4
2010-07,3,54,0,0,18.875,-84.375,0,1,1
2010-07,4,52,0,0,19.125,-84.875,0,1,1
2010-07,5,66,0,0,19.375,-81.375,2,0,2
2010-07,5,67,0,0,19.375,-81.125,4,0,4
2010-07,6,63,0,0,19.625,-82.125,3,0,3
2010-07,6,67,0,0,19.625,-81.125,1,0,1
2010-07,6,68,0,0,19.625,-80.875,4,0,4
2010-07,6,69,0,0,19.625,-80.625,4,0,4
2010-07,7,13,0,0,19.875,-94.625,3,0,3
2010-07,7,49,0,0,19.875,-85.625,0,3,3
2010-07,7,59,0,0,19.875,-83.125,4,0,4
2010-07,7,60,0,0,19.875,-82.875,2,0,2
2010-07,7,61,0,0,19.875,-82.625,2,0,2
2010-07,7,62,0,0,19.875,-82.375,3,0,3
2010-07,7,63,0,0,19.875,-82.125,1,0,1
2010-07,8,12,0,0,20.125,-94.875,9,0,9
2010-07,8,13,0,0,20.125,-94.625,12,0,12
2010-07,8,56,0,0,20.125,-83.875,1,0,1
2010-07,9,13,0,0,20.375,-94.625,7,0,7
2010-07,9,56,0,0,20.375,-83.875,10,0,10
2010-07,10,55,0,0,20.625,-84.125,1,0,1
2010-07,10,56,0,0,20.625,-83.875,2,0,2
2010-07,11,55,0,0,20.875,-84.125,2,0,2
2010-07,17,6,0,0,22.375,-96.375,0,9,9
2010-07,17,7,0,0,22.375,-96.125,0,11,11
2010-07,17,8,0,0,22.375,-95.875,0,6,6
2010-07,17,9,0,0,22.375,-95.625,0,4,4
2010-07,17,10,0,0,22.375,-95.375,0,1,1
2010-07,18,42,0,0,22.625,-87.375,0,4,4
2010-07,18,43,0,0,22.625,-87.125,0,1,1
2010-07,19,43,0,0,22.875,-87.125,0,8,8
2010-07,20,43,0,0,23.125,-87.125,0,1,1
2010-07,21,14,0,0,23.375,-94.375,2,0,2
2010-07,21,18,0,0,23.375,-93.375,2,0,2
2010-07,21,19,0,0,23.375,-93.125,5,0,5
2010-07,22,14,0,0,23.625,-94.375,1,0,1
2010-07,22,22,0,0,23.625,-92.375,3,0,3
2010-07,22,32,0,0,23.625,-89.875,0,9,9
2010-07,22,49,0,0,23.625,-85.625,1,0,1
2010-07,22,58,0,0,23.625,-83.375,0,1,1
2010-07,23,22,0,0,23.875,-92.375,4,0,4
2010-07,23,32,0,0,23.875,-89.875,0,10,10
2010-07,23,46,0,0,23.875,-86.375,2,0,2
2010-07,23,49,0,0,23.875,-85.625,4,0,4
2010-07,23,58,0,0,23.875,-83.375,0,5,5
2010-07,23,59,0,0,23.875,-83.125,0,2,2
2010-07,24,47,0,0,24.125,-86.125,5,0,5
2010-07,24,48,0,0,24.125,-85.875,8,0,8
2010-07,24,49,0,0,24.125,-85.625,11,0,11
2010-07,25,12,0,0,24.375,-94.875,2,0,2
2010-07,25,56,0,0,24.375,-83.875,0,6,6
2010-07,26,12,0,0,24.625,-94.875,2,0,2
2010-07,26,56,0,0,24.625,-83.875,0,1,1
2010-07,27,40,0,0,24.875,-87.875,0,8,8
2010-07,28,10,0,0,25.125,-95.375,11,0,11
2010-07,28,37,0,0,25.125,-88.625,0,2,2
2010-07,28,38,0,0,25.125,-88.375,0,5,5
2010-07,28,39,0,0,25.125,-88.125,0,7,7
2010-07,28,40,0,0,25.125,-87.875,0,9,9
2010-07,29,10,0,0,25.375,-95.375,2,0,2
2010-07,29,11,0,0,25.375,-95.125,6,0,6
2010-07,29,19,0,0,25.375,-93.125,7,0,7
2010-07,29,20,0,0,25.375,-92.875,3,0,3
2010-07,29,26,0,0,25.375,-91.375,0,2,2
2010-07,29,27,0,0,25.375,-91.125,0,1,1
2010-07,30,19,0,0,25.625,-93.125,2,0,2
2010-07,30,27,0,0,25.625,-91.125,0,4,4
2010-07,30,51,0,0,25.625,-85.125,0,2,2
2010-07,31,27,0,0,25.875,-91.125,0,1,1
2010-07,31,28,0,0,25.875,-90.875,0,5,5
2010-07,31,51,0,0,25.875,-85.125,0,3,3
2010-07,31,52,0,0,25.875,-84.875,0,2,2
2010-07,31,53,0,0,25.875,-84.625,0,4,4
2010-07,32,27,0,0,26.125,-91.125,0,1,1
2010-07,32,28,0,0,26.125,-90.875,0,14,14
2010-07,32,52,0,0,26.125,-84.875,0,3,3
2010-07,32,53,0,0,26.125,-84.625,0,5,5
2010-07,32,54,0,0,26.125,-84.375,0,5,5
2010-07,33,6,0,0,26.375,-96.375,0,7,7
2010-07,33,28,0,0,26.375,-90.875,0,3,3
2010-07,34,6,0,0,26.625,-96.375,0,3,3
2010-07,34,35,0,0,26.625,-89.125,2,0,2
2010-07,35,6,0,0,26.875,-96.375,0,2,2
2010-07,35,21,0,0,26.875,-92.625,0,6,6
2010-07,35,25,1,1,26.875,-91.625,0,0,0
2010-07,35,26,1,1,26.875,-91.375,0,0,0
2010-07,35,35,0,0,26.875,-89.125,11,0,11
2010-07,35,38,0,0,26.875,-88.375,1,0,1
2010-07,35,41,0,0,26.875,-87.625,2,0,2
2010-07,35,42,0,0,26.875,-87.375,3,0,3
2010-07,36,21,0,0,27.125,-92.625,0,1,1
2010-07,36,26,1,1,27.125,-91.375,0,0,0
2010-07,36,39,0,0,27.125,-88.125,4,0,4
2010-07,36,40,0,0,27.125,-87.875,6,0,6
2010-07,36,41,0,0,27.125,-87.625,1,0,1
2010-07,37,8,0,0,27.375,-95.875,0,2,2
2010-07,37,21,0,0,27.375,-92.625,0,2,2
2010-07,37,25,0,0,27.375,-91.625,2,0,2
2010-07,37,26,1,1,27.375,-91.375,2,0,2
2010-07,38,8,0,0,27.625,-95.875,0,3,3
2010-07,38,9,0,0,27.625,-95.625,0,2,2
2010-07,38,10,0,0,27.625,-95.375,0,1,1
2010-07,38,21,0,0,27.625,-92.625,0,3,3
2010-07,38,22,0,0,27.625,-92.375,0,3,3
2010-07,38,23,0,0,27.625,-92.125,0,1,1
2010-07,38,25,1,1,27.625,-91.625,2,0,2
2010-07,38,26,0,0,27.625,-91.375,1,0,1
2010-07,38,27,0,0,27.625,-91.125,3,0,3
2010-07,39,10,0,0,27.875,-95.375,0,1,1
2010-07,39,11,0,0,27.875,-95.125,0,6,6
2010-07,39,22,0,0,27.875,-92.375,0,2,2
2010-07,39,23,0,0,27.875,-92.125,0,1,1
2010-07,39,24,1,1,27.875,-91.875,0,0,0
2010-07,40,11,0,0,28.125,-95.125,0,1,1
2010-08,0,42,0,0,18.125,-87.375,2,0,2
2010-08,0,56,0,0,18.125,-83.875,0,6,6
2010-08,0,57,0,0,18.125,-83.625,0,2,2
2010-08,1,52,0,0,18.375,-84.875,0,1,1
2010-08,1,53,0,0,18.375,-84.625,0,3,3
2010-08,1,54,0,0,18.375,-84.375,0,4,4
2010-08,1,55,0,0,18.375,-84.125,0,3,3
2010-08,1,57,0,0,18.375,-83.625,0,3,3
2010-08,7,58,0,0,19.875,-83.375,1,0,1
2010-08,8,10,0,0,20.125,-95.375,6,0,6
2010-08,8,11,0,0,20.125,-95.125,10,0,10
2010-08,8,17,0,0,20.125,-93.625,0,3,3
2010-08,8,51,0,0,20.125,-85.125,2,0,2
2010-08,8,52,0,0,20.125,-84.875,4,0,4
2010-08,8,53,0,0,20.125,-84.625,3,0,3
2010-08,8,54,0,0,20.125,-84.375,1,0,1
2010-08,8,55,0,0,20.125,-84.125,2,0,2
2010-08,8,56,0,0,20.125,-83.875,3,0,3
2010-08,8,58,0,0,20.125,-83.375,1,0,1
2010-08,8,67,0,0,20.125,-81.125,6,0,6
2010-08,8,69,0,0,20.125,-80.625,1,0,1
2010-08,9,10,0,0,20.375,-95.375,7,0,7
2010-08,9,11,0,0,20.375,-95.125,8,0,8
2010-08,9,17,0,0,20.375,-93.625,0,4,4
2010-08,9,51,0,0,20.375,-85.125,6,0,6
2010-08,9,66,0,0,20.375,-81.375,1,0,1
2010-08,9,67,0,0,20.375,-81.125,2,0,2
2010-08,9,68,0,0,20.375,-80.875,1,0,1
2010-08,10,17,0,0,20.625,-93.625,0,1,1
2010-08,10,19,0,0,20.625,-93.125,0,1,1
2010-08,10,50,0,0,20.625,-85.375,5,0,5
2010-08,10,51,0,0,20.625,-85.125,1,0,1
2010-08,10,69,0,0,20.625,-80.625,2,0,2
2010-08,11,17,0,0,20.875,-93.625,0,1,1
2010-08,11,19,0,0,20.875,-93.125,0,2,2
2010-08,11,20,0,0,20.875,-92.875,0,6,6
2010-08,11,50,0,0,20.875,-85.375,2,0,2
2010-08,11,68,0,0,20.875,-80.875,3,0,3
2010-08,11,69,0,0,20.875,-80.625,6,0,6
2010-08,12,17,0,0,21.125,-93.625,0,4,4
2010-08,16,44,0,0,22.125,-86.875,0,5,5
2010-08,17,42,0,0,22.375,-87.375,0,2,2
2010-08,17,43,0,0,22.375,-87.125,0,4,4
2010-08,17,44,0,0,22.375,-86.875,0,9,9
2010-08,18,5,0,0,22.625,-96.625,0,5,5
2010-08,18,6,0,0,22.625,-96.375,0,2,2
2010-08,18,9,0,0,22.625,-95.625,5,0,5
2010-08,18,10,0,0,22.625,-95.375,5,0,5
2010-08,18,11,0,0,22.625,-95.125,4,0,4
2010-08,18,42,0,0,22.625,-87.375,0,7,7
2010-08,18,43,0,0,22.625,-87.125,0,4,4
2010-08,19,4,0,0,22.875,-96.875,0,3,3
2010-08,19,5,0,0,22.875,-96.625,0,9,9
2010-08,19,11,0,0,22.875,-95.125,1,0,1
2010-08,19,12,0,0,22.875,-94.875,4,0,4
2010-08,20,4,0,0,23.125,-96.875,0,5,5
2010-08,20,5,0,0,23.125,-96.625,0,1,1
2010-08,20,12,0,0,23.125,-94.875,3,0,3
2010-08,20,13,0,0,23.125,-94.625,3,0,3
2010-08,21,13,0,0,23.375,-94.625,4,0,4
2010-08,21,55,0,0,23.375,-84.125,0,7,7
2010-08,22,5,0,0,23.625,-96.625,0,2,2
2010-08,22,55,0,0,23.625,-84.125,0,2,2
2010-08,23,29,0,0,23.875,-90.625,0,1,1
2010-08,23,30,0,0,23.875,-90.375,0,6,6
2010-08,23,31,0,0,23.875,-90.125,0,3,3
2010-08,23,46,0,0,23.875,-86.375,5,0,5
2010-08,23,60,0,0,23.875,-82.875,6,0,6
2010-08,23,61,0,0,23.875,-82.625,3,0,3
2010-08,23,62,0,0,23.875,-82.375,6,0,6
2010-08,23,63,0,0,23.875,-82.125,2,0,2
2010-08,24,31,0,0,24.125,-90.125,0,6,6
2010-08,24,32,0,0,24.125,-89.875,0,2,2
2010-08,24,46,0,0,24.125,-86.375,8,0,8
2010-08,24,53,0,0,24.125,-84.625,0,2,2
2010-08,24,60,0,0,24.125,-82.875,1,0,1
2010-08,25,54,0,0,24.375,-84.375,0,6,6
2010-08,25,60,0,0,24.375,-82.875,2,0,2
2010-08,26,54,0,0,24.625,-84.375,0,14,14
2010-08,26,59,0,0,24.625,-83.125,1,0,1
2010-08,27,16,0,0,24.875,-93.875,3,0,3
2010-08,27,34,0,0,24.875,-89.375,0,2,2
2010-08,27,35,0,0,24.875,-89.125,0,5,5
2010-08,27,36,0,0,24.875,-88.875,0,1,1
2010-08,27,39,0,0,24.875,-88.125,0,3,3
2010-08,27,46,0,0,24.875,-86.375,4,0,4
2010-08,27,52,0,0,24.875,-84.875,0,2,2
2010-08,27,60,0,0,24.875,-82.875,1,0,1
2010-08,28,10,0,0,25.125,-95.375,1,0,1
2010-08,28,12,0,0,25.125,-94.875,2,0,2
2010-08,28,13,0,0,25.125,-94.625,5,0,5
2010-08,28,14,0,0,25.125,-94.375,6,0,6
2010-08,28,15,0,0,25.125,-94.125,2,0,2
2010-08,28,16,0,0,25.125,-93.875,3,0,3
2010-08,28,36,0,0,25.125,-88.875,0,3,3
2010-08,28,37,0,0,25.125,-88.625,0,2,2
2010-08,28,39,0,0,25.125,-88.125,0,2,2
2010-08,28,46,0,0,25.125,-86.375,14,0,14
2010-08,28,52,0,0,25.125,-84.875,0,1,1
2010-08,28,59,0,0,25.125,-83.125,1,0,1
2010-08,29,39,0,0,25.375,-88.125,0,4,4
2010-08,29,52,0,0,25.375,-84.875,0,3,3
2010-08,29,60,0,0,25.375,-82.875,1,0,1
2010-08,30,39,0,0,25.625,-88.125,0,9,9
2010-08,30,51,0,0,25.625,-85.125,0,3,3
2010-08,32,28,0,0,26.125,-90.875,0,1,1
2010-08,32,29,0,0,26.125,-90.625,0,13,13
2010-08,32,30,0,0,26.125,-90.375,0,12,12
2010-08,33,23,1,1,26.375,-92.125,0,0,0
2010-08,33,24,1,1,26.375,-91.875,0,0,0
2010-08,33,25,1,1,26.375,-91.625,0,0,0
2010-08,33,26,1,1,26.375,-91.375,0,0,0
2010-08,33,28,0,0,26.375,-90.875,0,4,4
2010-08,33,45,0,0,26.375,-86.625,1,0,1
2010-08,33,46,0,0,26.375,-86.375,1,0,1
2010-08,34,6,0,0,26.625,-96.375,0,7,7
2010-08,34,23,1,1,26.625,-92.125,0,0,0
2010-08,34,27,1,1,26.625,-91.125,0,0,0
2010-08,34,43,0,0,26.625,-87.125,6,0,6
2010-08,34,44,0,0,26.625,-86.875,1,0,1
2010-08,35,6,0,0,26.875,-96.375,0,6,6
2010-08,35,19,0,0,26.875,-93.125,0,7,7
2010-08,35,20,0,0,26.875,-92.875,0,2,2
2010-08,35,21,3,1,26.875,-92.625,0,0,0
2010-08,35,22,3,1,26.875,-92.375,0,0,0
2010-08,35,26,0,0,26.875,-91.375,3,0,3
2010-08,35,27,1,1,26.875,-91.125,0,0,0
2010-08,35,42,0,0,26.875,-87.375,2,0,2
2010-08,35,43,0,0,26.875,-87.125,2,0,2
2010-08,36,18,0,0,27.125,-93.375,0,4,4
2010-08,36,19,1,1,27.125,-93.125,0,4,4
2010-08,36,20,2,1,27.125,-92.875,0,0,0
2010-08,36,21,1,1,27.125,-92.625,0,0,0
2010-08,36,25,0,0,27.125,-91.625,6,0,6
2010-08,36,26,0,0,27.125,-91.375,18,0,18
2010-08,36,28,1,1,27.125,-90.875,0,0,0
2010-08,37,7,0,0,27.375,-96.125,0,3,3
2010-08,37,8,0,0,27.375,-95.875,0,4,4
2010-08,37,18,1,1,27.375,-93.375,0,8,8
2010-08,37,19,0,0,27.375,-93.125,0,6,6
2010-08,37,24,1,1,27.375,-91.875,0,0,0
2010-08,37,25,0,0,27.375,-91.625,4,0,4
2010-08,37,28,1,1,27.375,-90.875,0,0,0
2010-08,38,9,0,0,27.625,-95.625,0,3,3
2010-08,38,10,0,0,27.625,-95.375,0,2,2
2010-08,38,23,1,1,27.625,-92.125,0,0,0
2010-08,38,24,1,1,27.625,-91.875,0,0,0
2010-08,38,25,1,1,27.625,-91.625,0,0,0
2010-08,38,29,1,1,27.625,-90.625,0,0,0
2010-08,39,27,1,1,27.875,-91.125,0,0,0
2010-08,39,28,5,2,27.875,-90.875,0,0,0
2010-09,1,52,0,0,18.375,-84.875,0,1,1
2010-09,2,49,0,0,18.625,-85.625,0,3,3
2010-09,2,50,0,0,18.625,-85.375,0,4,4
2010-09,2,51,0,0,18.625,-85.125,0,3,3
2010-09,2,52,0,0,18.625,-84.875,0,2,2
2010-09,3,49,0,0,18.875,-85.625,0,4,4
2010-09,4,49,0,0,19.125,-85.625,0,6,6
2010-09,5,47,0,0,19.375,-86.125,0,3,3
2010-09,5,48,0,0,19.375,-85.875,0,3,3
2010-09,5,49,0,0,19.375,-85.625,0,1,1
2010-09,7,11,0,0,19.875,-95.125,16,0,16
2010-09,7,12,0,0,19.875,-94.875,1,0,1
2010-09,8,13,0,0,20.125,-94.625,2,0,2
2010-09,8,14,0,0,20.125,-94.375,2,0,2
2010-09,8,15,0,0,20.125,-94.125,2,0,2
2010-09,8,16,0,0,20.125,-93.875,7,0,7
2010-09,8,62,0,0,20.125,-82.375,2,0,2
2010-09,8,63,0,0,20.125,-82.125,2,0,2
2010-09,8,65,0,0,20.125,-81.625,2,0,2
2010-09,9,63,0,0,20.375,-82.125,3,0,3
2010-09,9,64,0,0,20.375,-81.875,11,0,11
2010-09,9,65,0,0,20.375,-81.625,4,0,4
2010-09,9,66,0,0,20.375,-81.375,6,0,6
2010-09,11,49,0,0,20.875,-85.625,3,0,3
2010-09,11,50,0,0,20.875,-85.375,2,0,2
2010-09,11,57,0,0,20.875,-83.625,0,1,1
2010-09,12,9,0,0,21.125,-95.625,0,6,6
2010-09,12,10,0,0,21.125,-95.375,0,3,3
2010-09,12,14,0,0,21.125,-94.375,0,1,1
2010-09,12,15,0,0,21.125,-94.125,0,3,3
2010-09,12,16,0,0,21.125,-93.875,0,5,5
2010-09,12,17,0,0,21.125,-93.625,0,5,5
2010-09,12,50,0,0,21.125,-85.375,2,0,2
2010-09,12,58,0,0,21.125,-83.375,0,2,2
2010-09,13,10,0,0,21.375,-95.375,0,2,2
2010-09,13,11,0,0,21.375,-95.125,0,1,1
2010-09,13,14,0,0,21.375,-94.375,0,3,3
2010-09,18,9,0,0,22.625,-95.625,2,0,2
2010-09,18,25,0,0,22.625,-91.625,1,0,1
2010-09,18,42,0,0,22.625,-87.375,0,1,1
2010-09,19,11,0,0,22.875,-95.125,1,0,1
2010-09,19,25,0,0,22.875,-91.625,4,0,4
2010-09,19,42,0,0,22.875,-87.375,0,1,1
2010-09,21,22,0,0,23.375,-92.375,0,1,1
2010-09,22,21,0,0,23.625,-92.625,0,1,1
2010-09,22,26,0,0,23.625,-91.375,0,2,2
2010-09,22,27,0,0,23.625,-91.125,0,3,3
2010-09,22,28,0,0,23.625,-90.875,0,3,3
2010-09,22,30,0,0,23.625,-90.375,0,1,1
2010-09,23,20,0,0,23.875,-92.875,0,2,2
2010-09,23,21,0,0,23.875,-92.625,0,1,1
2010-09,23,28,0,0,23.875,-90.875,0,4,4
2010-09,23,29,0,0,23.875,-90.625,0,5,5
2010-09,23,55,0,0,23.875,-84.125,0,2,2
2010-09,23,56,0,0,23.875,-83.875,0,5,5
2010-09,23,62,0,0,23.875,-82.375,2,0,2
2010-09,23,63,0,0,23.875,-82.125,5,0,5
2010-09,23,64,0,0,23.875,-81.875,2,0,2
2010-09,23,65,0,0,23.875,-81.625,5,0,5
2010-09,23,66,0,0,23.875,-81.375,3,0,3
2010-09,24,20,0,0,24.125,-92.875,0,8,8
2010-09,24,39,0,0,24.125,-88.125,0,6,6
2010-09,24,55,0,0,24.125,-84.125,0,1,1
2010-09,24,62,0,0,24.125,-82.375,2,0,2
2010-09,25,39,0,0,24.375,-88.125,0,16,16
2010-09,25,55,0,0,24.375,-84.125,0,9,9
2010-09,26,38,0,0,24.625,-88.375,0,3,3
2010-09,26,39,0,0,24.625,-88.125,0,4,4
2010-09,26,55,0,0,24.625,-84.125,0,13,13
2010-09,27,12,0,0,24.875,-94.875,20,0,20
2010-09,27,39,0,0,24.875,-88.125,0,1,1
2010-09,27,46,0,0,24.875,-86.375,1,0,1
2010-09,28,12,0,0,25.125,-94.875,10,0,10
2010-09,28,46,0,0,25.125,-86.375,5,0,5
2010-09,29,46,0,0,25.375,-86.375,24,0,24
2010-09,32,5,0,0,26.125,-96.625,0,4,4
2010-09,32,6,0,0,26.125,-96.375,0,3,3
2010-09,33,24,0,0,26.375,-91.875,10,0,10
2010-09,34,6,0,0,26.625,-96.375,0,3,3
2010-09,34,7,0,0,26.625,-96.125,0,1,1
2010-09,34,12,2,1,26.625,-94.875,0,0,0
2010-09,34,13,1,1,26.625,-94.625,0,0,0
2010-09,34,22,0,0,26.625,-92.375,3,0,3
2010-09,35,6,0,0,26.875,-96.375,0,1,1
2010-09,35,11,3,1,26.875,-95.125,0,0,0
2010-09,35,16,1,1,26.875,-93.875,0,0,0
2010-09,35,17,1,1,26.875,-93.625,0,0,0
2010-09,35,18,2,1,26.875,-93.375,0,0,0
2010-09,35,22,0,0,26.875,-92.375,5,0,5
2010-09,35,23,0,0,26.875,-92.125,5,0,5
2010-09,35,24,0,0,26.875,-91.875,3,0,3
2010-09,36,7,0,0,27.125,-96.125,0,1,1
2010-09,36,8,0,0,27.125,-95.875,0,3,3
2010-09,36,11,10,1,27.125,-95.125,0,0,0
2010-09,36,12,2,1,27.125,-94.875,0,0,0
2010-09,36,13,2,1,27.125,-94.625,0,0,0
2010-09,36,14,1,1,27.125,-94.375,0,0,0
2010-09,36,15,1,1,27.125,-94.125,0,0,0
2010-09,36,16,1,1,27.125,-93.875,0,0,0
2010-09,36,17,0,0,27.125,-93.625,0,1,1
2010-09,36,18,0,0,27.125,-93.375,0,5,5
2010-09,36,19,3,1,27.125,-93.125,0,0,0
2010-09,36,24,0,0,27.125,-91.875,3,0,3
2010-09,36,25,0,0,27.125,-91.625,1,0,1
2010-09,37,17,0,0,27.375,-93.625,0,1,1
2010-09,38,17,0,0,27.625,-93.625,0,6,6
2010-09,38,18,0,0,27.625,-93.375,0,10,10
2010-09,45,45,1,1,29.375,-86.625,0,0,0
2010-09,45,46,2,1,29.375,-86.375,0,0,0
2010-09,46,39,1,1,29.625,-88.125,0,0,0
2010-09,46,42,1,1,29.625,-87.375,0,0,0
2010-09,47,43,1,1,29.875,-87.125,0,0,0
2010-09,47,44,1,1,29.875,-86.875,0,0,0
2010-09,47,45,2,1,29.875,-86.625,0,0,0
2010-10,0,52,0,0,18.125,-84.875,2,0,2
2010-10,1,49,0,0,18.375,-85.625,3,0,3
2010-10,1,50,0,0,18.375,-85.375,1,0,1
2010-10,1,51,0,0,18.375,-85.125,2,0,2
2010-10,1,52,0,0,18.375,-84.875,4,0,4
2010-10,2,50,0,0,18.625,-85.375,3,0,3
2010-10,2,51,0,0,18.625,-85.125,3,0,3
2010-10,2,70,0,0,18.625,-80.375,4,0,4
2010-10,2,71,0,0,18.625,-80.125,3,0,3
2010-10,3,50,0,0,18.875,-85.375,1,0,1
2010-10,3,51,0,0,18.875,-85.125,4,0,4
2010-10,3,52,0,0,18.875,-84.875,1,0,1
2010-10,5,46,0,0,19.375,-86.375,0,1,1
2010-10,5,47,0,0,19.375,-86.125,0,3,3
2010-10,7,62,0,0,19.875,-82.375,1,0,1
2010-10,7,63,0,0,19.875,-82.125,1,0,1
2010-10,8,13,0,0,20.125,-94.625,4,0,4
2010-10,8,62,0,0,20.125,-82.375,4,0,4
2010-10,8,63,0,0,20.125,-82.125,1,0,1
2010-10,9,11,0,0,20.375,-95.125,7,0,7
2010-10,9,12,0,0,20.375,-94.875,7,0,7
2010-10,9,13,0,0,20.375,-94.625,3,0,3
2010-10,9,47,0,0,20.375,-86.125,0,1,1
2010-10,9,48,0,0,20.375,-85.875,0,1,1
2010-10,10,6,0,0,20.625,-96.375,0,3,3
2010-10,10,12,0,0,20.625,-94.875,2,0,2
2010-10,11,6,0,0,20.875,-96.375,0,2,2
2010-10,11,7,0,0,20.875,-96.125,0,9,9
2010-10,11,8,0,0,20.875,-95.875,0,3,3
2010-10,11,55,0,0,20.875,-84.125,0,1,1
2010-10,11,57,0,0,20.875,-83.625,0,3,3
2010-10,11,58,0,0,20.875,-83.375,0,7,7
2010-10,12,8,0,0,21.125,-95.875,0,5,5
2010-10,12,9,0,0,21.125,-95.625,0,3,3
2010-10,12,55,0,0,21.125,-84.125,0,5,5
2010-10,12,56,0,0,21.125,-83.875,0,3,3
2010-10,12,57,0,0,21.125,-83.625,0,2,2
2010-10,12,58,0,0,21.125,-83.375,0,6,6
2010-10,16,9,0,0,22.125,-95.625,13,0,13
2010-10,18,24,0,0,22.625,-91.875,2,0,2
2010-10,19,23,0,0,22.875,-92.125,4,0,4
2010-10,19,24,0,0,22.875,-91.875,10,0,10
2010-10,20,23,0,0,23.125,-92.125,11,0,11
2010-10,21,22,0,0,23.375,-92.375,1,0,1
2010-10,23,55,0,0,23.875,-84.125,0,2,2
2010-10,23,56,0,0,23.875,-83.875,0,4,4
2010-10,23,64,0,0,23.875,-81.875,2,0,2
2010-10,23,66,0,0,23.875,-81.375,6,0,6
2010-10,23,67,0,0,23.875,-81.125,6,0,6
2010-10,23,68,0,0,23.875,-80.875,2,0,2
2010-10,24,19,0,0,24.125,-93.125,0,12,12
2010-10,24,20,0,0,24.125,-92.875,0,2,2
2010-10,24,37,0,0,24.125,-88.625,0,4,4
2010-10,24,38,0,0,24.125,-88.375,0,1,1
2010-10,24,53,0,0,24.125,-84.625,0,11,11
2010-10,24,54,0,0,24.125,-84.375,0,1,1
2010-10,24,55,0,0,24.125,-84.125,0,9,9
2010-10,25,19,0,0,24.375,-93.125,0,2,2
2010-10,25,20,0,0,24.375,-92.875,0,14,14
2010-10,25,36,0,0,24.375,-88.875,0,2,2
2010-10,25,37,0,0,24.375,-88.625,0,9,9
2010-10,25,38,0,0,24.375,-88.375,0,3,3
2010-10,25,54,0,0,24.375,-84.375,0,4,4
2010-10,26,37,0,0,24.625,-88.625,0,3,3
2010-10,26,38,0,0,24.625,-88.375,0,9,9
2010-10,26,45,0,0,24.625,-86.625,11,0,11
2010-10,27,11,0,0,24.875,-95.125,28,0,28
2010-10,27,12,0,0,24.875,-94.875,2,0,2
2010-10,27,22,0,0,24.875,-92.375,0,1,1
2010-10,27,45,0,0,24.875,-86.625,7,0,7
2010-10,27,46,0,0,24.875,-86.375,1,0,1
2010-10,28,11,0,0,25.125,-95.125,1,0,1
2010-10,28,45,0,0,25.125,-86.625,12,0,12
2010-10,31,20,1,1,25.875,-92.875,0,0,0
2010-10,32,20,1,1,26.125,-92.875,0,0,0
2010-10,33,19,1,1,26.375,-93.125,0,0,0
2010-10,33,21,1,1,26.375,-92.625,0,0,0
2010-10,34,6,0,0,26.625,-96.375,0,4,4
2010-10,34,7,0,0,26.625,-96.125,0,5,5
2010-10,34,13,3,1,26.625,-94.625,0,0,0
2010-10,34,16,1,1,26.625,-93.875,0,0,0
2010-10,34,17,1,1,26.625,-93.625,0,0,0
2010-10,34,18,1,1,26.625,-93.375,0,0,0
2010-10,34,21,7,1,26.625,-92.625,4,0,4
2010-10,34,22,0,0,26.625,-92.375,8,0,8
2010-10,34,23,0,0,26.625,-92.125,11,0,11
2010-10,35,7,0,0,26.875,-96.125,0,5,5
2010-10,35,8,0,0,26.875,-95.875,0,3,3
2010-10,35,13,1,1,26.875,-94.625,0,0,0
2010-10,35,15,1,1,26.875,-94.125,0,0,0
2010-10,35,19,0,0,26.875,-93.125,2,0,2
2010-10,35,20,0,0,26.875,-92.875,3,0,3
2010-10,35,21,0,0,26.875,-92.625,1,0,1
2010-10,41,29,0,0,28.375,-90.625,0,4,4
2010-10,41,30,0,0,28.375,-90.375,0,11,11
2010-10,41,31,0,0,28.375,-90.125,0,2,2
2010-10,41,46,0,0,28.375,-86.375,0,1,1
2010-10,41,47,0,0,28.375,-86.125,0,2,2
2010-10,42,44,1,1,28.625,-86.875,0,0,0
2010-10,42,47,0,0,28.625,-86.125,0,6,6
2010-10,43,44,3,1,28.875,-86.875,0,4,4
2010-10,43,45,0,0,28.875,-86.625,0,1,1
2010-10,43,46,0,0,28.875,-86.375,0,3,3
2010-10,44,44,3,1,29.125,-86.875,0,0,0
2010-10,45,43,2,1,29.375,-87.125,0,0,0
2010-10,45,44,1,1,29.375,-86.875,0,0,0
2010-10,46,43,3,1,29.625,-87.125,0,0,0
2010-10,46,46,1,1,29.625,-86.375,0,0,0
2010-10,46,71,0,0,29.625,-80.125,0,3,3
2010-10,47,43,1,1,29.875,-87.125,0,0,0
2010-10,47,46,1,1,29.875,-86.375,0,0,0
2010-10,47,70,0,0,29.875,-80.375,0,3,3
2010-10,48,45,2,1,30.125,-86.625,0,0,0
2010-10,48,46,3,1,30.125,-86.375,0,0,0
2010-10,50,70,0,0,30.625,-80.375,0,2,2
2010-11,0,70,0,0,18.125,-80.375,1,0,1
2010-11,2,67,0,0,18.625,-81.125,2,0,2
2010-11,2,68,0,0,18.625,-80.875,2,0,2
2010-11,2,69,0,0,18.625,-80.625,2,0,2
2010-11,3,49,0,0,18.875,-85.625,3,0,3
2010-11,3,50,0,0,18.875,-85.375,3,0,3
2010-11,3,66,0,0,18.875,-81.375,3,0,3
2010-11,3,67,0,0,18.875,-81.125,1,0,1
2010-11,4,47,0,0,19.125,-86.125,1,0,1
2010-11,4,48,0,0,19.125,-85.875,5,0,5
2010-11,4,49,0,0,19.125,-85.625,2,0,2
2010-11,4,64,0,0,19.125,-81.875,6,0,6
2010-11,4,65,0,0,19.125,-81.625,4,0,4
2010-11,5,47,0,0,19.375,-86.125,3,0,3
2010-11,5,62,0,0,19.375,-82.375,1,0,1
2010-11,5,63,0,0,19.375,-82.125,5,0,5
2010-11,5,64,0,0,19.375,-81.875,1,0,1
2010-11,6,47,0,0,19.625,-86.125,2,0,2
2010-11,6,48,0,0,19.625,-85.875,1,0,1
2010-11,7,10,0,0,19.875,-95.375,4,0,4
2010-11,7,11,0,0,19.875,-95.125,4,0,4
2010-11,7,12,0,0,19.875,-94.875,3,0,3
2010-11,7,13,0,0,19.875,-94.625,2,0,2
2010-11,7,14,0,0,19.875,-94.375,2,0,2
2010-11,7,48,0,0,19.875,-85.875,3,0,3
2010-11,8,10,0,0,20.125,-95.375,4,0,4
2010-11,8,11,0,0,20.125,-95.125,2,0,2
2010-11,8,12,0,0,20.125,-94.875,4,0,4
2010-11,10,49,0,0,20.625,-85.625,5,0,5
2010-11,11,56,0,0,20.875,-83.875,0,12,12
2010-11,12,54,0,0,21.125,-84.375,0,6,6
2010-11,12,55,0,0,21.125,-84.125,0,7,7
2010-11,12,56,0,0,21.125,-83.875,0,5,5
2010-11,13,13,0,0,21.375,-94.625,0,2,2
2010-11,13,14,0,0,21.375,-94.375,0,2,2
2010-11,14,13,0,0,21.625,-94.625,0,2,2
2010-11,15,13,0,0,21.875,-94.625,0,1,1
2010-11,16,8,0,0,22.125,-95.875,10,0,10
2010-11,16,9,0,0,22.125,-95.625,14,0,14
2010-11,16,13,0,0,22.125,-94.625,0,5,5
2010-11,16,14,0,0,22.125,-94.375,0,2,2
2010-11,17,8,0,0,22.375,-95.875,1,0,1
2010-11,17,9,0,0,22.375,-95.625,5,0,5
2010-11,17,13,0,0,22.375,-94.625,0,2,2
2010-11,17,14,0,0,22.375,-94.375,0,2,2
2010-11,20,23,0,0,23.125,-92.125,2,0,2
2010-11,21,18,0,0,23.375,-93.375,9,0,9
2010-11,21,21,0,0,23.375,-92.625,2,0,2
2010-11,21,22,0,0,23.375,-92.375,1,0,1
2010-11,22,19,0,0,23.625,-93.125,7,0,7
2010-11,22,20,0,0,23.625,-92.875,4,0,4
2010-11,22,21,0,0,23.625,-92.625,1,0,1
2010-11,23,40,0,0,23.875,-87.875,0,5,5
2010-11,24,38,0,0,24.125,-88.375,0,3,3
2010-11,24,39,0,0,24.125,-88.125,0,6,6
2010-11,24,40,0,0,24.125,-87.875,0,3,3
2010-11,24,54,0,0,24.125,-84.375,0,4,4
2010-11,25,38,0,0,24.375,-88.375,0,11,11
2010-11,25,39,0,0,24.375,-88.125,0,2,2
2010-11,25,53,0,0,24.375,-84.625,0,8,8
2010-11,25,54,0,0,24.375,-84.375,0,1,1
2010-11,26,53,0,0,24.625,-84.625,0,10,10
2010-11,26,54,0,0,24.625,-84.375,0,7,7
2010-11,27,11,0,0,24.875,-95.125,1,0,1
2010-11,27,20,0,0,24.875,-92.875,0,2,2
2010-11,27,21,0,0,24.875,-92.625,0,6,6
2010-11,27,22,0,0,24.875,-92.375,0,4,4
2010-11,27,45,0,0,24.875,-86.625,8,0,8
2010-11,28,10,0,0,25.125,-95.375,7,0,7
2010-11,28,11,0,0,25.125,-95.125,22,0,22
2010-11,28,21,0,0,25.125,-92.625,0,3,3
2010-11,28,22,0,0,25.125,-92.375,0,9,9
2010-11,28,23,0,0,25.125,-92.125,0,2,2
2010-11,28,45,0,0,25.125,-86.625,6,0,6
2010-11,29,23,0,0,25.375,-92.125,0,4,4
2010-11,29,45,0,0,25.375,-86.625,6,0,6
2010-11,30,45,0,0,25.625,-86.625,10,0,10
2010-11,30,47,1,1,25.625,-86.125,0,0,0
2010-11,31,46,1,1,25.875,-86.375,0,0,0
2010-11,32,45,1,1,26.125,-86.625,0,0,0
2010-11,32,46,1,1,26.125,-86.375,0,0,0
2010-11,33,44,2,1,26.375,-86.875,0,0,0
2010-11,33,45,1,1,26.375,-86.625,0,0,0
2010-11,34,44,2,1,26.625,-86.875,0,0,0
2010-11,35,8,0,0,26.875,-95.875,0,6,6
2010-11,35,44,1,1,26.875,-86.875,0,0,0
2010-11,36,8,0,0,27.125,-95.875,0,5,5
2010-11,36,9,0,0,27.125,-95.625,0,7,7
2010-11,36,43,1,1,27.125,-87.125,0,0,0
2010-11,36,44,1,1,27.125,-86.875,0,0,0
2010-11,37,8,0,0,27.375,-95.875,0,8,8
2010-11,37,43,2,1,27.375,-87.125,0,0,0
2010-11,38,43,3,1,27.625,-87.125,0,0,0
2010-11,39,32,0,0,27.875,-89.875,0,4,4
2010-11,39,33,0,0,27.875,-89.625,0,2,2
2010-11,39,43,2,1,27.875,-87.125,0,0,0
2010-11,40,31,0,0,28.125,-90.125,0,3,3
2010-11,40,32,0,0,28.125,-89.875,0,4,4
2010-11,40,43,4,1,28.125,-87.125,0,0,0
2010-11,41,43,1,1,28.375,-87.125,0,2,2
2010-11,41,44,1,1,28.375,-86.875,0,1,1
2010-11,41,45,0,0,28.375,-86.625,0,8,8
2010-11,41,46,0,0,28.375,-86.375,0,1,1
2010-11,42,44,3,1,28.625,-86.875,0,9,9
2010-11,43,44,0,0,28.875,-86.875,0,6,6
2010-11,43,45,1,1,28.875,-86.625,0,3,3
2010-11,44,45,1,1,29.125,-86.625,0,0,0
2010-12,1,69,0,0,18.375,-80.625,3,0,3
2010-12,1,70,0,0,18.375,-80.375,1,0,1
2010-12,1,71,0,0,18.375,-80.125,1,0,1
2010-12,2,65,0,0,18.625,-81.625,1,0,1
2010-12,2,66,0,0,18.625,-81.375,1,0,1
2010-12,2,67,0,0,18.625,-81.125,2,0,2
2010-12,2,68,0,0,18.625,-80.875,2,0,2
2010-12,5,59,0,0,19.375,-83.125,1,0,1
2010-12,5,60,0,0,19.375,-82.875,3,0,3
2010-12,5,61,0,0,19.375,-82.625,3,0,3
2010-12,5,62,0,0,19.375,-82.375,3,0,3
2010-12,6,59,0,0,19.625,-83.125,8,0,8
2010-12,6,60,0,0,19.625,-82.875,4,0,4
2010-12,6,61,0,0,19.625,-82.625,1,0,1
2010-12,7,9,0,0,19.875,-95.625,2,0,2
2010-12,7,10,0,0,19.875,-95.375,6,0,6
2010-12,7,58,0,0,19.875,-83.375,5,0,5
2010-12,7,59,0,0,19.875,-83.125,3,0,3
2010-12,8,69,0,0,20.125,-80.625,0,1,1
2010-12,8,70,0,0,20.125,-80.375,0,4,4
2010-12,8,71,0,0,20.125,-80.125,0,4,4
2010-12,9,68,0,0,20.375,-80.875,0,3,3
2010-12,9,69,0,0,20.375,-80.625,0,3,3
2010-12,10,49,0,0,20.625,-85.625,1,0,1
2010-12,11,48,0,0,20.875,-85.875,4,0,4
2010-12,11,49,0,0,20.875,-85.625,3,0,3
2010-12,11,55,0,0,20.875,-84.125,0,11,11
2010-12,11,56,0,0,20.875,-83.875,0,6,6
2010-12,12,48,0,0,21.125,-85.875,3,0,3
2010-12,12,49,0,0,21.125,-85.625,1,0,1
2010-12,12,55,0,0,21.125,-84.125,0,1,1
2010-12,12,56,0,0,21.125,-83.875,0,3,3
2010-12,12,57,0,0,21.125,-83.625,0,2,2
2010-12,13,12,0,0,21.375,-94.875,0,10,10
2010-12,13,13,0,0,21.375,-94.625,0,20,20
2010-12,14,13,0,0,21.625,-94.625,0,1,1
2010-12,14,50,0,0,21.625,-85.375,1,0,1
2010-12,16,7,0,0,22.125,-96.125,1,0,1
2010-12,16,8,0,0,22.125,-95.875,2,0,2
2010-12,20,8,0,0,23.125,-95.875,2,0,2
2010-12,21,7,0,0,23.375,-96.125,1,0,1
2010-12,21,8,0,0,23.375,-95.875,1,0,1
2010-12,21,16,0,0,23.375,-93.875,2,0,2
2010-12,21,17,0,0,23.375,-93.625,3,0,3
2010-12,22,7,0,0,23.625,-96.125,2,0,2
2010-12,22,8,0,0,23.625,-95.875,4,0,4
2010-12,23,51,0,0,23.875,-85.125,0,5,5
2010-12,23,52,0,0,23.875,-84.875,0,8,8
2010-12,24,40,0,0,24.125,-87.875,0,5,5
2010-12,24,45,1,1,24.125,-86.625,0,0,0
2010-12,24,52,0,0,24.125,-84.875,0,6,6
2010-12,24,53,0,0,24.125,-84.625,0,10,10
2010-12,24,54,0,0,24.125,-84.375,0,1,1
2010-12,25,36,0,0,24.375,-88.875,0,2,2
2010-12,25,38,2,1,24.375,-88.375,0,0,0
2010-12,25,39,2,1,24.375,-88.125,0,0,0
2010-12,25,40,1,1,24.375,-87.875,0,0,0
2010-12,25,41,1,1,24.375,-87.625,0,0,0
2010-12,25,43,1,1,24.375,-87.125,0,0,0
2010-12,25,44,2,1,24.375,-86.875,0,0,0
2010-12,25,45,1,1,24.375,-86.625,0,0,0
2010-12,25,46,2,1,24.375,-86.375,0,0,0
2010-12,25,47,1,1,24.375,-86.125,0,0,0
2010-12,25,48,2,1,24.375,-85.875,0,0,0
2010-12,25,54,0,0,24.375,-84.375,0,1,1
2010-12,26,33,0,0,24.625,-89.625,0,6,6
2010-12,26,34,0,0,24.625,-89.375,0,6,6
2010-12,26,35,0,0,24.625,-89.125,0,3,3
2010-12,26,36,0,0,24.625,-88.875,0,4,4
2010-12,26,37,0,0,24.625,-88.625,0,2,2
2010-12,26,38,1,1,24.625,-88.375,0,2,2
2010-12,26,39,1,1,24.625,-88.125,0,0,0
2010-12,26,47,1,1,24.625,-86.125,0,0,0
2010-12,26,48,2,1,24.625,-85.875,0,0,0
2010-12,27,17,0,0,24.875,-93.625,0,11,11
2010-12,27,48,2,1,24.875,-85.875,0,0,0
2010-12,27,49,2,1,24.875,-85.625,0,0,0
2010-12,28,10,0,0,25.125,-95.375,3,0,3
2010-12,28,17,0,0,25.125,-93.625,0,1,1
2010-12,28,18,0,0,25.125,-93.375,0,7,7
2010-12,28,19,0,0,25.125,-93.125,0,9,9
2010-12,28,20,0,0,25.125,-92.875,0,2,2
2010-12,28,48,2,1,25.125,-85.875,0,0,0
2010-12,28,49,2,1,25.125,-85.625,0,0,0
2010-12,29,10,0,0,25.375,-95.375,10,0,10
2010-12,29,17,0,0,25.375,-93.625,0,1,1
2010-12,29,48,1,1,25.375,-85.875,0,0,0
2010-12,30,10,0,0,25.625,-95.375,5,0,5
2010-12,30,11,0,0,25.625,-95.125,1,0,1
2010-12,30,45,0,0,25.625,-86.625,28,0,28
2010-12,30,47,1,1,25.625,-86.125,0,0,0
2010-12,30,50,0,0,25.625,-85.375,3,0,3
2010-12,31,11,0,0,25.875,-95.125,3,0,3
2010-12,31,40,0,0,25.875,-87.875,3,0,3
2010-12,32,12,0,0,26.125,-94.875,9,0,9
2010-12,35,7,0,0,26.875,-96.125,0,4,4
2010-12,35,8,0,0,26.875,-95.875,0,6,6
2010-12,36,8,0,0,27.125,-95.875,0,18,18
2010-12,41,42,0,0,28.375,-87.375,0,3,3
2010-12,41,43,0,0,28.375,-87.125,0,2,2
2010-12,42,41,0,0,28.625,-87.625,0,1,1
2010-12,42,42,0,0,28.625,-87.375,0,11,11
2011-01,1,70,0,0,18.375,-80.375,3,0,3
2011-01,2,70,0,0,18.625,-80.375,1,0,1
2011-01,2,71,0,0,18.625,-80.125,3,0,3
2011-01,3,70,0,0,18.875,-80.375,3,0,3
2011-01,5,56,0,0,19.375,-83.875,1,0,1
2011-01,5,57,0,0,19.375,-83.625,3,0,3
2011-01,5,58,0,0,19.375,-83.375,2,0,2
2011-01,5,59,0,0,19.375,-83.125,1,0,1
2011-01,6,53,0,0,19.625,-84.625,2,0,2
2011-01,6,54,0,0,19.625,-84.375,2,0,2
2011-01,6,55,0,0,19.625,-84.125,3,0,3
2011-01,6,56,0,0,19.625,-83.875,1,0,1
2011-01,7,52,0,0,19.875,-84.875,5,0,5
2011-01,7,53,0,0,19.875,-84.625,1,0,1
2011-01,8,50,0,0,20.125,-85.375,5,0,5
2011-01,8,51,0,0,20.125,-85.125,4,0,4
2011-01,8,69,0,0,20.125,-80.625,0,1,1
2011-01,9,13,0,0,20.375,-94.625,0,6,6
2011-01,9,50,0,0,20.375,-85.375,1,0,1
2011-01,9,66,0,0,20.375,-81.375,0,1,1
2011-01,9,67,0,0,20.375,-81.125,0,3,3
2011-01,9,68,0,0,20.375,-80.875,0,6,6
2011-01,10,13,0,0,20.625,-94.625,0,4,4
2011-01,10,64,0,0,20.625,-81.875,0,3,3
2011-01,10,65,0,0,20.625,-81.625,0,9,9
2011-01,10,66,0,0,20.625,-81.375,0,1,1
2011-01,11,69,0,0,20.875,-80.625,0,2,2
2011-01,11,70,0,0,20.875,-80.375,0,1,1
2011-01,12,11,0,0,21.125,-95.125,0,1,1
2011-01,12,12,0,0,21.125,-94.875,0,5,5
2011-01,13,9,0,0,21.375,-95.625,0,1,1
2011-01,13,10,0,0,21.375,-95.375,0,5,5
2011-01,13,11,0,0,21.375,-95.125,0,3,3
2011-01,14,7,0,0,21.625,-96.125,0,3,3
2011-01,14,8,0,0,21.625,-95.875,0,4,4
2011-01,14,9,0,0,21.625,-95.625,0,1,1
2011-01,15,6,0,0,21.875,-96.375,0,4,4
2011-01,15,7,0,0,21.875,-96.125,0,4,4
2011-01,20,19,0,0,23.125,-93.125,2,0,2
2011-01,20,20,0,0,23.125,-92.875,1,0,1
2011-01,21,6,0,0,23.375,-96.375,1,0,1
2011-01,21,7,0,0,23.375,-96.125,4,0,4
2011-01,21,20,0,0,23.375,-92.875,5,0,5
2011-01,21,21,0,0,23.375,-92.625,5,0,5
2011-01,21,22,0,0,23.375,-92.375,4,0,4
2011-01,22,6,0,0,23.625,-96.375,17,0,17
2011-01,22,7,0,0,23.625,-96.125,2,0,2
2011-01,22,22,0,0,23.625,-92.375,3,0,3
2011-01,22,23,0,0,23.625,-92.125,7,0,7
2011-01,22,54,0,0,23.625,-84.375,0,3,3
2011-01,22,55,0,0,23.625,-84.125,0,4,4
2011-01,22,56,0,0,23.625,-83.875,0,4,4
2011-01,22,57,0,0,23.625,-83.625,0,2,2
2011-01,23,6,0,0,23.875,-96.375,4,0,4
2011-01,23,50,0,0,23.875,-85.375,0,5,5
2011-01,23,51,0,0,23.875,-85.125,0,5,5
2011-01,23,53,0,0,23.875,-84.625,0,4,4
2011-01,23,54,0,0,23.875,-84.375,0,1,1
2011-01,24,7,0,0,24.125,-96.125,2,0,2
2011-01,25,27,0,0,24.375,-91.125,0,2,2
2011-01,25,28,0,0,24.375,-90.875,0,4,4
2011-01,25,29,0,0,24.375,-90.625,0,7,7
2011-01,25,30,0,0,24.375,-90.375,0,6,6
2011-01,25,31,0,0,24.375,-90.125,0,7,7
2011-01,25,32,0,0,24.375,-89.875,0,1,1
2011-01,26,32,0,0,24.625,-89.875,0,4,4
2011-01,26,51,0,0,24.625,-85.125,3,0,3
2011-01,27,17,0,0,24.875,-93.625,0,6,6
2011-01,27,39,1,1,24.875,-88.125,0,0,0
2011-01,27,40,1,1,24.875,-87.875,0,0,0
2011-01,27,50,0,0,24.875,-85.375,3,0,3
2011-01,27,51,0,0,24.875,-85.125,6,0,6
2011-01,28,17,0,0,25.125,-93.625,0,11,11
2011-01,28,41,2,1,25.125,-87.625,0,0,0
2011-01,28,50,0,0,25.125,-85.375,6,0,6
2011-01,29,17,0,0,25.375,-93.625,0,13,13
2011-01,29,41,1,1,25.375,-87.625,0,0,0
2011-01,29,42,1,1,25.375,-87.375,0,0,0
2011-01,29,50,0,0,25.375,-85.375,6,0,6
2011-01,30,17,0,0,25.625,-93.625,0,1,1
2011-01,30,37,0,0,25.625,-88.625,2,0,2
2011-01,30,38,0,0,25.625,-88.375,4,0,4
2011-01,30,42,3,1,25.625,-87.375,0,0,0
2011-01,30,43,5,1,25.625,-87.125,0,0,0
2011-01,30,50,0,0,25.625,-85.375,3,0,3
2011-01,30,51,0,0,25.625,-85.125,4,0,4
2011-01,31,37,0,0,25.875,-88.625,7,0,7
2011-01,31,38,0,0,25.875,-88.375,7,0,7
2011-01,31,39,0,0,25.875,-88.125,1,0,1
2011-01,31,44,2,1,25.875,-86.875,0,0,0
2011-01,31,45,0,0,25.875,-86.625,0,9,9
2011-01,32,12,0,0,26.125,-94.875,1,0,1
2011-01,32,13,0,0,26.125,-94.625,3,0,3
2011-01,32,37,0,0,26.125,-88.625,5,0,5
2011-01,32,39,0,0,26.125,-88.125,2,0,2
2011-01,32,44,6,1,26.125,-86.875,0,0,0
2011-01,32,45,1,1,26.125,-86.625,0,0,0
2011-01,33,13,0,0,26.375,-94.625,22,0,22
2011-01,33,14,0,0,26.375,-94.375,5,0,5
2011-01,33,37,0,0,26.375,-88.625,3,0,3
2011-01,33,45,6,1,26.375,-86.625,0,0,0
2011-01,34,45,2,1,26.625,-86.625,0,0,0
2011-01,36,7,0,0,27.125,-96.125,0,4,4
2011-01,40,42,0,0,28.125,-87.375,0,1,1
2011-01,41,42,0,0,28.375,-87.375,0,10,10
2011-02,0,51,0,0,18.125,-85.125,0,2,2
2011-02,0,52,0,0,18.125,-84.875,0,3,3
2011-02,1,49,0,0,18.375,-85.625,0,2,2
2011-02,1,50,0,0,18.375,-85.375,0,1,1
2011-02,2,47,0,0,18.625,-86.125,0,4,4
2011-02,2,48,0,0,18.625,-85.875,0,3,3
2011-02,2,49,0,0,18.625,-85.625,0,1,1
2011-02,3,47,0,0,18.875,-86.125,0,1,1
2011-02,3,69,0,0,18.875,-80.625,4,0,4
2011-02,4,68,0,0,19.125,-80.875,4,0,4
2011-02,4,69,0,0,19.125,-80.625,3,0,3
2011-02,5,67,0,0,19.375,-81.125,1,0,1
2011-02,5,68,0,0,19.375,-80.875,6,0,6
2011-02,8,51,0,0,20.125,-85.125,3,0,3
2011-02,9,12,0,0,20.375,-94.875,0,2,2
2011-02,9,13,0,0,20.375,-94.625,0,12,12
2011-02,9,51,0,0,20.375,-85.125,8,0,8
2011-02,9,52,0,0,20.375,-84.875,6,0,6
2011-02,10,13,0,0,20.625,-94.625,0,14,14
2011-02,10,50,0,0,20.625,-85.375,1,0,1
2011-02,10,51,0,0,20.625,-85.125,10,0,10
2011-02,10,61,0,0,20.625,-82.625,0,1,1
2011-02,10,62,0,0,20.625,-82.375,0,3,3
2011-02,10,65,0,0,20.625,-81.625,0,1,1
2011-02,10,66,0,0,20.625,-81.375,0,2,2
2011-02,10,67,0,0,20.625,-81.125,0,3,3
2011-02,10,68,0,0,20.625,-80.875,0,3,3
2011-02,11,62,0,0,20.875,-82.375,0,9,9
2011-02,11,63,0,0,20.875,-82.125,0,1,1
2011-02,11,68,0,0,20.875,-80.875,0,1,1
2011-02,11,69,0,0,20.875,-80.625,0,1,1
2011-02,15,6,0,0,21.875,-96.375,0,2,2
2011-02,16,6,0,0,22.125,-96.375,0,3,3
2011-02,17,6,0,0,22.375,-96.375,0,3,3
2011-02,18,6,0,0,22.625,-96.375,0,1,1
2011-02,19,6,0,0,22.875,-96.375,0,2,2
2011-02,20,6,0,0,23.125,-96.375,0,4,4
2011-02,20,18,0,0,23.125,-93.375,1,0,1
2011-02,20,19,0,0,23.125,-93.125,12,0,12
2011-02,21,6,0,0,23.375,-96.375,0,1,1
2011-02,21,18,0,0,23.375,-93.375,13,0,13
2011-02,21,19,0,0,23.375,-93.125,2,0,2
2011-02,22,57,0,0,23.625,-83.625,0,5,5
2011-02,22,58,0,0,23.625,-83.375,0,9,9
2011-02,22,59,0,0,23.625,-83.125,0,6,6
2011-02,23,9,0,0,23.875,-95.625,0,2,2
2011-02,23,59,0,0,23.875,-83.125,0,5,5
2011-02,24,7,0,0,24.125,-96.125,2,0,2
2011-02,24,8,0,0,24.125,-95.875,0,1,1
2011-02,24,9,0,0,24.125,-95.625,0,6,6
2011-02,24,10,0,0,24.125,-95.375,0,1,1
2011-02,24,11,0,0,24.125,-95.125,0,1,1
2011-02,24,25,0,0,24.125,-91.625,0,5,5
2011-02,24,51,0,0,24.125,-85.125,6,0,6
2011-02,24,52,0,0,24.125,-84.875,2,0,2
2011-02,25,6,0,0,24.375,-96.375,5,0,5
2011-02,25,12,0,0,24.375,-94.875,0,2,2
2011-02,25,25,0,0,24.375,-91.625,0,4,4
2011-02,25,26,0,0,24.375,-91.375,0,14,14
2011-02,25,27,0,0,24.375,-91.125,0,5,5
2011-02,25,51,0,0,24.375,-85.125,10,0,10
2011-02,26,6,0,0,24.625,-96.375,1,0,1
2011-02,26,14,0,0,24.625,-94.375,0,1,1
2011-02,26,51,0,0,24.625,-85.125,10,0,10
2011-02,27,15,0,0,24.875,-94.125,0,6,6
2011-02,27,16,0,0,24.875,-93.875,0,4,4
2011-02,28,7,0,0,25.125,-96.125,1,0,1
2011-02,29,7,0,0,25.375,-96.125,1,0,1
2011-02,29,8,0,0,25.375,-95.875,7,0,7
2011-02,29,9,0,0,25.375,-95.625,5,0,5
2011-02,29,17,0,0,25.375,-93.625,0,3,3
2011-02,31,44,0,0,25.875,-86.875,0,7,7
2011-02,31,45,0,0,25.875,-86.625,0,20,20
2011-02,32,45,0,0,26.125,-86.625,0,1,1
2011-02,33,14,0,0,26.375,-94.375,7,0,7
2011-02,33,15,0,0,26.375,-94.125,2,0,2
2011-02,33,34,0,0,26.375,-89.375,13,0,13
2011-02,33,35,0,0,26.375,-89.125,7,0,7
2011-02,33,36,0,0,26.375,-88.875,8,0,8
2011-02,34,14,0,0,26.625,-94.375,7,0,7
2011-02,34,15,0,0,26.625,-94.125,10,0,10
2011-02,34,44,1,1,26.625,-86.875,0,0,0
2011-02,35,14,0,0,26.875,-94.375,2,0,2
2011-02,35,20,0,0,26.875,-92.875,0,11,11
2011-02,36,19,0,0,27.125,-93.125,0,6,6
2011-02,36,20,0,0,27.125,-92.875,0,5,5
2011-02,36,44,1,1,27.125,-86.875,0,0,0
2011-02,37,41,2,1,27.375,-87.625,0,0,0
2011-02,38,41,2,1,27.625,-87.625,0,0,0
2011-02,38,43,1,1,27.625,-87.125,0,0,0
2011-02,39,42,1,1,27.875,-87.375,0,0,0
2011-02,41,39,0,0,28.375,-88.125,0,2,2
2011-02,41,40,0,0,28.375,-87.875,0,3,3
2011-02,41,41,0,0,28.375,-87.625,0,7,7
2011-02,41,42,0,0,28.375,-87.375,0,1,1
2011-02,42,39,0,0,28.625,-88.125,0,6,6
2011-02,42,40,0,0,28.625,-87.875,0,6,6
2011-02,42,41,0,0,28.625,-87.625,0,1,1
2011-03,0,57,0,0,18.125,-83.625,2,0,2
2011-03,1,45,0,0,18.375,-86.625,0,5,5
2011-03,1,46,0,0,18.375,-86.375,0,8,8
2011-03,1,47,0,0,18.375,-86.125,0,1,1
2011-03,1,48,0,0,18.375,-85.875,0,3,3
2011-03,1,53,0,0,18.375,-84.625,1,0,1
2011-03,1,54,0,0,18.375,-84.375,5,0,5
2011-03,1,57,0,0,18.375,-83.625,2,0,2
2011-03,2,46,0,0,18.625,-86.375,0,3,3
2011-03,2,47,0,0,18.625,-86.125,0,3,3
2011-03,2,48,0,0,18.625,-85.875,0,3,3
2011-03,2,49,0,0,18.625,-85.625,0,4,4
2011-03,2,50,0,0,18.625,-85.375,0,1,1
2011-03,2,54,0,0,18.625,-84.375,1,0,1
2011-03,2,55,0,0,18.625,-84.125,4,0,4
2011-03,2,56,0,0,18.625,-83.875,2,0,2
2011-03,2,57,0,0,18.625,-83.625,1,0,1
2011-03,5,68,0,0,19.375,-80.875,4,0,4
2011-03,5,69,0,0,19.375,-80.625,14,0,14
2011-03,5,70,0,0,19.375,-80.375,2,0,2
2011-03,5,71,0,0,19.375,-80.125,7,0,7
2011-03,6,68,0,0,19.625,-80.875,2,0,2
2011-03,8,10,0,0,20.125,-95.375,0,6,6
2011-03,8,11,0,0,20.125,-95.125,0,15,15
2011-03,8,12,0,0,20.125,-94.875,0,7,7
2011-03,8,52,0,0,20.125,-84.875,6,0,6
2011-03,8,57,0,0,20.125,-83.625,0,4,4
2011-03,8,58,0,0,20.125,-83.375,0,1,1
2011-03,9,12,0,0,20.375,-94.875,0,2,2
2011-03,9,52,0,0,20.375,-84.875,2,0,2
2011-03,9,56,0,0,20.375,-83.875,0,5,5
2011-03,9,57,0,0,20.375,-83.625,0,1,1
2011-03,9,58,0,0,20.375,-83.375,0,3,3
2011-03,9,59,0,0,20.375,-83.125,0,2,2
2011-03,9,60,0,0,20.375,-82.875,0,2,2
2011-03,9,61,0,0,20.375,-82.625,0,1,1
2011-03,10,51,0,0,20.625,-85.125,5,0,5
2011-03,10,56,0,0,20.625,-83.875,0,2,2
2011-03,10,61,0,0,20.625,-82.625,0,2,2
2011-03,10,62,0,0,20.625,-82.375,0,3,3
2011-03,11,51,0,0,20.875,-85.125,1,0,1
2011-03,11,57,0,0,20.875,-83.625,0,1,1
2011-03,11,58,0,0,20.875,-83.375,0,1,1
2011-03,12,19,0,0,21.125,-93.125,0,2,2
2011-03,12,20,0,0,21.125,-92.875,0,6,6
2011-03,12,21,0,0,21.125,-92.625,0,2,2
2011-03,12,52,0,0,21.125,-84.875,1,0,1
2011-03,13,8,0,0,21.375,-95.875,8,0,8
2011-03,13,19,0,0,21.375,-93.125,0,4,4
2011-03,14,8,0,0,21.625,-95.875,2,0,2
2011-03,20,16,0,0,23.125,-93.875,1,0,1
2011-03,20,17,0,0,23.125,-93.625,1,0,1
2011-03,21,16,0,0,23.375,-93.875,5,0,5
2011-03,21,17,0,0,23.375,-93.625,14,0,14
2011-03,21,18,0,0,23.375,-93.375,10,0,10
2011-03,22,56,0,0,23.625,-83.875,3,0,3
2011-03,23,7,0,0,23.875,-96.125,0,11,11
2011-03,23,8,0,0,23.875,-95.875,0,3,3
2011-03,23,22,0,0,23.875,-92.375,0,3,3
2011-03,23,59,0,0,23.875,-83.125,0,6,6
2011-03,23,60,0,0,23.875,-82.875,0,5,5
2011-03,23,61,0,0,23.875,-82.625,0,2,2
2011-03,23,62,0,0,23.875,-82.375,0,5,5
2011-03,23,63,0,0,23.875,-82.125,0,3,3
2011-03,23,64,0,0,23.875,-81.875,0,3,3
2011-03,23,65,0,0,23.875,-81.625,0,5,5
2011-03,23,66,0,0,23.875,-81.375,0,2,2
2011-03,24,7,0,0,24.125,-96.125,0,13,13
2011-03,24,8,0,0,24.125,-95.875,0,4,4
2011-03,24,22,0,0,24.125,-92.375,0,1,1
2011-03,24,23,0,0,24.125,-92.125,0,10,10
2011-03,24,24,0,0,24.125,-91.875,0,14,14
2011-03,24,25,0,0,24.125,-91.625,0,3,3
2011-03,24,52,0,0,24.125,-84.875,6,0,6
2011-03,24,53,0,0,24.125,-84.625,2,0,2
2011-03,25,53,0,0,24.375,-84.625,10,0,10
2011-03,26,53,0,0,24.625,-84.625,3,0,3
2011-03,27,53,0,0,24.875,-84.625,1,0,1
2011-03,29,9,0,0,25.375,-95.625,5,0,5
2011-03,29,10,0,0,25.375,-95.375,4,0,4
2011-03,30,12,0,0,25.625,-94.875,2,0,2
2011-03,30,13,0,0,25.625,-94.625,17,0,17
2011-03,30,14,0,0,25.625,-94.375,3,0,3
2011-03,31,43,0,0,25.875,-87.125,0,14,14
2011-03,32,20,0,0,26.125,-92.875,0,1,1
2011-03,32,32,0,0,26.125,-89.875,9,0,9
2011-03,32,33,0,0,26.125,-89.625,1,0,1
2011-03,32,43,0,0,26.125,-87.125,0,8,8
2011-03,33,32,0,0,26.375,-89.875,7,0,7
2011-03,33,33,0,0,26.375,-89.625,7,0,7
2011-03,33,34,0,0,26.375,-89.375,1,0,1
2011-03,33,43,0,0,26.375,-87.125,0,9,9
2011-03,34,20,0,0,26.625,-92.875,0,3,3
2011-03,34,34,0,0,26.625,-89.375,6,0,6
2011-03,35,10,0,0,26.875,-95.375,6,0,6
2011-03,35,13,0,0,26.875,-94.625,6,0,6
2011-03,35,14,0,0,26.875,-94.375,3,0,3
2011-03,35,19,0,0,26.875,-93.125,0,2,2
2011-03,35,20,0,0,26.875,-92.875,0,2,2
2011-03,35,21,0,0,26.875,-92.625,0,3,3
2011-03,36,10,0,0,27.125,-95.375,10,0,10
2011-03,36,11,0,0,27.125,-95.125,5,0,5
2011-03,36,19,0,0,27.125,-93.125,0,5,5
2011-03,42,38,0,0,28.625,-88.375,0,6,6
2011-03,42,39,0,0,28.625,-88.125,0,1,1
2011-04,0,45,0,0,18.125,-86.625,0,8,8
2011-04,0,51,0,0,18.125,-85.125,3,0,3
2011-04,0,52,0,0,18.125,-84.875,4,0,4
2011-04,1,44,0,0,18.375,-86.875,0,2,2
2011-04,1,52,0,0,18.375,-84.875,6,0,6
2011-04,1,53,0,0,18.375,-84.625,15,0,15
2011-04,2,53,0,0,18.625,-84.625,2,0,2
2011-04,5,71,0,0,19.375,-80.125,2,0,2
2011-04,6,70,0,0,19.625,-80.375,10,0,10
2011-04,6,71,0,0,19.625,-80.125,3,0,3
2011-04,7,57,0,0,19.875,-83.625,0,1,1
2011-04,7,68,0,0,19.875,-80.875,1,0,1
2011-04,7,69,0,0,19.875,-80.625,3,0,3
2011-04,8,9,0,0,20.125,-95.625,0,1,1
2011-04,8,10,0,0,20.125,-95.375,0,16,16
2011-04,8,56,0,0,20.125,-83.875,0,2,2
2011-04,9,9,0,0,20.375,-95.625,0,4,4
2011-04,9,10,0,0,20.375,-95.375,0,2,2
2011-04,9,53,0,0,20.375,-84.625,0,3,3
2011-04,9,54,0,0,20.375,-84.375,0,2,2
2011-04,9,55,0,0,20.375,-84.125,0,10,10
2011-04,10,8,0,0,20.625,-95.875,0,2,2
2011-04,10,54,0,0,20.625,-84.375,0,8,8
2011-04,11,18,0,0,20.875,-93.375,0,2,2
2011-04,12,18,0,0,21.125,-93.375,0,3,3
2011-04,12,19,0,0,21.125,-93.125,0,2,2
2011-04,13,8,0,0,21.375,-95.875,5,0,5
2011-04,13,19,0,0,21.375,-93.125,0,7,7
2011-04,13,20,0,0,21.375,-92.875,0,4,4
2011-04,14,8,0,0,21.625,-95.875,5,0,5
2011-04,14,9,0,0,21.625,-95.625,4,0,4
2011-04,14,19,0,0,21.625,-93.125,0,6,6
2011-04,15,8,0,0,21.875,-95.875,16,0,16
2011-04,21,15,0,0,23.375,-94.125,8,0,8
2011-04,21,21,0,0,23.375,-92.625,0,1,1
2011-04,21,22,0,0,23.375,-92.375,0,8,8
2011-04,21,23,0,0,23.375,-92.125,0,4,4
2011-04,22,15,0,0,23.625,-94.125,3,0,3
2011-04,22,16,0,0,23.625,-93.875,2,0,2
2011-04,22,21,0,0,23.625,-92.625,0,7,7
2011-04,22,23,0,0,23.625,-92.125,0,3,3
2011-04,23,22,0,0,23.875,-92.375,0,7,7
2011-04,23,39,0,0,23.875,-88.125,3,0,3
2011-04,23,40,0,0,23.875,-87.875,1,0,1
2011-04,23,66,0,0,23.875,-81.375,0,2,2
2011-04,24,7,0,0,24.125,-96.125,0,14,14
2011-04,24,68,0,0,24.125,-80.875,0,6,6
2011-04,24,69,0,0,24.125,-80.625,0,1,1
2011-04,25,7,0,0,24.375,-96.125,0,4,4
2011-04,25,8,0,0,24.375,-95.875,0,12,12
2011-04,25,15,0,0,24.375,-94.125,4,0,4
2011-04,26,15,0,0,24.625,-94.125,3,0,3
2011-04,26,50,0,0,24.625,-85.375,6,0,6
2011-04,26,51,0,0,24.625,-85.125,7,0,7
2011-04,27,52,0,0,24.875,-84.875,15,0,15
2011-04,28,25,0,0,25.125,-91.625,4,0,4
2011-04,28,52,0,0,25.125,-84.875,2,0,2
2011-04,29,14,0,0,25.375,-94.375,4,0,4
2011-04,29,24,0,0,25.375,-91.875,4,0,4
2011-04,29,25,0,0,25.375,-91.625,5,0,5
2011-04,30,14,0,0,25.625,-94.375,5,0,5
2011-04,31,13,0,0,25.875,-94.625,5,0,5
2011-04,31,14,0,0,25.875,-94.375,9,0,9
2011-04,32,41,0,0,26.125,-87.625,0,1,1
2011-04,32,42,0,0,26.125,-87.375,0,6,6
2011-04,33,20,0,0,26.375,-92.875,0,5,5
2011-04,33,33,0,0,26.375,-89.625,7,0,7
2011-04,33,42,0,0,26.375,-87.375,0,2,2
2011-04,33,43,0,0,26.375,-87.125,0,21,21
2011-04,34,19,0,0,26.625,-93.125,0,12,12
2011-04,34,20,0,0,26.625,-92.875,0,3,3
2011-04,34,33,0,0,26.625,-89.625,8,0,8
2011-04,34,34,0,0,26.625,-89.375,6,0,6
2011-04,35,19,0,0,26.875,-93.125,0,10,10
2011-04,35,32,0,0,26.875,-89.875,3,0,3
2011-04,35,33,0,0,26.875,-89.625,6,0,6
2011-04,36,50,0,0,27.125,-85.375,1,0,1
2011-04,37,49,0,0,27.375,-85.625,1,0,1
2011-04,40,49,0,0,28.125,-85.625,4,0,4
2011-04,41,48,0,0,28.375,-85.875,3,0,3
2011-05,0,71,0,0,18.125,-80.125,0,1,1
2011-05,1,70,0,0,18.375,-80.375,0,2,2
2011-05,1,71,0,0,18.375,-80.125,0,3,3
2011-05,2,59,0,0,18.625,-83.125,0,2,2
2011-05,2,60,0,0,18.625,-82.875,0,2,2
2011-05,2,61,0,0,18.625,-82.625,0,1,1
2011-05,2,62,0,0,18.625,-82.375,0,1,1
2011-05,2,63,0,0,18.625,-82.125,0,2,2
2011-05,2,64,0,0,18.625,-81.875,0,1,1
2011-05,2,69,0,0,18.625,-80.625,0,4,4
2011-05,2,70,0,0,18.625,-80.375,0,2,2
2011-05,2,71,0,0,18.625,-80.125,0,1,1
2011-05,3,57,0,0,18.875,-83.625,0,2,2
2011-05,3,58,0,0,18.875,-83.375,0,3,3
2011-05,10,16,0,0,20.625,-93.875,0,3,3
2011-05,10,17,0,0,20.625,-93.625,0,2,2
2011-05,11,16,0,0,20.875,-93.875,0,4,4
2011-05,12,17,0,0,21.125,-93.625,0,5,5
2011-05,15,7,0,0,21.875,-96.125,1,0,1
2011-05,15,8,0,0,21.875,-95.875,14,0,14
2011-05,20,22,0,0,23.125,-92.375,0,6,6
2011-05,20,23,0,0,23.125,-92.125,0,2,2
2011-05,21,20,0,0,23.375,-92.875,0,2,2
2011-05,21,21,0,0,23.375,-92.625,0,10,10
2011-05,21,22,0,0,23.375,-92.375,0,4,4
2011-05,21,23,0,0,23.375,-92.125,0,1,1
2011-05,22,21,0,0,23.625,-92.625,0,4,4
2011-05,22,23,0,0,23.625,-92.125,0,1,1
2011-05,22,24,0,0,23.625,-91.875,0,1,1
2011-05,22,32,0,0,23.625,-89.875,0,1,1
2011-05,22,38,0,0,23.625,-88.375,1,0,1
2011-05,22,54,0,0,23.625,-84.375,3,0,3
2011-05,22,55,0,0,23.625,-84.125,4,0,4
2011-05,22,56,0,0,23.625,-83.875,3,0,3
2011-05,23,11,0,0,23.875,-95.125,2,0,2
2011-05,23,12,0,0,23.875,-94.875,6,0,6
2011-05,23,32,0,0,23.875,-89.875,0,4,4
2011-05,23,33,0,0,23.875,-89.625,0,1,1
2011-05,23,38,0,0,23.875,-88.375,1,0,1
2011-05,23,39,0,0,23.875,-88.125,8,0,8
2011-05,23,40,0,0,23.875,-87.875,5,0,5
2011-05,23,53,0,0,23.875,-84.625,4,0,4
2011-05,24,13,0,0,24.125,-94.625,5,0,5
2011-05,24,14,0,0,24.125,-94.375,9,0,9
2011-05,24,15,0,0,24.125,-94.125,5,0,5
2011-05,24,51,0,0,24.125,-85.125,1,0,1
2011-05,24,52,0,0,24.125,-84.875,4,0,4
2011-05,24,53,0,0,24.125,-84.625,1,0,1
2011-05,25,15,0,0,24.375,-94.125,4,0,4
2011-05,25,35,0,0,24.375,-89.125,3,0,3
2011-05,25,36,0,0,24.375,-88.875,8,0,8
2011-05,25,50,0,0,24.375,-85.375,2,0,2
2011-05,25,51,0,0,24.375,-85.125,3,0,3
2011-05,26,8,0,0,24.625,-95.875,0,12,12
2011-05,26,34,0,0,24.625,-89.375,1,0,1
2011-05,26,35,0,0,24.625,-89.125,2,0,2
2011-05,27,8,0,0,24.875,-95.875,0,4,4
2011-05,27,9,0,0,24.875,-95.625,0,2,2
2011-05,28,9,0,0,25.125,-95.625,0,11,11
2011-05,28,10,0,0,25.125,-95.375,0,2,2
2011-05,28,25,0,0,25.125,-91.625,1,0,1
2011-05,28,26,0,0,25.125,-91.375,7,0,7
2011-05,28,27,0,0,25.125,-91.125,1,0,1
2011-05,29,24,0,0,25.375,-91.875,11,0,11
2011-05,29,25,0,0,25.375,-91.625,9,0,9
2011-05,29,26,0,0,25.375,-91.375,1,0,1
2011-05,29,27,0,0,25.375,-91.125,1,0,1
2011-05,31,48,0,0,25.875,-85.875,1,0,1
2011-05,31,49,0,0,25.875,-85.625,2,0,2
2011-05,31,50,0,0,25.875,-85.375,3,0,3
2011-05,32,40,0,0,26.125,-87.875,0,6,6
2011-05,32,41,0,0,26.125,-87.625,0,5,5
2011-05,32,48,0,0,26.125,-85.875,8,0,8
2011-05,32,49,0,0,26.125,-85.625,3,0,3
2011-05,33,39,0,0,26.375,-88.125,0,18,18
2011-05,33,40,0,0,26.375,-87.875,0,2,2
2011-05,33,49,0,0,26.375,-85.625,3,0,3
2011-05,33,50,0,0,26.375,-85.375,3,0,3
2011-05,34,18,0,0,26.625,-93.375,0,1,1
2011-05,34,19,0,0,26.625,-93.125,0,1,1
2011-05,34,20,0,0,26.625,-92.875,0,1,1
2011-05,34,31,0,0,26.625,-90.125,1,0,1
2011-05,34,50,0,0,26.625,-85.375,1,0,1
2011-05,34,51,0,0,26.625,-85.125,3,0,3
2011-05,35,19,0,0,26.875,-93.125,0,23,23
2011-05,35,20,0,0,26.875,-92.875,0,5,5
2011-05,35,31,0,0,26.875,-90.125,13,0,13
2011-05,35,51,0,0,26.875,-85.125,3,0,3
2011-05,36,31,0,0,27.125,-90.125,5,0,5
2011-05,36,32,0,0,27.125,-89.875,2,0,2
2011-05,37,31,0,0,27.375,-90.125,2,0,2
2011-05,38,33,0,0,27.625,-89.625,2,0,2
2011-05,39,33,0,0,27.875,-89.625,4,0,4
2011-05,39,34,0,0,27.875,-89.375,1,0,1
2011-05,40,34,0,0,28.125,-89.375,1,0,1
2011-06,0,56,0,0,18.125,-83.875,0,2,2
2011-06,0,57,0,0,18.125,-83.625,0,5,5
2011-06,3,51,0,0,18.875,-85.125,0,4,4
2011-06,3,52,0,0,18.875,-84.875,0,2,2
2011-06,3,53,0,0,18.875,-84.625,0,2,2
2011-06,3,54,0,0,18.875,-84.375,0,3,3
2011-06,3,55,0,0,18.875,-84.125,0,3,3
2011-06,3,56,0,0,18.875,-83.875,0,2,2
2011-06,3,57,0,0,18.875,-83.625,0,1,1
2011-06,4,50,0,0,19.125,-85.375,0,2,2
2011-06,5,48,0,0,19.375,-85.875,0,2,2
2011-06,5,71,0,0,19.375,-80.125,4,0,4
2011-06,6,48,0,0,19.625,-85.875,0,3,3
2011-06,6,54,0,0,19.625,-84.375,5,0,5
2011-06,6,55,0,0,19.625,-84.125,1,0,1
2011-06,6,71,0,0,19.625,-80.125,10,0,10
2011-06,7,48,0,0,19.875,-85.875,0,3,3
2011-06,8,48,0,0,20.125,-85.875,0,1,1
2011-06,8,49,0,0,20.125,-85.625,0,2,2
2011-06,8,56,0,0,20.125,-83.875,7,0,7
2011-06,8,57,0,0,20.125,-83.625,7,0,7
2011-06,9,20,0,0,20.375,-92.875,0,2,2
2011-06,9,57,0,0,20.375,-83.625,4,0,4
2011-06,9,58,0,0,20.375,-83.375,1,0,1
2011-06,10,17,0,0,20.625,-93.625,0,9,9
2011-06,10,18,0,0,20.625,-93.375,0,4,4
2011-06,10,19,0,0,20.625,-93.125,0,1,1
2011-06,10,20,0,0,20.625,-92.875,0,1,1
2011-06,11,16,0,0,20.875,-93.875,0,1,1
2011-06,11,17,0,0,20.875,-93.625,0,10,10
2011-06,11,18,0,0,20.875,-93.375,0,2,2
2011-06,13,57,0,0,21.375,-83.625,6,0,6
2011-06,16,11,0,0,22.125,-95.125,1,0,1
2011-06,17,13,0,0,22.375,-94.625,5,0,5
2011-06,18,13,0,0,22.625,-94.625,4,0,4
2011-06,20,18,0,0,23.125,-93.375,0,2,2
2011-06,20,19,0,0,23.125,-93.125,0,15,15
2011-06,20,20,0,0,23.125,-92.875,0,4,4
2011-06,21,18,0,0,23.375,-93.375,0,1,1
2011-06,21,20,0,0,23.375,-92.875,0,2,2
2011-06,22,52,0,0,23.625,-84.875,0,1,1
2011-06,22,53,0,0,23.625,-84.625,0,1,1
2011-06,22,54,0,0,23.625,-84.375,0,4,4
2011-06,22,55,0,0,23.625,-84.125,0,5,5
2011-06,22,56,0,0,23.625,-83.875,0,4,4
2011-06,23,6,0,0,23.875,-96.375,3,0,3
2011-06,23,7,0,0,23.875,-96.125,9,0,9
2011-06,23,8,0,0,23.875,-95.875,1,0,1
2011-06,23,9,0,0,23.875,-95.625,3,0,3
2011-06,23,10,0,0,23.875,-95.375,4,0,4
2011-06,23,11,0,0,23.875,-95.125,3,0,3
2011-06,23,30,0,0,23.875,-90.375,0,17,17
2011-06,23,31,0,0,23.875,-90.125,0,11,11
2011-06,23,32,0,0,23.875,-89.875,0,1,1
2011-06,23,51,0,0,23.875,-85.125,0,2,2
2011-06,23,52,0,0,23.875,-84.875,0,4,4
2011-06,23,53,0,0,23.875,-84.625,0,3,3
2011-06,23,64,0,0,23.875,-81.875,5,0,5
2011-06,23,65,0,0,23.875,-81.625,3,0,3
2011-06,26,9,0,0,24.625,-95.625,0,4,4
2011-06,27,9,0,0,24.875,-95.625,0,20,20
2011-06,27,50,0,0,24.875,-85.375,6,0,6
2011-06,28,49,0,0,25.125,-85.625,2,0,2
2011-06,28,50,0,0,25.125,-85.375,4,0,4
2011-06,29,14,0,0,25.375,-94.375,1,0,1
2011-06,29,50,0,0,25.375,-85.375,4,0,4
2011-06,30,12,0,0,25.625,-94.875,2,0,2
2011-06,30,13,0,0,25.625,-94.625,2,0,2
2011-06,30,50,0,0,25.625,-85.375,2,0,2
2011-06,31,11,0,0,25.875,-95.125,4,0,4
2011-06,31,39,0,0,25.875,-88.125,0,11,11
2011-06,31,50,0,0,25.875,-85.375,4,0,4
2011-06,31,51,0,0,25.875,-85.125,8,0,8
2011-06,32,39,0,0,26.125,-88.125,0,3,3
2011-06,32,40,0,0,26.125,-87.875,0,9,9
2011-06,33,19,0,0,26.375,-93.125,0,5,5
2011-06,33,20,0,0,26.375,-92.875,0,13,13
2011-06,33,39,0,0,26.375,-88.125,0,7,7
2011-06,34,19,0,0,26.625,-93.125,0,7,7
2011-06,34,20,0,0,26.625,-92.875,0,5,5
2011-06,37,8,0,0,27.375,-95.875,0,8,8
2011-06,38,8,0,0,27.625,-95.875,0,5,5
2011-06,38,9,0,0,27.625,-95.625,0,6,6
2011-06,38,10,0,0,27.625,-95.375,0,3,3
2011-06,38,11,0,0,27.625,-95.125,0,3,3
2011-06,38,12,0,0,27.625,-94.875,0,1,1
2011-06,39,27,2,1,27.875,-91.125,0,0,0
2011-06,39,28,1,1,27.875,-90.875,0,0,0
2011-06,39,39,0,0,27.875,-88.125,1,0,1
2011-06,39,40,0,0,27.875,-87.875,1,0,1
2011-06,39,41,0,0,27.875,-87.625,1,0,1
2011-06,40,27,1,1,28.125,-91.125,0,0,0
2011-06,40,28,5,1,28.125,-90.875,0,0,0
2011-06,40,34,0,0,28.125,-89.375,6,0,6
2011-06,40,35,0,0,28.125,-89.125,7,0,7
2011-07,0,49,0,0,18.125,-85.625,0,2,2
2011-07,0,50,0,0,18.125,-85.375,0,3,3
2011-07,0,51,0,0,18.125,-85.125,0,4,4
2011-07,0,52,0,0,18.125,-84.875,0,1,1
2011-07,0,54,0,0,18.125,-84.375,0,3,3
2011-07,0,55,0,0,18.125,-84.125,0,3,3
2011-07,0,56,0,0,18.125,-83.875,2,1,3
2011-07,0,59,0,0,18.125,-83.125,2,0,2
2011-07,0,60,0,0,18.125,-82.875,2,0,2
2011-07,0,61,0,0,18.125,-82.625,3,0,3
2011-07,0,62,0,0,18.125,-82.375,2,0,2
2011-07,1,53,0,0,18.375,-84.625,0,3,3
2011-07,1,54,0,0,18.375,-84.375,0,1,1
2011-07,4,60,0,0,19.125,-82.875,0,1,1
2011-07,4,61,0,0,19.125,-82.625,0,1,1
2011-07,5,59,0,0,19.375,-83.125,0,2,2
2011-07,5,60,0,0,19.375,-82.875,0,2,2
2011-07,6,52,0,0,19.625,-84.875,4,0,4
2011-07,6,53,0,0,19.625,-84.625,6,0,6
2011-07,6,61,0,0,19.625,-82.625,0,1,1
2011-07,6,71,0,0,19.625,-80.125,3,0,3
2011-07,7,51,0,0,19.875,-85.125,2,0,2
2011-07,7,52,0,0,19.875,-84.875,3,0,3
2011-07,7,69,0,0,19.875,-80.625,1,0,1
2011-07,7,70,0,0,19.875,-80.375,3,0,3
2011-07,7,71,0,0,19.875,-80.125,4,0,4
2011-07,8,48,0,0,20.125,-85.875,0,2,2
2011-07,8,49,0,0,20.125,-85.625,4,6,10
2011-07,8,50,0,0,20.125,-85.375,3,0,3
2011-07,8,68,0,0,20.125,-80.875,2,0,2
2011-07,8,69,0,0,20.125,-80.625,1,0,1
2011-07,9,20,0,0,20.375,-92.875,0,1,1
2011-07,9,48,0,0,20.375,-85.875,1,1,2
2011-07,9,49,0,0,20.375,-85.625,3,2,5
2011-07,10,20,0,0,20.625,-92.875,0,4,4
2011-07,10,21,0,0,20.625,-92.625,0,2,2
2011-07,10,48,0,0,20.625,-85.875,1,1,2
2011-07,10,49,0,0,20.625,-85.625,0,1,1
2011-07,12,19,0,0,21.125,-93.125,0,6,6
2011-07,12,20,0,0,21.125,-92.875,0,1,1
2011-07,12,55,0,0,21.125,-84.125,2,0,2
2011-07,12,56,0,0,21.125,-83.875,18,0,18
2011-07,12,57,0,0,21.125,-83.625,3,0,3
2011-07,13,18,0,0,21.375,-93.375,0,16,16
2011-07,13,55,0,0,21.375,-84.125,3,0,3
2011-07,13,57,0,0,21.375,-83.625,3,0,3
2011-07,15,12,0,0,21.875,-94.875,1,0,1
2011-07,16,10,0,0,22.125,-95.375,1,0,1
2011-07,16,11,0,0,22.125,-95.125,14,0,14
2011-07,16,12,0,0,22.125,-94.875,2,0,2
2011-07,17,11,0,0,22.375,-95.125,1,0,1
2011-07,17,12,0,0,22.375,-94.875,2,0,2
2011-07,17,13,0,0,22.375,-94.625,2,0,2
2011-07,17,46,0,0,22.375,-86.375,1,0,1
2011-07,17,52,0,0,22.375,-84.875,0,1,1
2011-07,18,46,0,0,22.625,-86.375,8,0,8
2011-07,18,51,0,0,22.625,-85.125,0,2,2
2011-07,19,45,0,0,22.875,-86.625,1,0,1
2011-07,19,46,0,0,22.875,-86.375,2,0,2
2011-07,19,51,0,0,22.875,-85.125,0,3,3
2011-07,20,19,0,0,23.125,-93.125,2,0,2
2011-07,20,20,0,0,23.125,-92.875,3,0,3
2011-07,20,45,0,0,23.125,-86.625,2,0,2
2011-07,21,27,0,0,23.375,-91.125,0,3,3
2011-07,21,28,0,0,23.375,-90.875,0,16,16
2011-07,21,45,0,0,23.375,-86.625,3,0,3
2011-07,22,28,0,0,23.625,-90.875,0,5,5
2011-07,22,29,0,0,23.625,-90.625,0,4,4
2011-07,22,44,0,0,23.625,-86.875,2,0,2
2011-07,22,45,0,0,23.625,-86.625,2,0,2
2011-07,22,50,0,0,23.625,-85.375,0,4,4
2011-07,22,51,0,0,23.625,-85.125,0,1,1
2011-07,22,56,0,0,23.625,-83.875,0,2,2
2011-07,22,57,0,0,23.625,-83.625,0,4,4
2011-07,23,30,0,0,23.875,-90.375,0,3,3
2011-07,23,44,0,0,23.875,-86.875,5,0,5
2011-07,23,50,0,0,23.875,-85.375,0,2,2
2011-07,23,51,0,0,23.875,-85.125,0,1,1
2011-07,23,57,0,0,23.875,-83.625,0,1,1
2011-07,23,58,0,0,23.875,-83.375,0,5,5
2011-07,23,59,0,0,23.875,-83.125,0,5,5
2011-07,23,60,0,0,23.875,-82.875,0,1,1
2011-07,23,65,0,0,23.875,-81.625,2,0,2
2011-07,24,66,0,0,24.125,-81.375,8,0,8
2011-07,24,67,0,0,24.125,-81.125,2,0,2
2011-07,24,69,0,0,24.125,-80.625,1,0,1
2011-07,25,68,0,0,24.375,-80.875,1,0,1
2011-07,25,69,0,0,24.375,-80.625,3,0,3
2011-07,25,70,0,0,24.375,-80.375,3,0,3
2011-07,26,51,0,0,24.625,-85.125,1,0,1
2011-07,27,50,0,0,24.875,-85.375,2,0,2
2011-07,27,51,0,0,24.875,-85.125,2,0,2
2011-07,29,26,0,0,25.375,-91.375,1,0,1
2011-07,29,27,0,0,25.375,-91.125,1,0,1
2011-07,29,28,0,0,25.375,-90.875,2,0,2
2011-07,30,16,0,0,25.625,-93.875,0,10,10
2011-07,30,17,0,0,25.625,-93.625,0,9,9
2011-07,30,25,0,0,25.625,-91.625,2,0,2
2011-07,30,26,0,0,25.625,-91.375,2,0,2
2011-07,30,27,0,0,25.625,-91.125,1,0,1
2011-07,30,51,0,0,25.625,-85.125,1,0,1
2011-07,31,10,0,0,25.875,-95.375,1,0,1
2011-07,31,11,0,0,25.875,-95.125,10,0,10
2011-07,31,12,0,0,25.875,-94.875,2,0,2
2011-07,31,17,0,0,25.875,-93.625,0,2,2
2011-07,31,18,0,0,25.875,-93.375,0,1,1
2011-07,31,25,0,0,25.875,-91.625,4,0,4
2011-07,31,38,0,0,25.875,-88.375,0,3,3
2011-07,31,51,0,0,25.875,-85.125,3,0,3
2011-07,32,12,0,0,26.125,-94.875,18,0,18
2011-07,32,19,0,0,26.125,-93.125,0,7,7
2011-07,32,37,0,0,26.125,-88.625,0,3,3
2011-07,32,38,0,0,26.125,-88.375,0,3,3
2011-07,33,19,0,0,26.375,-93.125,0,2,2
2011-07,33,35,0,0,26.375,-89.125,0,5,5
2011-07,33,36,0,0,26.375,-88.875,0,9,9
2011-07,33,37,0,0,26.375,-88.625,0,5,5
2011-07,34,35,0,0,26.625,-89.125,0,3,3
2011-07,35,8,0,0,26.875,-95.875,0,9,9
2011-07,36,8,0,0,27.125,-95.875,0,10,10
2011-07,36,9,0,0,27.125,-95.625,0,3,3
2011-07,36,10,0,0,27.125,-95.375,0,3,3
2011-07,37,10,0,0,27.375,-95.375,0,1,1
2011-07,37,11,0,0,27.375,-95.125,0,1,1
2011-07,38,12,0,0,27.625,-94.875,0,3,3
2011-07,39,27,5,1,27.875,-91.125,0,0,0
2011-07,39,28,4,1,27.875,-90.875,0,0,0
2011-07,39,36,1,1,27.875,-88.875,0,0,0
2011-07,40,27,2,1,28.125,-91.125,0,0,0
2011-08,0,47,0,0,18.125,-86.125,0,5,5
2011-08,5,58,0,0,19.375,-83.375,0,2,2
2011-08,5,59,0,0,19.375,-83.125,0,1,1
2011-08,6,53,0,0,19.625,-84.625,0,3,3
2011-08,6,54,0,0,19.625,-84.375,0,5,5
2011-08,6,55,0,0,19.625,-84.125,0,3,3
2011-08,6,57,0,0,19.625,-83.625,0,2,2
2011-08,6,58,0,0,19.625,-83.375,0,1,1
2011-08,6,62,0,0,19.625,-82.375,2,0,2
2011-08,6,64,0,0,19.625,-81.875,5,0,5
2011-08,6,65,0,0,19.625,-81.625,1,0,1
2011-08,7,53,0,0,19.875,-84.625,0,5,5
2011-08,7,56,0,0,19.875,-83.875,0,3,3
2011-08,7,62,0,0,19.875,-82.375,1,0,1
2011-08,7,63,0,0,19.875,-82.125,4,0,4
2011-08,7,65,0,0,19.875,-81.625,5,0,5
2011-08,7,66,0,0,19.875,-81.375,5,0,5
2011-08,7,67,0,0,19.875,-81.125,2,0,2
2011-08,8,49,0,0,20.125,-85.625,1,0,1
2011-08,8,62,0,0,20.125,-82.375,5,0,5
2011-08,8,67,0,0,20.125,-81.125,1,0,1
2011-08,10,47,0,0,20.625,-86.125,1,0,1
2011-08,10,48,0,0,20.625,-85.875,1,0,1
2011-08,11,47,0,0,20.875,-86.125,1,0,1
2011-08,12,10,0,0,21.125,-95.375,0,1,1
2011-08,13,11,0,0,21.375,-95.125,0,3,3
2011-08,13,12,0,0,21.375,-94.875,0,2,2
2011-08,13,13,0,0,21.375,-94.625,0,6,6
2011-08,13,14,0,0,21.375,-94.375,0,3,3
2011-08,13,15,0,0,21.375,-94.125,0,4,4
2011-08,13,16,0,0,21.375,-93.875,0,1,1
2011-08,13,17,0,0,21.375,-93.625,0,2,2
2011-08,13,18,0,0,21.375,-93.375,0,1,1
2011-08,14,16,0,0,21.625,-93.875,0,1,1
2011-08,14,17,0,0,21.625,-93.625,0,1,1
2011-08,15,7,0,0,21.875,-96.125,0,3,3
2011-08,15,8,0,0,21.875,-95.875,0,3,3
2011-08,20,17,0,0,23.125,-93.625,1,0,1
2011-08,20,18,0,0,23.125,-93.375,4,0,4
2011-08,20,19,0,0,23.125,-93.125,2,0,2
2011-08,20,25,0,0,23.125,-91.625,0,1,1
2011-08,20,26,0,0,23.125,-91.375,0,1,1
2011-08,21,11,0,0,23.375,-95.125,2,0,2
2011-08,21,12,0,0,23.375,-94.875,6,0,6
2011-08,21,13,0,0,23.375,-94.625,5,0,5
2011-08,21,14,0,0,23.375,-94.375,4,0,4
2011-08,21,15,0,0,23.375,-94.125,2,0,2
2011-08,21,16,0,0,23.375,-93.875,4,0,4
2011-08,21,17,0,0,23.375,-93.625,1,0,1
2011-08,21,25,0,0,23.375,-91.625,0,4,4
2011-08,21,26,0,0,23.375,-91.375,0,2,2
2011-08,21,27,0,0,23.375,-91.125,0,3,3
2011-08,22,50,0,0,23.625,-85.375,0,1,1
2011-08,23,49,0,0,23.875,-85.625,0,3,3
2011-08,23,50,0,0,23.875,-85.375,0,3,3
2011-08,24,48,0,0,24.125,-85.875,0,10,10
2011-08,24,49,0,0,24.125,-85.625,0,14,14
2011-08,26,42,0,0,24.625,-87.375,2,0,2
2011-08,26,43,0,0,24.625,-87.125,1,0,1
2011-08,27,13,0,0,24.875,-94.625,0,5,5
2011-08,27,14,0,0,24.875,-94.375,0,9,9
2011-08,27,15,0,0,24.875,-94.125,0,4,4
2011-08,27,41,0,0,24.875,-87.625,3,0,3
2011-08,27,42,0,0,24.875,-87.375,2,0,2
2011-08,28,13,0,0,25.125,-94.625,0,2,2
2011-08,28,14,0,0,25.125,-94.375,0,3,3
2011-08,28,41,0,0,25.125,-87.625,3,0,3
2011-08,29,16,0,0,25.375,-93.875,0,7,7
2011-08,29,40,0,0,25.375,-87.875,2,0,2
2011-08,29,41,0,0,25.375,-87.625,2,0,2
2011-08,30,22,0,0,25.625,-92.375,2,0,2
2011-08,30,23,0,0,25.625,-92.125,4,0,4
2011-08,30,39,0,0,25.625,-88.125,3,0,3
2011-08,30,40,0,0,25.625,-87.875,8,0,8
2011-08,30,41,0,0,25.625,-87.625,3,0,3
2011-08,31,20,0,0,25.875,-92.875,5,0,5
2011-08,31,21,0,0,25.875,-92.625,3,0,3
2011-08,31,23,0,0,25.875,-92.125,3,0,3
2011-08,31,24,0,0,25.875,-91.875,4,0,4
2011-08,31,25,0,0,25.875,-91.625,3,0,3
2011-08,32,12,0,0,26.125,-94.875,28,0,28
2011-08,32,13,0,0,26.125,-94.625,3,0,3
2011-08,32,24,0,0,26.125,-91.875,6,0,6
2011-08,32,25,0,0,26.125,-91.625,1,0,1
2011-08,32,29,0,0,26.125,-90.625,0,4,4
2011-08,32,30,0,0,26.125,-90.375,0,5,5
2011-08,32,31,0,0,26.125,-90.125,0,3,3
2011-08,32,32,0,0,26.125,-89.875,0,5,5
2011-08,32,51,0,0,26.125,-85.125,2,0,2
2011-08,33,32,0,0,26.375,-89.875,0,1,1
2011-08,33,33,0,0,26.375,-89.625,0,6,6
2011-08,33,34,0,0,26.375,-89.375,0,7,7
2011-08,33,49,0,0,26.375,-85.625,4,0,4
2011-08,33,50,0,0,26.375,-85.375,2,0,2
2011-08,33,51,0,0,26.375,-85.125,3,0,3
2011-08,34,49,0,0,26.625,-85.625,6,0,6
2011-08,34,50,0,0,26.625,-85.375,9,0,9
2011-08,34,51,0,0,26.625,-85.125,2,0,2
2011-08,36,8,0,0,27.125,-95.875,0,5,5
2011-08,36,9,0,0,27.125,-95.625,0,2,2
2011-08,36,12,0,0,27.125,-94.875,0,10,10
2011-08,36,13,0,0,27.125,-94.625,0,9,9
2011-08,41,42,0,0,28.375,-87.375,0,1,1
2011-08,41,43,0,0,28.375,-87.125,0,1,1
2011-08,42,42,0,0,28.625,-87.375,0,5,5
2011-08,42,43,0,0,28.625,-87.125,0,11,11
2011-08,42,44,0,0,28.625,-86.875,0,2,2
2011-08,42,45,0,0,28.625,-86.625,0,2,2
2011-08,42,46,0,0,28.625,-86.375,0,3,3
2011-09,0,47,0,0,18.125,-86.125,1,0,1
2011-09,0,56,0,0,18.125,-83.875,0,1,1
2011-09,0,70,0,0,18.125,-80.375,1,0,1
2011-09,1,70,0,0,18.375,-80.375,1,0,1
2011-09,5,57,0,0,19.375,-83.625,1,0,1
2011-09,5,58,0,0,19.375,-83.375,1,0,1
2011-09,5,59,0,0,19.375,-83.125,4,0,4
2011-09,5,60,0,0,19.375,-82.875,2,0,2
2011-09,6,60,0,0,19.625,-82.875,2,0,2
2011-09,6,61,0,0,19.625,-82.625,3,0,3
2011-09,6,62,0,0,19.625,-82.375,3,0,3
2011-09,10,17,0,0,20.625,-93.625,2,0,2
2011-09,10,67,0,0,20.625,-81.125,0,2,2
2011-09,10,68,0,0,20.625,-80.875,0,8,8
2011-09,11,7,0,0,20.875,-96.125,0,8,8
2011-09,11,16,0,0,20.875,-93.875,4,0,4
2011-09,11,17,0,0,20.875,-93.625,5,0,5
2011-09,12,7,0,0,21.125,-96.125,0,4,4
2011-09,12,16,0,0,21.125,-93.875,4,0,4
2011-09,12,56,0,0,21.125,-83.875,0,2,2
2011-09,13,7,0,0,21.375,-96.125,0,6,6
2011-09,13,16,0,0,21.375,-93.875,3,0,3
2011-09,14,7,0,0,21.625,-96.125,0,6,6
2011-09,14,16,0,0,21.625,-93.875,4,0,4
2011-09,15,7,0,0,21.875,-96.125,0,6,6
2011-09,15,15,0,0,21.875,-94.125,2,0,2
2011-09,15,16,0,0,21.875,-93.875,3,0,3
2011-09,19,25,0,0,22.875,-91.625,0,1,1
2011-09,20,24,0,0,23.125,-91.875,0,19,19
2011-09,20,25,0,0,23.125,-91.625,0,10,10
2011-09,21,11,0,0,23.375,-95.125,1,0,1
2011-09,22,8,0,0,23.625,-95.875,1,0,1
2011-09,22,9,0,0,23.625,-95.625,6,0,6
2011-09,22,10,0,0,23.625,-95.375,3,0,3
2011-09,22,11,0,0,23.625,-95.125,1,0,1
2011-09,23,7,0,0,23.875,-96.125,2,0,2
2011-09,23,8,0,0,23.875,-95.875,5,0,5
2011-09,23,55,0,0,23.875,-84.125,5,0,5
2011-09,24,48,0,0,24.125,-85.875,0,1,1
2011-09,24,55,0,0,24.125,-84.125,3,0,3
2011-09,25,47,0,0,24.375,-86.125,0,6,6
2011-09,25,55,0,0,24.375,-84.125,4,0,4
2011-09,26,11,0,0,24.625,-95.125,0,1,1
2011-09,26,47,0,0,24.625,-86.125,0,5,5
2011-09,26,54,0,0,24.625,-84.375,2,0,2
2011-09,26,55,0,0,24.625,-84.125,1,0,1
2011-09,27,15,0,0,24.875,-94.125,0,3,3
2011-09,27,47,0,0,24.875,-86.125,0,4,4
2011-09,27,54,0,0,24.875,-84.375,6,0,6
2011-09,28,14,0,0,25.125,-94.375,0,4,4
2011-09,28,15,0,0,25.125,-94.125,0,2,2
2011-09,28,46,0,0,25.125,-86.375,0,14,14
2011-09,28,54,0,0,25.125,-84.375,3,0,3
2011-09,30,23,0,0,25.625,-92.125,0,3,3
2011-09,30,24,0,0,25.625,-91.875,0,2,2
2011-09,30,37,0,0,25.625,-88.625,5,0,5
2011-09,30,38,0,0,25.625,-88.375,1,0,1
2011-09,30,39,0,0,25.625,-88.125,8,0,8
2011-09,31,24,0,0,25.875,-91.875,0,3,3
2011-09,31,25,0,0,25.875,-91.625,0,4,4
2011-09,31,26,0,0,25.875,-91.375,0,4,4
2011-09,31,27,0,0,25.875,-91.125,0,4,4
2011-09,31,38,0,0,25.875,-88.375,16,0,16
2011-09,32,13,0,0,26.125,-94.625,3,0,3
2011-09,32,27,0,0,26.125,-91.125,0,2,2
2011-09,32,28,0,0,26.125,-90.875,0,6,6
2011-09,32,29,0,0,26.125,-90.625,0,2,2
2011-09,33,51,0,0,26.375,-85.125,1,0,1
2011-09,34,10,0,0,26.625,-95.375,0,3,3
2011-09,34,11,0,0,26.625,-95.125,0,8,8
2011-09,34,46,3,1,26.625,-86.375,0,0,0
2011-09,34,50,0,0,26.625,-85.375,2,0,2
2011-09,35,11,0,0,26.875,-95.125,0,7,7
2011-09,35,12,0,0,26.875,-94.875,0,5,5
2011-09,35,46,2,1,26.875,-86.375,0,0,0
2011-09,36,12,0,0,27.125,-94.875,0,3,3
2011-09,36,13,0,0,27.125,-94.625,0,3,3
2011-09,36,28,0,0,27.125,-90.875,1,0,1
2011-09,36,47,1,1,27.125,-86.125,0,0,0
2011-09,36,51,0,0,27.125,-85.125,3,0,3
2011-09,36,52,0,0,27.125,-84.875,3,0,3
2011-09,37,27,0,0,27.375,-91.125,1,0,1
2011-09,37,41,1,1,27.375,-87.625,0,0,0
2011-09,38,45,1,1,27.625,-86.625,0,0,0
2011-09,38,46,1,1,27.625,-86.375,0,0,0
2011-09,38,47,1,1,27.625,-86.125,0,0,0
2011-09,39,19,0,0,27.875,-93.125,1,0,1
2011-09,39,20,0,0,27.875,-92.875,1,0,1
2011-09,39,21,0,0,27.875,-92.625,2,0,2
2011-09,39,33,6,4,27.875,-89.625,0,0,0
2011-09,39,34,1,1,27.875,-89.375,0,0,0
2011-09,39,35,1,1,27.875,-89.125,0,0,0
2011-09,39,37,1,1,27.875,-88.625,0,0,0
2011-09,39,46,3,1,27.875,-86.375,0,0,0
2011-09,40,17,0,0,28.125,-93.625,1,0,1
2011-09,40,18,0,0,28.125,-93.375,1,0,1
2011-09,40,19,0,0,28.125,-93.125,1,0,1
2011-09,40,33,2,1,28.125,-89.625,0,0,0
2011-09,40,35,1,1,28.125,-89.125,0,0,0
2011-09,40,36,2,2,28.125,-88.875,0,0,0
2011-09,40,37,1,1,28.125,-88.625,0,0,0
2011-09,40,38,1,1,28.125,-88.375,0,0,0
2011-09,40,40,1,1,28.125,-87.875,0,0,0
2011-09,40,43,1,1,28.125,-87.125,0,0,0
2011-09,40,44,1,1,28.125,-86.875,0,0,0
2011-09,40,45,1,1,28.125,-86.625,0,0,0
2011-09,41,33,2,1,28.375,-89.625,0,0,0
2011-09,41,36,1,1,28.375,-88.875,0,0,0
2011-09,41,37,1,1,28.375,-88.625,0,0,0
2011-09,41,38,2,2,28.375,-88.375,0,0,0
2011-09,41,40,1,1,28.375,-87.875,0,0,0
2011-09,41,42,1,1,28.375,-87.375,0,5,5
2011-09,41,43,1,1,28.375,-87.125,0,9,9
2011-09,41,44,3,1,28.375,-86.875,0,10,10
2011-09,41,45,5,1,28.375,-86.625,0,0,0
2011-09,42,40,1,1,28.625,-87.875,0,0,0
2011-09,42,41,1,1,28.625,-87.625,0,0,0
2011-09,42,42,0,0,28.625,-87.375,0,5,5
2011-09,42,43,1,1,28.625,-87.125,0,0,0
2011-09,44,41,1,1,29.125,-87.625,0,0,0
2011-10,0,56,0,0,18.125,-83.875,0,1,1
2011-10,0,58,0,0,18.125,-83.375,2,0,2
2011-10,0,59,0,0,18.125,-83.125,2,0,2
2011-10,0,60,0,0,18.125,-82.875,3,0,3
2011-10,1,51,0,0,18.375,-85.125,0,2,2
2011-10,1,52,0,0,18.375,-84.875,0,2,2
2011-10,1,53,0,0,18.375,-84.625,0,4,4
2011-10,1,54,0,0,18.375,-84.375,0,2,2
2011-10,1,55,0,0,18.375,-84.125,0,6,6
2011-10,1,56,0,0,18.375,-83.875,0,3,3
2011-10,2,51,0,0,18.625,-85.125,0,3,3
2011-10,2,52,0,0,18.625,-84.875,0,1,1
2011-10,2,55,0,0,18.625,-84.125,0,1,1
2011-10,2,69,0,0,18.625,-80.625,1,0,1
2011-10,3,67,0,0,18.875,-81.125,1,0,1
2011-10,3,68,0,0,18.875,-80.875,2,0,2
2011-10,4,62,0,0,19.125,-82.375,2,0,2
2011-10,4,63,0,0,19.125,-82.125,3,0,3
2011-10,4,64,0,0,19.125,-81.875,3,0,3
2011-10,4,65,0,0,19.125,-81.625,2,0,2
2011-10,4,66,0,0,19.125,-81.375,3,0,3
2011-10,4,67,0,0,19.125,-81.125,1,0,1
2011-10,5,60,0,0,19.375,-82.875,2,0,2
2011-10,5,61,0,0,19.375,-82.625,3,0,3
2011-10,5,62,0,0,19.375,-82.375,1,0,1
2011-10,6,69,0,0,19.625,-80.625,0,5,5
2011-10,6,70,0,0,19.625,-80.375,0,4,4
2011-10,7,69,0,0,19.875,-80.625,0,4,4
2011-10,8,68,0,0,20.125,-80.875,0,3,3
2011-10,9,7,0,0,20.375,-96.125,0,2,2
2011-10,9,66,0,0,20.375,-81.375,0,5,5
2011-10,9,68,0,0,20.375,-80.875,0,5,5
2011-10,10,7,0,0,20.625,-96.125,0,4,4
2011-10,10,68,0,0,20.625,-80.875,0,4,4
2011-10,11,7,0,0,20.875,-96.125,0,3,3
2011-10,11,54,0,0,20.875,-84.375,0,2,2
2011-10,11,55,0,0,20.875,-84.125,0,7,7
2011-10,11,56,0,0,20.875,-83.875,0,3,3
2011-10,11,57,0,0,20.875,-83.625,0,3,3
2011-10,12,56,0,0,21.125,-83.875,0,10,10
2011-10,12,57,0,0,21.125,-83.625,0,3,3
2011-10,15,10,0,0,21.875,-95.375,3,0,3
2011-10,15,11,0,0,21.875,-95.125,2,0,2
2011-10,15,13,0,0,21.875,-94.625,4,0,4
2011-10,15,14,0,0,21.875,-94.375,7,0,7
2011-10,16,12,0,0,22.125,-94.875,3,0,3
2011-10,16,13,0,0,22.125,-94.625,1,0,1
2011-10,16,15,0,0,22.125,-94.125,4,0,4
2011-10,16,16,0,0,22.125,-93.875,1,0,1
2011-10,17,14,0,0,22.375,-94.375,2,0,2
2011-10,17,15,0,0,22.375,-94.125,4,0,4
2011-10,20,4,1,1,23.125,-96.875,0,0,0
2011-10,20,23,0,0,23.125,-92.125,0,3,3
2011-10,20,24,0,0,23.125,-91.875,0,1,1
2011-10,21,23,0,0,23.375,-92.125,0,2,2
2011-10,22,5,1,1,23.625,-96.625,0,0,0
2011-10,22,29,1,1,23.625,-90.625,0,0,0
2011-10,22,54,0,0,23.625,-84.375,6,0,6
2011-10,22,55,0,0,23.625,-84.125,18,0,18
2011-10,23,14,1,1,23.875,-94.375,0,0,0
2011-10,23,17,1,1,23.875,-93.625,0,0,0
2011-10,23,27,1,1,23.875,-91.125,0,0,0
2011-10,23,31,1,1,23.875,-90.125,0,0,0
2011-10,23,55,0,0,23.875,-84.125,1,0,1
2011-10,24,7,1,1,24.125,-96.125,0,3,3
2011-10,24,8,0,0,24.125,-95.875,0,4,4
2011-10,24,10,1,1,24.125,-95.375,0,0,0
2011-10,24,12,1,1,24.125,-94.875,0,0,0
2011-10,24,19,1,1,24.125,-93.125,0,0,0
2011-10,24,24,1,1,24.125,-91.875,0,0,0
2011-10,24,34,2,1,24.125,-89.375,0,0,0
2011-10,24,35,2,1,24.125,-89.125,0,0,0
2011-10,24,36,2,1,24.125,-88.875,0,0,0
2011-10,24,37,10,1,24.125,-88.625,0,0,0
2011-10,24,38,4,1,24.125,-88.375,0,0,0
2011-10,25,7,0,0,24.375,-96.125,0,10,10
2011-10,25,8,0,0,24.375,-95.875,0,5,5
2011-10,25,9,1,1,24.375,-95.625,0,2,2
2011-10,25,10,0,0,24.375,-95.375,0,2,2
2011-10,25,35,2,1,24.375,-89.125,0,0,0
2011-10,25,37,4,1,24.375,-88.625,0,0,0
2011-10,25,38,1,1,24.375,-88.375,0,0,0
2011-10,26,10,0,0,24.625,-95.375,0,1,1
2011-10,26,11,0,0,24.625,-95.125,0,2,2
2011-10,26,20,1,1,24.625,-92.875,0,0,0
2011-10,26,21,1,1,24.625,-92.625,0,0,0
2011-10,26,31,1,1,24.625,-90.125,0,0,0
2011-10,26,35,2,1,24.625,-89.125,0,0,0
2011-10,26,36,2,1,24.625,-88.875,0,0,0
2011-10,26,38,1,1,24.625,-88.375,0,0,0
2011-10,26,39,1,1,24.625,-88.125,0,0,0
2011-10,26,51,0,0,24.625,-85.125,2,0,2
2011-10,26,52,0,0,24.625,-84.875,3,0,3
2011-10,26,53,0,0,24.625,-84.625,1,0,1
2011-10,27,22,0,0,24.875,-92.375,0,2,2
2011-10,27,31,1,1,24.875,-90.125,0,0,0
2011-10,27,39,1,1,24.875,-88.125,0,0,0
2011-10,28,23,0,0,25.125,-92.125,0,7,7
2011-10,28,30,1,1,25.125,-90.375,0,0,0
2011-10,28,38,1,1,25.125,-88.375,0,0,0
2011-10,28,41,1,1,25.125,-87.625,0,0,0
2011-10,28,45,0,0,25.125,-86.625,0,6,6
2011-10,28,46,0,0,25.125,-86.375,0,6,6
2011-10,29,23,0,0,25.375,-92.125,0,8,8
2011-10,29,32,1,1,25.375,-89.875,0,0,0
2011-10,29,41,1,1,25.375,-87.625,0,0,0
2011-10,29,43,1,1,25.375,-87.125,0,0,0
2011-10,29,44,0,0,25.375,-86.875,0,3,3
2011-10,29,46,0,0,25.375,-86.375,0,2,2
2011-10,29,50,0,0,25.375,-85.375,1,0,1
2011-10,29,51,0,0,25.375,-85.125,2,0,2
2011-10,30,23,0,0,25.625,-92.125,0,14,14
2011-10,30,36,0,0,25.625,-88.875,4,0,4
2011-10,30,37,0,0,25.625,-88.625,3,0,3
2011-10,30,42,1,1,25.625,-87.375,0,0,0
2011-10,30,44,0,0,25.625,-86.875,0,1,1
2011-10,30,51,0,0,25.625,-85.125,2,0,2
2011-10,31,11,0,0,25.875,-95.125,0,1,1
2011-10,31,34,1,1,25.875,-89.375,0,0,0
2011-10,31,36,0,0,25.875,-88.875,5,0,5
2011-10,31,43,1,1,25.875,-87.125,0,0,0
2011-10,31,44,0,0,25.875,-86.875,0,4,4
2011-10,31,51,0,0,25.875,-85.125,1,0,1
2011-10,31,52,0,0,25.875,-84.875,3,0,3
2011-10,32,11,0,0,26.125,-95.125,0,1,1
2011-10,32,35,1,1,26.125,-89.125,0,0,0
2011-10,32,36,0,0,26.125,-88.875,4,0,4
2011-10,32,44,1,1,26.125,-86.875,0,4,4
2011-10,32,45,1,1,26.125,-86.625,0,0,0
2011-10,32,52,0,0,26.125,-84.875,1,0,1
2011-10,33,11,0,0,26.375,-95.125,0,13,13
2011-10,33,12,0,0,26.375,-94.875,0,2,2
2011-10,33,30,0,0,26.375,-90.375,1,0,1
2011-10,33,36,1,1,26.375,-88.875,6,0,6
2011-10,33,37,0,0,26.375,-88.625,2,0,2
2011-10,33,44,0,0,26.375,-86.875,0,5,5
2011-10,33,45,1,1,26.375,-86.625,0,0,0
2011-10,33,52,0,0,26.375,-84.875,1,0,1
2011-10,34,10,0,0,26.625,-95.375,0,1,1
2011-10,34,11,0,0,26.625,-95.125,0,6,6
2011-10,34,12,0,0,26.625,-94.875,0,6,6
2011-10,34,29,0,0,26.625,-90.625,6,0,6
2011-10,34,30,0,0,26.625,-90.375,1,0,1
2011-10,34,37,1,1,26.625,-88.625,4,0,4
2011-10,34,51,0,0,26.625,-85.125,1,0,1
2011-10,35,11,0,0,26.875,-95.125,0,1,1
2011-10,35,28,0,0,26.875,-90.875,1,0,1
2011-10,35,29,0,0,26.875,-90.625,13,0,13
2011-10,35,47,1,1,26.875,-86.125,0,0,0
2011-10,35,51,0,0,26.875,-85.125,1,0,1
2011-10,35,52,0,0,26.875,-84.875,1,0,1
2011-10,36,28,0,0,27.125,-90.875,7,0,7
2011-10,36,29,0,0,27.125,-90.625,2,0,2
2011-10,36,36,1,1,27.125,-88.875,0,0,0
2011-10,36,37,1,1,27.125,-88.625,0,0,0
2011-10,36,50,0,0,27.125,-85.375,1,0,1
2011-10,36,51,0,0,27.125,-85.125,6,0,6
2011-10,37,37,1,1,27.375,-88.625,0,0,0
2011-10,37,38,0,0,27.375,-88.375,3,0,3
2011-10,37,41,2,1,27.375,-87.625,0,0,0
2011-10,37,47,1,1,27.375,-86.125,0,0,0
2011-10,37,50,0,0,27.375,-85.375,3,0,3
2011-10,37,51,0,0,27.375,-85.125,1,0,1
2011-10,38,18,0,0,27.625,-93.375,5,0,5
2011-10,38,38,1,1,27.625,-88.375,0,0,0
2011-10,38,47,2,1,27.625,-86.125,0,0,0
2011-10,39,15,0,0,27.875,-94.125,7,0,7
2011-10,39,16,0,0,27.875,-93.875,3,0,3
2011-10,39,17,0,0,27.875,-93.625,2,0,2
2011-10,39,18,0,0,27.875,-93.375,4,0,4
2011-10,40,16,0,0,28.125,-93.875,2,0,2
2011-10,40,17,0,0,28.125,-93.625,1,0,1
2011-10,40,18,0,0,28.125,-93.375,3,0,3
2011-10,40,39,1,1,28.125,-88.125,0,0,0
2011-10,41,41,1,1,28.375,-87.625,0,1,1
2011-10,41,44,2,1,28.375,-86.875,0,0,0
2011-10,41,45,3,1,28.375,-86.625,0,0,0
2011-10,42,41,5,1,28.625,-87.625,0,14,14
2011-10,42,42,5,1,28.625,-87.375,0,0,0
2011-10,42,43,2,1,28.625,-87.125,0,0,0
2011-10,42,71,0,0,28.625,-80.125,0,4,4
2011-10,43,40,0,0,28.875,-87.875,0,15,15
2011-10,43,41,1,1,28.875,-87.625,0,0,0
2011-10,44,36,1,1,29.125,-88.875,0,0,0
2011-10,44,41,1,1,29.125,-87.625,0,0,0
2011-10,44,42,1,1,29.125,-87.375,0,0,0
2011-11,0,50,0,0,18.125,-85.375,0,2,2
2011-11,0,51,0,0,18.125,-85.125,0,2,2
2011-11,0,52,0,0,18.125,-84.875,0,1,1
2011-11,0,57,0,0,18.125,-83.625,2,0,2
2011-11,0,58,0,0,18.125,-83.375,1,0,1
2011-11,0,69,0,0,18.125,-80.625,3,0,3
2011-11,1,47,0,0,18.375,-86.125,0,3,3
2011-11,1,48,0,0,18.375,-85.875,0,3,3
2011-11,1,49,0,0,18.375,-85.625,0,2,2
2011-11,1,53,0,0,18.375,-84.625,6,0,6
2011-11,1,54,0,0,18.375,-84.375,5,0,5
2011-11,1,55,0,0,18.375,-84.125,5,0,5
2011-11,1,56,0,0,18.375,-83.875,6,0,6
2011-11,1,57,0,0,18.375,-83.625,4,0,4
2011-11,1,58,0,0,18.375,-83.375,1,0,1
2011-11,1,68,0,0,18.375,-80.875,2,0,2
2011-11,2,46,0,0,18.625,-86.375,0,2,2
2011-11,2,67,0,0,18.625,-81.125,2,0,2
2011-11,4,70,0,0,19.125,-80.375,0,1,1
2011-11,4,71,0,0,19.125,-80.125,0,17,17
2011-11,9,66,0,0,20.375,-81.375,0,1,1
2011-11,10,54,0,0,20.625,-84.375,0,2,2
2011-11,10,57,0,0,20.625,-83.625,0,1,1
2011-11,11,53,0,0,20.875,-84.625,0,9,9
2011-11,11,54,0,0,20.875,-84.375,0,12,12
2011-11,12,52,0,0,21.125,-84.875,0,1,1
2011-11,14,9,0,0,21.625,-95.625,3,0,3
2011-11,14,10,0,0,21.625,-95.375,2,0,2
2011-11,15,9,1,1,21.875,-95.625,0,0,0
2011-11,15,10,0,0,21.875,-95.375,8,0,8
2011-11,15,11,0,0,21.875,-95.125,7,0,7
2011-11,15,12,0,0,21.875,-94.875,5,0,5
2011-11,16,11,0,0,22.125,-95.125,1,0,1
2011-11,16,12,0,0,22.125,-94.875,4,0,4
2011-11,17,11,1,1,22.375,-95.125,0,0,0
2011-11,17,16,1,1,22.375,-93.875,0,0,0
2011-11,17,17,2,1,22.375,-93.625,0,0,0
2011-11,17,46,1,1,22.375,-86.375,0,0,0
2011-11,18,11,1,1,22.625,-95.125,0,0,0
2011-11,18,17,2,1,22.625,-93.625,0,0,0
2011-11,18,18,3,1,22.625,-93.375,0,0,0
2011-11,18,19,2,1,22.625,-93.125,0,0,0
2011-11,18,20,2,1,22.625,-92.875,0,0,0
2011-11,18,21,1,1,22.625,-92.625,0,0,0
2011-11,19,12,1,1,22.875,-94.875,0,0,0
2011-11,19,22,1,1,22.875,-92.375,0,0,0
2011-11,19,23,1,1,22.875,-92.125,0,0,0
2011-11,19,24,1,1,22.875,-91.875,0,0,0
2011-11,19,25,5,1,22.875,-91.625,0,0,0
2011-11,19,26,3,1,22.875,-91.375,0,0,0
2011-11,20,9,1,1,23.125,-95.625,0,0,0
2011-11,20,12,1,1,23.125,-94.875,0,0,0
2011-11,20,26,1,1,23.125,-91.375,0,0,0
2011-11,20,27,1,1,23.125,-91.125,0,0,0
2011-11,21,4,1,1,23.375,-96.875,0,0,0
2011-11,21,5,1,1,23.375,-96.625,0,0,0
2011-11,21,6,1,1,23.375,-96.375,0,0,0
2011-11,21,8,1,1,23.375,-95.875,0,0,0
2011-11,21,29,1,1,23.375,-90.625,0,0,0
2011-11,22,16,1,1,23.625,-93.875,0,0,0
2011-11,23,28,1,1,23.875,-90.875,0,0,0
2011-11,23,31,1,1,23.875,-90.125,0,0,0
2011-11,23,37,1,1,23.875,-88.625,0,0,0
2011-11,23,48,0,0,23.875,-85.875,2,0,2
2011-11,23,56,0,0,23.875,-83.875,0,3,3
2011-11,23,57,0,0,23.875,-83.625,0,11,11
2011-11,24,13,1,1,24.125,-94.625,0,0,0
2011-11,24,19,1,1,24.125,-93.125,0,0,0
2011-11,24,21,1,1,24.125,-92.625,0,0,0
2011-11,24,22,0,0,24.125,-92.375,0,2,2
2011-11,24,23,1,1,24.125,-92.125,0,0,0
2011-11,24,24,1,1,24.125,-91.875,0,0,0
2011-11,24,25,5,1,24.125,-91.625,0,0,0
2011-11,24,26,2,1,24.125,-91.375,0,0,0
2011-11,24,27,1,1,24.125,-91.125,0,0,0
2011-11,24,28,1,1,24.125,-90.875,0,0,0
2011-11,24,29,5,2,24.125,-90.625,0,0,0
2011-11,24,30,2,2,24.125,-90.375,0,0,0
2011-11,24,32,1,1,24.125,-89.875,0,0,0
2011-11,24,34,1,1,24.125,-89.375,0,0,0
2011-11,24,37,4,1,24.125,-88.625,0,0,0
2011-11,24,48,0,0,24.125,-85.875,8,0,8
2011-11,24,56,0,0,24.125,-83.875,0,3,3
2011-11,25,22,0,0,24.375,-92.375,0,6,6
2011-11,25,30,1,1,24.375,-90.375,0,0,0
2011-11,25,31,1,1,24.375,-90.125,0,0,0
2011-11,25,32,1,1,24.375,-89.875,0,0,0
2011-11,25,33,1,1,24.375,-89.625,0,0,0
2011-11,25,35,2,2,24.375,-89.125,0,0,0
2011-11,25,36,1,1,24.375,-88.875,0,0,0
2011-11,25,38,2,1,24.375,-88.375,0,0,0
2011-11,25,39,3,1,24.375,-88.125,0,0,0
2011-11,25,40,7,1,24.375,-87.875,0,0,0
2011-11,25,48,0,0,24.375,-85.875,5,0,5
2011-11,25,57,0,0,24.375,-83.625,0,2,2
2011-11,26,22,0,0,24.625,-92.375,0,14,14
2011-11,26,23,0,0,24.625,-92.125,0,4,4
2011-11,26,31,2,1,24.625,-90.125,0,0,0
2011-11,26,38,1,1,24.625,-88.375,0,0,0
2011-11,26,48,0,0,24.625,-85.875,4,0,4
2011-11,26,49,0,0,24.625,-85.625,7,0,7
2011-11,26,50,0,0,24.625,-85.375,1,0,1
2011-11,26,51,0,0,24.625,-85.125,1,0,1
2011-11,26,57,0,0,24.625,-83.625,0,2,2
2011-11,27,22,0,0,24.875,-92.375,0,4,4
2011-11,27,49,0,0,24.875,-85.625,1,0,1
2011-11,27,50,0,0,24.875,-85.375,1,0,1
2011-11,28,11,0,0,25.125,-95.125,0,5,5
2011-11,28,12,0,0,25.125,-94.875,0,12,12
2011-11,29,11,0,0,25.375,-95.125,0,3,3
2011-11,29,12,0,0,25.375,-94.875,0,6,6
2011-11,30,11,0,0,25.625,-95.125,0,2,2
2011-11,31,11,0,0,25.875,-95.125,0,2,2
2011-11,31,32,0,0,25.875,-89.875,2,0,2
2011-11,32,28,0,0,26.125,-90.875,2,0,2
2011-11,32,29,0,0,26.125,-90.625,7,0,7
2011-11,32,30,0,0,26.125,-90.375,5,0,5
2011-11,32,31,0,0,26.125,-90.125,9,0,9
2011-11,32,32,0,0,26.125,-89.875,5,0,5
2011-11,32,43,0,0,26.125,-87.125,0,6,6
2011-11,33,44,0,0,26.375,-86.875,0,24,24
2011-11,36,16,0,0,27.125,-93.875,2,0,2
2011-11,36,17,0,0,27.125,-93.625,6,0,6
2011-11,37,38,0,0,27.375,-88.375,2,0,2
2011-11,38,17,0,0,27.625,-93.625,2,0,2
2011-11,38,18,0,0,27.625,-93.375,1,0,1
2011-11,38,38,0,0,27.625,-88.375,4,0,4
2011-11,38,39,0,0,27.625,-88.125,4,0,4
2011-11,39,17,0,0,27.875,-93.625,2,0,2
2011-11,39,18,0,0,27.875,-93.375,1,0,1
2011-11,39,40,0,0,27.875,-87.875,4,0,4
2011-11,39,41,0,0,27.875,-87.625,9,0,9
2011-11,39,42,0,0,27.875,-87.375,4,0,4
2011-11,39,43,0,0,27.875,-87.125,3,0,3
2011-11,40,16,0,0,28.125,-93.875,1,0,1
2011-12,0,46,0,0,18.125,-86.375,7,0,7
2011-12,0,47,0,0,18.125,-86.125,2,0,2
2011-12,0,48,0,0,18.125,-85.875,2,0,2
2011-12,0,69,0,0,18.125,-80.625,2,0,2
2011-12,1,52,0,0,18.375,-84.875,1,0,1
2011-12,1,67,0,0,18.375,-81.125,5,0,5
2011-12,1,68,0,0,18.375,-80.875,5,0,5
2011-12,2,50,0,0,18.625,-85.375,3,0,3
2011-12,2,51,0,0,18.625,-85.125,4,0,4
2011-12,2,52,0,0,18.625,-84.875,5,0,5
2011-12,2,64,0,0,18.625,-81.875,1,0,1
2011-12,2,65,0,0,18.625,-81.625,2,0,2
2011-12,2,66,0,0,18.625,-81.375,2,0,2
2011-12,2,67,0,0,18.625,-81.125,1,0,1
2011-12,3,49,0,0,18.875,-85.625,4,0,4
2011-12,3,50,0,0,18.875,-85.375,2,0,2
2011-12,3,62,0,0,18.875,-82.375,2,0,2
2011-12,3,63,0,0,18.875,-82.125,2,0,2
2011-12,3,64,0,0,18.875,-81.875,1,0,1
2011-12,5,71,0,0,19.375,-80.125,1,0,1
2011-12,10,69,0,0,20.625,-80.625,0,2,2
2011-12,10,70,0,0,20.625,-80.375,0,4,4
2011-12,10,71,0,0,20.625,-80.125,0,1,1
2011-12,11,52,0,0,20.875,-84.875,0,1,1
2011-12,11,63,0,0,20.875,-82.125,0,3,3
2011-12,11,64,0,0,20.875,-81.875,0,4,4
2011-12,11,70,0,0,20.875,-80.375,0,2,2
2011-12,11,71,0,0,20.875,-80.125,0,3,3
2011-12,12,52,0,0,21.125,-84.875,0,3,3
2011-12,15,10,0,0,21.875,-95.375,2,0,2
2011-12,15,11,0,0,21.875,-95.125,3,0,3
2011-12,16,10,0,0,22.125,-95.375,1,0,1
2011-12,16,11,0,0,22.125,-95.125,2,0,2
2011-12,17,16,1,1,22.375,-93.875,0,0,0
2011-12,19,16,1,1,22.875,-93.875,0,0,0
2011-12,20,10,0,0,23.125,-95.375,2,0,2
2011-12,20,15,1,1,23.125,-94.125,0,0,0
2011-12,21,14,2,1,23.375,-94.375,0,0,0
2011-12,21,17,0,0,23.375,-93.625,0,4,4
2011-12,21,18,0,0,23.375,-93.375,0,3,3
2011-12,21,19,0,0,23.375,-93.125,0,2,2
2011-12,21,20,0,0,23.375,-92.875,0,4,4
2011-12,21,21,0,0,23.375,-92.625,0,1,1
2011-12,22,16,2,1,23.625,-93.875,0,0,0
2011-12,22,18,2,1,23.625,-93.375,0,0,0
2011-12,22,21,0,0,23.625,-92.625,0,3,3
2011-12,22,22,0,0,23.625,-92.375,0,2,2
2011-12,22,27,2,1,23.625,-91.125,0,0,0
2011-12,22,43,5,1,23.625,-87.125,0,0,0
2011-12,23,16,4,1,23.875,-93.875,0,0,0
2011-12,23,18,1,1,23.875,-93.375,0,0,0
2011-12,23,19,1,1,23.875,-93.125,0,0,0
2011-12,23,20,1,1,23.875,-92.875,0,0,0
2011-12,23,22,1,1,23.875,-92.375,0,6,6
2011-12,23,24,1,1,23.875,-91.875,0,0,0
2011-12,23,25,1,1,23.875,-91.625,0,0,0
2011-12,23,26,1,1,23.875,-91.375,0,0,0
2011-12,23,27,2,1,23.875,-91.125,0,0,0
2011-12,23,28,1,1,23.875,-90.875,0,0,0
2011-12,23,42,1,1,23.875,-87.375,0,0,0
2011-12,23,43,5,1,23.875,-87.125,0,0,0
2011-12,23,46,0,0,23.875,-86.375,5,0,5
2011-12,23,47,0,0,23.875,-86.125,9,0,9
2011-12,23,48,0,0,23.875,-85.875,1,0,1
2011-12,23,56,0,0,23.875,-83.875,0,5,5
2011-12,23,57,0,0,23.875,-83.625,0,9,9
2011-12,24,22,0,0,24.125,-92.375,0,2,2
2011-12,24,31,1,1,24.125,-90.125,0,0,0
2011-12,24,32,4,1,24.125,-89.875,0,0,0
2011-12,24,36,1,1,24.125,-88.875,0,0,0
2011-12,24,40,1,1,24.125,-87.875,0,0,0
2011-12,24,41,1,1,24.125,-87.625,0,0,0
2011-12,24,42,1,1,24.125,-87.375,0,0,0
2011-12,24,46,0,0,24.125,-86.375,4,0,4
2011-12,24,55,0,0,24.125,-84.125,0,2,2
2011-12,25,15,0,0,24.375,-94.125,0,4,4
2011-12,25,31,1,1,24.375,-90.125,0,0,0
2011-12,25,33,1,1,24.375,-89.625,0,0,0
2011-12,25,39,1,1,24.375,-88.125,0,0,0
2011-12,25,54,0,0,24.375,-84.375,0,1,1
2011-12,25,55,0,0,24.375,-84.125,0,2,2
2011-12,26,34,1,1,24.625,-89.375,0,0,0
2011-12,26,47,0,0,24.625,-86.125,1,0,1
2011-12,26,54,0,0,24.625,-84.375,0,2,2
2011-12,26,55,0,0,24.625,-84.125,0,1,1
2011-12,27,31,1,1,24.875,-90.125,0,0,0
2011-12,27,47,0,0,24.875,-86.125,1,0,1
2011-12,27,54,0,0,24.875,-84.375,0,6,6
2011-12,28,28,1,1,25.125,-90.875,0,0,0
2011-12,28,46,0,0,25.125,-86.375,5,0,5
2011-12,28,54,0,0,25.125,-84.375,0,3,3
2011-12,29,12,0,0,25.375,-94.875,0,21,21
2011-12,29,13,0,0,25.375,-94.625,0,2,2
2011-12,29,14,0,0,25.375,-94.375,0,4,4
2011-12,29,38,0,0,25.375,-88.375,0,3,3
2011-12,30,25,1,1,25.625,-91.625,0,0,0
2011-12,30,38,0,0,25.625,-88.375,0,2,2
2011-12,30,39,0,0,25.625,-88.125,0,3,3
2011-12,31,22,1,1,25.875,-92.375,0,0,0
2011-12,31,39,0,0,25.875,-88.125,0,7,7
2011-12,31,40,0,0,25.875,-87.875,0,4,4
2011-12,32,21,3,1,26.125,-92.625,0,0,0
2011-12,32,25,0,0,26.125,-91.625,5,0,5
2011-12,32,26,0,0,26.125,-91.375,10,0,10
2011-12,32,27,0,0,26.125,-91.125,11,0,11
2011-12,32,28,0,0,26.125,-90.875,5,0,5
2011-12,32,40,0,0,26.125,-87.875,0,1,1
2011-12,32,41,0,0,26.125,-87.625,0,4,4
2011-12,32,42,0,0,26.125,-87.375,0,7,7
2011-12,33,48,0,0,26.375,-85.875,1,0,1
2011-12,34,48,0,0,26.625,-85.875,4,0,4
2011-12,35,48,0,0,26.875,-85.875,3,0,3
2011-12,36,47,0,0,27.125,-86.125,2,0,2
2011-12,36,48,0,0,27.125,-85.875,1,0,1
2011-12,37,46,0,0,27.375,-86.375,1,0,1
2011-12,37,47,0,0,27.375,-86.125,2,0,2
2011-12,38,45,0,0,27.625,-86.625,2,0,2
2011-12,38,46,0,0,27.625,-86.375,1,0,1
2011-12,39,44,0,0,27.875,-86.875,2,0,2
2012-01,0,46,0,0,18.125,-86.375,2,0,2
2012-01,1,71,0,0,18.375,-80.125,1,0,1
2012-01,2,71,0,0,18.625,-80.125,5,0,5
2012-01,3,67,0,0,18.875,-81.125,1,0,1
2012-01,3,69,0,0,18.875,-80.625,3,0,3
2012-01,3,70,0,0,18.875,-80.375,4,0,4
2012-01,6,50,0,0,19.625,-85.375,4,0,4
2012-01,7,49,0,0,19.875,-85.625,3,0,3
2012-01,7,50,0,0,19.875,-85.375,1,0,1
2012-01,8,51,0,0,20.125,-85.125,1,0,1
2012-01,10,8,0,0,20.625,-95.875,1,0,1
2012-01,10,9,0,0,20.625,-95.625,2,0,2
2012-01,10,64,0,0,20.625,-81.875,0,2,2
2012-01,11,8,0,0,20.875,-95.875,2,0,2
2012-01,11,9,0,0,20.875,-95.625,9,0,9
2012-01,11,10,0,0,20.875,-95.375,1,0,1
2012-01,11,59,0,0,20.875,-83.125,0,1,1
2012-01,11,60,0,0,20.875,-82.875,0,2,2
2012-01,11,61,0,0,20.875,-82.625,0,7,7
2012-01,11,62,0,0,20.875,-82.375,0,2,2
2012-01,11,63,0,0,20.875,-82.125,0,9,9
2012-01,12,9,0,0,21.125,-95.625,6,0,6
2012-01,12,10,0,0,21.125,-95.375,3,0,3
2012-01,12,56,0,0,21.125,-83.875,0,3,3
2012-01,12,57,0,0,21.125,-83.625,0,2,2
2012-01,13,10,0,0,21.375,-95.375,4,0,4
2012-01,14,10,0,0,21.625,-95.375,1,0,1
2012-01,16,14,0,0,22.125,-94.375,0,5,5
2012-01,18,9,1,1,22.625,-95.625,0,0,0
2012-01,20,14,0,0,23.125,-94.375,0,3,3
2012-01,21,14,0,0,23.375,-94.375,0,4,4
2012-01,21,29,1,1,23.375,-90.625,0,0,0
2012-01,21,30,1,1,23.375,-90.375,0,0,0
2012-01,21,31,2,1,23.375,-90.125,0,0,0
2012-01,21,32,2,1,23.375,-89.875,0,0,0
2012-01,22,14,0,0,23.625,-94.375,0,3,3
2012-01,22,18,0,0,23.625,-93.375,5,0,5
2012-01,22,19,0,0,23.625,-93.125,3,0,3
2012-01,22,33,1,1,23.625,-89.625,0,0,0
2012-01,23,14,0,0,23.875,-94.375,0,5,5
2012-01,23,19,0,0,23.875,-93.125,6,0,6
2012-01,23,49,0,0,23.875,-85.625,0,1,1
2012-01,23,50,0,0,23.875,-85.375,0,4,4
2012-01,23,51,0,0,23.875,-85.125,0,4,4
2012-01,23,52,0,0,23.875,-84.875,0,2,2
2012-01,24,7,0,0,24.125,-96.125,4,0,4
2012-01,24,14,0,0,24.125,-94.375,0,6,6
2012-01,24,19,0,0,24.125,-93.125,3,0,3
2012-01,24,20,0,0,24.125,-92.875,2,0,2
2012-01,24,28,1,1,24.125,-90.875,0,0,0
2012-01,24,53,0,0,24.125,-84.625,0,7,7
2012-01,24,54,0,0,24.125,-84.375,0,4,4
2012-01,24,55,0,0,24.125,-84.125,0,2,2
2012-01,25,6,0,0,24.375,-96.375,15,0,15
2012-01,25,7,0,0,24.375,-96.125,5,0,5
2012-01,25,15,0,0,24.375,-94.125,0,3,3
2012-01,25,20,0,0,24.375,-92.875,3,0,3
2012-01,25,25,1,1,24.375,-91.625,0,0,0
2012-01,25,55,0,0,24.375,-84.125,0,5,5
2012-01,26,20,0,0,24.625,-92.875,2,0,2
2012-01,26,25,3,1,24.625,-91.625,0,0,0
2012-01,26,26,3,1,24.625,-91.375,0,0,0
2012-01,26,54,0,0,24.625,-84.375,0,2,2
2012-01,27,24,1,1,24.875,-91.875,0,0,0
2012-01,27,27,1,1,24.875,-91.125,0,0,0
2012-01,27,28,2,1,24.875,-90.875,0,0,0
2012-01,27,29,2,1,24.875,-90.625,0,0,0
2012-01,27,31,1,1,24.875,-90.125,0,0,0
2012-01,27,32,1,1,24.875,-89.875,0,0,0
2012-01,28,14,0,0,25.125,-94.375,0,7,7
2012-01,28,33,0,0,25.125,-89.625,0,4,4
2012-01,28,34,0,0,25.125,-89.375,0,6,6
2012-01,28,35,0,0,25.125,-89.125,0,5,5
2012-01,28,36,0,0,25.125,-88.875,0,4,4
2012-01,28,37,0,0,25.125,-88.625,0,6,6
2012-01,28,38,0,0,25.125,-88.375,0,3,3
2012-01,29,22,7,1,25.375,-92.375,0,0,0
2012-01,29,38,0,0,25.375,-88.375,0,3,3
2012-01,29,46,0,0,25.375,-86.375,4,0,4
2012-01,30,45,0,0,25.625,-86.625,6,0,6
2012-01,31,21,1,1,25.875,-92.625,0,0,0
2012-01,31,44,0,0,25.875,-86.875,6,0,6
2012-01,31,45,0,0,25.875,-86.625,3,0,3
2012-01,32,25,0,0,26.125,-91.625,4,0,4
2012-01,32,26,0,0,26.125,-91.375,2,0,2
2012-01,32,27,0,0,26.125,-91.125,8,0,8
2012-01,32,42,0,0,26.125,-87.375,1,0,1
2012-01,32,43,0,0,26.125,-87.125,11,0,11
2012-01,33,16,0,0,26.375,-93.875,1,0,1
2012-01,33,17,0,0,26.375,-93.625,1,0,1
2012-01,33,26,0,0,26.375,-91.375,8,0,8
2012-01,33,27,0,0,26.375,-91.125,5,0,5
2012-01,34,15,0,0,26.625,-94.125,4,0,4
2012-01,34,16,0,0,26.625,-93.875,4,0,4
2012-01,34,27,0,0,26.625,-91.125,4,0,4
2012-01,34,51,0,0,26.625,-85.125,0,4,4
2012-01,35,8,0,0,26.875,-95.875,0,7,7
2012-01,35,51,0,0,26.875,-85.125,0,13,13
2012-01,35,52,0,0,26.875,-84.875,0,2,2
2012-01,36,8,0,0,27.125,-95.875,0,7,7
2012-01,36,49,0,0,27.125,-85.625,0,1,1
2012-01,36,50,0,0,27.125,-85.375,0,6,6
2012-01,37,49,0,0,27.375,-85.625,0,1,1
2012-01,37,50,0,0,27.375,-85.375,0,1,1
2012-01,39,47,0,0,27.875,-86.125,0,3,3
2012-02,0,55,0,0,18.125,-84.125,0,5,5
2012-02,1,54,0,0,18.375,-84.375,0,2,2
2012-02,1,55,0,0,18.375,-84.125,0,2,2
2012-02,1,56,0,0,18.375,-83.875,0,1,1
2012-02,1,57,0,0,18.375,-83.625,0,2,2
2012-02,3,63,0,0,18.875,-82.125,2,0,2
2012-02,3,64,0,0,18.875,-81.875,2,0,2
2012-02,3,65,0,0,18.875,-81.625,2,0,2
2012-02,3,66,0,0,18.875,-81.375,3,0,3
2012-02,4,62,0,0,19.125,-82.375,3,0,3
2012-02,4,63,0,0,19.125,-82.125,2,0,2
2012-02,5,60,0,0,19.375,-82.875,1,0,1
2012-02,5,62,0,0,19.375,-82.375,1,0,1
2012-02,7,46,0,0,19.875,-86.375,6,0,6
2012-02,7,47,0,0,19.875,-86.125,1,0,1
2012-02,7,48,0,0,19.875,-85.875,6,0,6
2012-02,8,46,0,0,20.125,-86.375,4,0,4
2012-02,8,47,0,0,20.125,-86.125,9,0,9
2012-02,8,48,0,0,20.125,-85.875,2,0,2
2012-02,9,7,0,0,20.375,-96.125,1,0,1
2012-02,10,7,0,0,20.625,-96.125,9,0,9
2012-02,10,8,0,0,20.625,-95.875,6,0,6
2012-02,10,59,0,0,20.625,-83.125,0,1,1
2012-02,11,8,0,0,20.875,-95.875,1,0,1
2012-02,11,56,0,0,20.875,-83.875,0,1,1
2012-02,11,57,0,0,20.875,-83.625,0,5,5
2012-02,11,58,0,0,20.875,-83.375,0,14,14
2012-02,11,59,0,0,20.875,-83.125,0,1,1
2012-02,12,56,0,0,21.125,-83.875,0,5,5
2012-02,12,57,0,0,21.125,-83.625,0,1,1
2012-02,15,7,0,0,21.875,-96.125,0,2,2
2012-02,15,8,0,0,21.875,-95.875,0,1,1
2012-02,15,9,0,0,21.875,-95.625,0,2,2
2012-02,15,10,0,0,21.875,-95.375,0,3,3
2012-02,15,11,0,0,21.875,-95.125,0,5,5
2012-02,15,12,0,0,21.875,-94.875,0,4,4
2012-02,15,13,0,0,21.875,-94.625,0,6,6
2012-02,16,12,0,0,22.125,-94.875,0,1,1
2012-02,16,13,0,0,22.125,-94.625,0,3,3
2012-02,16,14,0,0,22.125,-94.375,0,2,2
2012-02,19,14,0,0,22.875,-94.375,1,0,1
2012-02,19,15,0,0,22.875,-94.125,1,0,1
2012-02,19,27,0,0,22.875,-91.125,5,0,5
2012-02,19,28,0,0,22.875,-90.875,5,0,5
2012-02,20,15,0,0,23.125,-94.125,7,0,7
2012-02,20,16,0,0,23.125,-93.875,3,0,3
2012-02,20,28,0,0,23.125,-90.875,4,0,4
2012-02,20,29,0,0,23.125,-90.625,2,0,2
2012-02,21,16,0,0,23.375,-93.875,8,0,8
2012-02,21,17,0,0,23.375,-93.625,5,0,5
2012-02,21,32,1,1,23.375,-89.875,0,0,0
2012-02,21,35,1,1,23.375,-89.125,0,0,0
2012-02,22,17,0,0,23.625,-93.625,2,0,2
2012-02,22,18,0,0,23.625,-93.375,2,0,2
2012-02,22,38,1,1,23.625,-88.375,0,0,0
2012-02,22,49,0,0,23.625,-85.625,0,1,1
2012-02,23,40,5,1,23.875,-87.875,0,0,0
2012-02,23,46,0,0,23.875,-86.375,0,3,3
2012-02,23,47,0,0,23.875,-86.125,0,3,3
2012-02,24,40,1,1,24.125,-87.875,0,0,0
2012-02,24,46,0,0,24.125,-86.375,0,7,7
2012-02,25,6,0,0,24.375,-96.375,9,0,9
2012-02,25,45,0,0,24.375,-86.625,0,2,2
2012-02,25,46,0,0,24.375,-86.375,0,3,3
2012-02,26,6,0,0,24.625,-96.375,14,0,14
2012-02,26,45,0,0,24.625,-86.625,0,4,4
2012-02,27,6,0,0,24.875,-96.375,1,0,1
2012-02,27,7,0,0,24.875,-96.125,2,0,2
2012-02,27,14,0,0,24.875,-94.375,0,9,9
2012-02,27,15,0,0,24.875,-94.125,0,3,3
2012-02,27,35,1,1,24.875,-89.125,0,0,0
2012-02,27,36,1,1,24.875,-88.875,0,0,0
2012-02,27,39,1,1,24.875,-88.125,0,0,0
2012-02,27,45,0,0,24.875,-86.625,0,1,1
2012-02,28,14,0,0,25.125,-94.375,0,13,13
2012-02,28,15,0,0,25.125,-94.125,0,4,4
2012-02,28,30,0,0,25.125,-90.375,0,4,4
2012-02,28,32,0,0,25.125,-89.875,0,5,5
2012-02,28,33,0,0,25.125,-89.625,0,3,3
2012-02,28,45,0,0,25.125,-86.625,0,3,3
2012-02,29,30,0,0,25.375,-90.375,0,3,3
2012-02,29,31,0,0,25.375,-90.125,0,11,11
2012-02,29,32,0,0,25.375,-89.875,0,3,3
2012-02,29,45,0,0,25.375,-86.625,0,1,1
2012-02,29,51,0,0,25.375,-85.125,6,0,6
2012-02,29,52,0,0,25.375,-84.875,5,0,5
2012-02,30,50,0,0,25.625,-85.375,3,0,3
2012-02,31,39,0,0,25.875,-88.125,4,0,4
2012-02,31,49,0,0,25.875,-85.625,1,0,1
2012-02,32,37,0,0,26.125,-88.625,2,0,2
2012-02,32,38,0,0,26.125,-88.375,2,0,2
2012-02,32,39,0,0,26.125,-88.125,2,0,2
2012-02,32,42,0,0,26.125,-87.375,6,0,6
2012-02,32,43,0,0,26.125,-87.125,1,0,1
2012-02,33,16,0,0,26.375,-93.875,21,0,21
2012-02,33,17,0,0,26.375,-93.625,6,0,6
2012-02,33,37,0,0,26.375,-88.625,2,0,2
2012-02,33,38,0,0,26.375,-88.375,3,0,3
2012-02,33,45,0,0,26.375,-86.625,1,0,1
2012-02,33,46,0,0,26.375,-86.375,1,0,1
2012-02,34,8,0,0,26.625,-95.875,0,16,16
2012-02,34,9,0,0,26.625,-95.625,0,1,1
2012-02,34,27,0,0,26.625,-91.125,2,0,2
2012-02,34,28,0,0,26.625,-90.875,1,0,1
2012-02,35,8,0,0,26.875,-95.875,0,4,4
2012-02,35,9,0,0,26.875,-95.625,0,6,6
2012-02,35,28,0,0,26.875,-90.875,2,0,2
2012-02,35,30,0,0,26.875,-90.375,2,0,2
2012-02,36,8,0,0,27.125,-95.875,0,1,1
2012-02,36,9,0,0,27.125,-95.625,0,1,1
2012-02,36,30,0,0,27.125,-90.375,1,0,1
2012-02,39,47,0,0,27.875,-86.125,0,2,2
2012-02,40,43,0,0,28.125,-87.125,0,1,1
2012-02,40,44,0,0,28.125,-86.875,0,5,5
2012-02,40,45,0,0,28.125,-86.625,0,6,6
2012-02,40,46,0,0,28.125,-86.375,0,5,5
2012-02,40,47,0,0,28.125,-86.125,0,1,1
2012-02,41,43,0,0,28.375,-87.125,0,1,1
2012-02,41,44,0,0,28.375,-86.875,0,7,7
2012-02,41,45,0,0,28.375,-86.625,0,1,1
2012-03,0,51,0,0,18.125,-85.125,0,3,3
2012-03,1,47,0,0,18.375,-86.125,0,3,3
2012-03,1,48,0,0,18.375,-85.875,0,4,4
2012-03,1,49,0,0,18.375,-85.625,0,4,4
2012-03,1,50,0,0,18.375,-85.375,0,3,3
2012-03,1,51,0,0,18.375,-85.125,0,1,1
2012-03,1,53,0,0,18.375,-84.625,0,2,2
2012-03,1,54,0,0,18.375,-84.375,0,1,1
2012-03,2,47,0,0,18.625,-86.125,0,4,4
2012-03,3,46,0,0,18.875,-86.375,0,1,1
2012-03,3,47,0,0,18.875,-86.125,0,2,2
2012-03,4,46,0,0,19.125,-86.375,0,1,1
2012-03,12,56,0,0,21.125,-83.875,0,19,19
2012-03,13,13,0,0,21.375,-94.625,8,0,8
2012-03,13,14,0,0,21.375,-94.375,4,0,4
2012-03,14,12,0,0,21.625,-94.875,2,0,2
2012-03,14,13,0,0,21.625,-94.625,8,0,8
2012-03,14,14,0,0,21.625,-94.375,4,0,4
2012-03,15,7,0,0,21.875,-96.125,0,8,8
2012-03,16,6,0,0,22.125,-96.375,0,3,3
2012-03,16,7,0,0,22.125,-96.125,0,1,1
2012-03,17,6,0,0,22.375,-96.375,0,2,2
2012-03,18,6,0,0,22.625,-96.375,0,1,1
2012-03,18,14,0,0,22.625,-94.375,2,0,2
2012-03,19,7,0,0,22.875,-96.125,0,1,1
2012-03,19,14,0,0,22.875,-94.375,3,0,3
2012-03,19,26,0,0,22.875,-91.375,2,0,2
2012-03,19,27,0,0,22.875,-91.125,2,0,2
2012-03,20,7,0,0,23.125,-96.125,0,3,3
2012-03,20,24,0,0,23.125,-91.875,2,0,2
2012-03,20,25,0,0,23.125,-91.625,4,0,4
2012-03,20,26,0,0,23.125,-91.375,1,0,1
2012-03,20,46,0,0,23.125,-86.375,2,0,2
2012-03,20,47,0,0,23.125,-86.125,1,0,1
2012-03,20,48,0,0,23.125,-85.875,2,0,2
2012-03,21,7,0,0,23.375,-96.125,0,5,5
2012-03,21,23,0,0,23.375,-92.125,3,0,3
2012-03,21,24,0,0,23.375,-91.875,3,0,3
2012-03,22,7,0,0,23.625,-96.125,0,4,4
2012-03,22,8,0,0,23.625,-95.875,0,3,3
2012-03,22,22,0,0,23.625,-92.375,6,0,6
2012-03,22,23,0,0,23.625,-92.125,2,0,2
2012-03,23,21,0,0,23.875,-92.625,1,0,1
2012-03,24,52,0,0,24.125,-84.875,1,0,1
2012-03,24,54,0,0,24.125,-84.375,3,0,3
2012-03,24,55,0,0,24.125,-84.125,1,0,1
2012-03,25,52,0,0,24.375,-84.875,1,0,1
2012-03,25,53,0,0,24.375,-84.625,1,0,1
2012-03,25,54,0,0,24.375,-84.375,3,0,3
2012-03,26,13,0,0,24.625,-94.625,0,1,1
2012-03,26,29,0,0,24.625,-90.625,0,11,11
2012-03,26,30,0,0,24.625,-90.375,0,4,4
2012-03,26,52,0,0,24.625,-84.875,6,0,6
2012-03,26,53,0,0,24.625,-84.625,1,0,1
2012-03,27,13,0,0,24.875,-94.625,0,1,1
2012-03,27,14,0,0,24.875,-94.375,0,8,8
2012-03,27,30,0,0,24.875,-90.375,0,10,10
2012-03,27,52,0,0,24.875,-84.875,7,0,7
2012-03,28,30,0,0,25.125,-90.375,0,6,6
2012-03,28,52,0,0,25.125,-84.875,6,0,6
2012-03,28,53,0,0,25.125,-84.625,1,0,1
2012-03,29,45,0,0,25.375,-86.625,0,5,5
2012-03,30,45,0,0,25.625,-86.625,0,1,1
2012-03,30,47,0,0,25.625,-86.125,0,4,4
2012-03,31,24,0,0,25.875,-91.875,1,0,1
2012-03,31,37,0,0,25.875,-88.625,3,0,3
2012-03,31,46,0,0,25.875,-86.375,0,4,4
2012-03,31,47,0,0,25.875,-86.125,0,6,6
2012-03,32,13,0,0,26.125,-94.625,3,0,3
2012-03,32,14,0,0,26.125,-94.375,5,0,5
2012-03,32,24,0,0,26.125,-91.875,7,0,7
2012-03,32,25,0,0,26.125,-91.625,1,0,1
2012-03,32,37,0,0,26.125,-88.625,14,0,14
2012-03,32,38,0,0,26.125,-88.375,9,0,9
2012-03,32,45,0,0,26.125,-86.625,0,4,4
2012-03,32,46,0,0,26.125,-86.375,0,6,6
2012-03,33,14,0,0,26.375,-94.375,6,0,6
2012-03,33,15,0,0,26.375,-94.125,12,0,12
2012-03,33,16,0,0,26.375,-93.875,4,0,4
2012-03,33,24,0,0,26.375,-91.875,18,0,18
2012-03,33,37,0,0,26.375,-88.625,5,0,5
2012-03,34,24,0,0,26.625,-91.875,2,0,2
2012-03,34,49,0,0,26.625,-85.625,1,0,1
2012-03,34,50,0,0,26.625,-85.375,1,0,1
2012-03,35,8,0,0,26.875,-95.875,0,2,2
2012-03,35,9,0,0,26.875,-95.625,0,15,15
2012-03,35,48,0,0,26.875,-85.875,1,0,1
2012-03,35,49,0,0,26.875,-85.625,4,0,4
2012-03,36,48,0,0,27.125,-85.875,5,0,5
2012-03,36,49,0,0,27.125,-85.625,1,0,1
2012-03,40,44,0,0,28.125,-86.875,0,1,1
2012-03,41,42,0,0,28.375,-87.375,0,3,3
2012-03,41,43,0,0,28.375,-87.125,0,3,3
2012-03,41,44,0,0,28.375,-86.875,0,6,6
2012-03,41,46,0,0,28.375,-86.375,4,0,4
2012-03,41,47,0,0,28.375,-86.125,1,0,1
2012-03,42,39,0,0,28.625,-88.125,0,3,3
2012-03,42,40,0,0,28.625,-87.875,0,11,11
2012-03,42,41,0,0,28.625,-87.625,0,4,4
2012-03,42,46,0,0,28.625,-86.375,4,0,4
2012-03,42,47,0,0,28.625,-86.125,1,0,1
2012-04,0,43,0,0,18.125,-87.125,0,1,1
2012-04,0,44,0,0,18.125,-86.875,0,1,1
2012-04,0,54,0,0,18.125,-84.375,3,0,3
2012-04,0,55,0,0,18.125,-84.125,3,0,3
2012-04,1,43,0,0,18.375,-87.125,0,1,1
2012-04,1,55,0,0,18.375,-84.125,3,0,3
2012-04,2,54,0,0,18.625,-84.375,2,0,2
2012-04,2,55,0,0,18.625,-84.125,4,0,4
2012-04,3,53,0,0,18.875,-84.625,4,0,4
2012-04,3,54,0,0,18.875,-84.375,3,0,3
2012-04,3,55,0,0,18.875,-84.125,1,0,1
2012-04,3,71,0,0,18.875,-80.125,8,0,8
2012-04,4,52,0,0,19.125,-84.875,2,0,2
2012-04,4,53,0,0,19.125,-84.625,1,0,1
2012-04,4,68,0,0,19.125,-80.875,1,0,1
2012-04,4,69,0,0,19.125,-80.625,9,0,9
2012-04,4,70,0,0,19.125,-80.375,7,0,7
2012-04,4,71,0,0,19.125,-80.125,1,0,1
2012-04,5,13,0,0,19.375,-94.625,0,3,3
2012-04,5,14,0,0,19.375,-94.375,0,3,3
2012-04,5,69,0,0,19.375,-80.625,1,0,1
2012-04,6,12,0,0,19.625,-94.875,0,1,1
2012-04,6,13,0,0,19.625,-94.625,0,1,1
2012-04,6,14,0,0,19.625,-94.375,0,6,6
2012-04,7,16,0,0,19.875,-93.875,0,1,1
2012-04,8,16,0,0,20.125,-93.875,0,2,2
2012-04,11,55,0,0,20.875,-84.125,0,2,2
2012-04,11,56,0,0,20.875,-83.875,0,7,7
2012-04,12,56,0,0,21.125,-83.875,0,8,8
2012-04,12,57,0,0,21.125,-83.625,0,5,5
2012-04,14,9,0,0,21.625,-95.625,5,0,5
2012-04,14,11,0,0,21.625,-95.125,5,0,5
2012-04,14,12,0,0,21.625,-94.875,8,0,8
2012-04,15,10,0,0,21.875,-95.375,3,0,3
2012-04,15,11,0,0,21.875,-95.125,7,0,7
2012-04,15,12,0,0,21.875,-94.875,2,0,2
2012-04,20,16,0,0,23.125,-93.875,3,0,3
2012-04,20,17,0,0,23.125,-93.625,2,0,2
2012-04,21,45,0,0,23.375,-86.625,2,0,2
2012-04,22,7,0,0,23.625,-96.125,0,1,1
2012-04,22,44,0,0,23.625,-86.875,2,0,2
2012-04,22,55,0,0,23.625,-84.125,0,4,4
2012-04,23,7,0,0,23.875,-96.125,0,2,2
2012-04,23,8,0,0,23.875,-95.875,0,6,6
2012-04,23,41,0,0,23.875,-87.625,4,0,4
2012-04,23,43,0,0,23.875,-87.125,7,0,7
2012-04,23,54,0,0,23.875,-84.375,0,2,2
2012-04,23,55,0,0,23.875,-84.125,2,2,4
2012-04,23,56,0,0,23.875,-83.875,4,0,4
2012-04,23,57,0,0,23.875,-83.625,3,0,3
2012-04,23,58,0,0,23.875,-83.375,3,0,3
2012-04,23,60,0,0,23.875,-82.875,1,0,1
2012-04,23,61,0,0,23.875,-82.625,2,0,2
2012-04,23,62,0,0,23.875,-82.375,5,0,5
2012-04,24,8,0,0,24.125,-95.875,0,3,3
2012-04,24,26,0,0,24.125,-91.375,0,3,3
2012-04,24,27,0,0,24.125,-91.125,0,8,8
2012-04,24,41,0,0,24.125,-87.625,8,0,8
2012-04,24,42,0,0,24.125,-87.375,7,0,7
2012-04,24,54,0,0,24.125,-84.375,0,1,1
2012-04,24,55,0,0,24.125,-84.125,3,0,3
2012-04,24,62,0,0,24.125,-82.375,1,0,1
2012-04,25,8,0,0,24.375,-95.875,0,2,2
2012-04,25,9,0,0,24.375,-95.625,0,5,5
2012-04,25,28,0,0,24.375,-90.875,0,7,7
2012-04,25,29,0,0,24.375,-90.625,0,10,10
2012-04,26,9,0,0,24.625,-95.625,0,4,4
2012-04,26,10,0,0,24.625,-95.375,0,2,2
2012-04,26,29,0,0,24.625,-90.625,0,2,2
2012-04,27,11,0,0,24.875,-95.125,0,4,4
2012-04,27,12,0,0,24.875,-94.875,0,1,1
2012-04,27,52,0,0,24.875,-84.875,6,0,6
2012-04,28,46,0,0,25.125,-86.375,0,6,6
2012-04,28,52,0,0,25.125,-84.875,3,0,3
2012-04,28,53,0,0,25.125,-84.625,1,0,1
2012-04,29,46,0,0,25.375,-86.375,0,9,9
2012-04,29,52,0,0,25.375,-84.875,1,0,1
2012-04,29,53,0,0,25.375,-84.625,1,0,1
2012-04,30,46,0,0,25.625,-86.375,0,5,5
2012-04,30,52,0,0,25.625,-84.875,1,0,1
2012-04,31,46,0,0,25.875,-86.375,0,5,5
2012-04,31,52,0,0,25.875,-84.875,3,0,3
2012-04,32,13,0,0,26.125,-94.625,1,0,1
2012-04,32,14,0,0,26.125,-94.375,8,0,8
2012-04,32,46,0,0,26.125,-86.375,0,5,5
2012-04,32,51,0,0,26.125,-85.125,7,0,7
2012-04,32,52,0,0,26.125,-84.875,1,0,1
2012-04,33,14,0,0,26.375,-94.375,21,0,21
2012-04,33,36,0,0,26.375,-88.875,30,0,30
2012-04,33,50,0,0,26.375,-85.375,4,0,4
2012-04,34,23,0,0,26.625,-92.125,4,0,4
2012-04,34,24,0,0,26.625,-91.875,21,0,21
2012-04,34,25,0,0,26.625,-91.625,5,0,5
2012-04,34,50,0,0,26.625,-85.375,2,0,2
2012-04,40,40,0,0,28.125,-87.875,0,1,1
2012-04,41,35,0,0,28.375,-89.125,0,2,2
2012-04,41,36,0,0,28.375,-88.875,0,3,3
2012-04,41,37,0,0,28.375,-88.625,0,4,4
2012-04,41,38,0,0,28.375,-88.375,0,2,2
2012-04,41,39,0,0,28.375,-88.125,0,1,1
2012-04,41,40,0,0,28.375,-87.875,0,11,11
2012-04,41,43,0,0,28.375,-87.125,1,0,1
2012-04,41,44,0,0,28.375,-86.875,1,0,1
2012-04,42,39,0,0,28.625,-88.125,0,6,6
2012-04,42,43,0,0,28.625,-87.125,5,0,5
2012-04,42,44,0,0,28.625,-86.875,2,0,2
2012-04,42,45,0,0,28.625,-86.625,5,0,5
2012-04,42,46,0,0,28.625,-86.375,11,0,11
2012-04,43,43,0,0,28.875,-87.125,3,0,3
2012-04,43,44,0,0,28.875,-86.875,2,0,2
2012-05,2,61,0,0,18.625,-82.625,2,0,2
2012-05,2,62,0,0,18.625,-82.375,4,0,4
2012-05,2,63,0,0,18.625,-82.125,6,0,6
2012-05,2,64,0,0,18.625,-81.875,1,0,1
2012-05,3,61,0,0,18.875,-82.625,1,0,1
2012-05,3,64,0,0,18.875,-81.875,9,0,9
2012-05,3,65,0,0,18.875,-81.625,2,0,2
2012-05,3,66,0,0,18.875,-81.375,2,0,2
2012-05,4,49,0,0,19.125,-85.625,1,0,1
2012-05,4,50,0,0,19.125,-85.375,5,0,5
2012-05,4,51,0,0,19.125,-85.125,1,0,1
2012-05,4,52,0,0,19.125,-84.875,1,0,1
2012-05,4,68,0,0,19.125,-80.875,1,0,1
2012-05,5,49,0,0,19.375,-85.625,5,0,5
2012-05,6,48,0,0,19.625,-85.875,8,0,8
2012-05,7,47,0,0,19.875,-86.125,3,0,3
2012-05,7,48,0,0,19.875,-85.875,2,0,2
2012-05,8,16,0,0,20.125,-93.875,0,7,7
2012-05,8,17,0,0,20.125,-93.625,0,2,2
2012-05,8,47,0,0,20.125,-86.125,4,0,4
2012-05,9,17,0,0,20.375,-93.625,0,1,1
2012-05,9,18,0,0,20.375,-93.375,0,6,6
2012-05,9,19,0,0,20.375,-93.125,0,1,1
2012-05,9,47,0,0,20.375,-86.125,1,0,1
2012-05,10,8,0,0,20.625,-95.875,2,0,2
2012-05,10,15,0,0,20.625,-94.125,0,2,2
2012-05,10,16,0,0,20.625,-93.875,0,4,4
2012-05,10,17,0,0,20.625,-93.625,0,6,6
2012-05,10,18,0,0,20.625,-93.375,0,1,1
2012-05,11,8,0,0,20.875,-95.875,6,0,6
2012-05,11,55,0,0,20.875,-84.125,0,7,7
2012-05,11,56,0,0,20.875,-83.875,0,3,3
2012-05,12,8,0,0,21.125,-95.875,6,0,6
2012-05,12,54,0,0,21.125,-84.375,0,3,3
2012-05,12,55,0,0,21.125,-84.125,0,9,9
2012-05,12,56,0,0,21.125,-83.875,0,8,8
2012-05,13,8,0,0,21.375,-95.875,9,0,9
2012-05,14,8,0,0,21.625,-95.875,6,0,6
2012-05,14,9,0,0,21.625,-95.625,2,0,2
2012-05,16,1,1,1,22.125,-97.625,0,0,0
2012-05,18,39,0,0,22.625,-88.125,1,0,1
2012-05,20,16,0,0,23.125,-93.875,3,0,3
2012-05,21,10,0,0,23.375,-95.375,3,0,3
2012-05,21,11,0,0,23.375,-95.125,3,0,3
2012-05,21,13,0,0,23.375,-94.625,1,0,1
2012-05,21,14,0,0,23.375,-94.375,3,0,3
2012-05,21,15,0,0,23.375,-94.125,8,0,8
2012-05,21,53,0,0,23.375,-84.625,0,3,3
2012-05,21,54,0,0,23.375,-84.375,0,2,2
2012-05,22,12,0,0,23.625,-94.875,3,0,3
2012-05,22,13,0,0,23.625,-94.625,3,0,3
2012-05,22,14,0,0,23.625,-94.375,2,0,2
2012-05,22,57,0,0,23.625,-83.625,0,1,1
2012-05,22,58,0,0,23.625,-83.375,0,1,1
2012-05,22,59,0,0,23.625,-83.125,0,3,3
2012-05,22,60,0,0,23.625,-82.875,0,2,2
2012-05,23,21,0,0,23.875,-92.625,0,14,14
2012-05,23,22,0,0,23.875,-92.375,0,5,5
2012-05,23,23,0,0,23.875,-92.125,0,3,3
2012-05,23,24,0,0,23.875,-91.875,0,2,2
2012-05,23,41,0,0,23.875,-87.625,3,0,3
2012-05,23,52,0,0,23.875,-84.875,9,0,9
2012-05,23,60,0,0,23.875,-82.875,0,2,2
2012-05,23,61,0,0,23.875,-82.625,0,6,6
2012-05,23,62,0,0,23.875,-82.375,1,3,4
2012-05,23,63,0,0,23.875,-82.125,3,0,3
2012-05,23,65,0,0,23.875,-81.625,2,0,2
2012-05,23,66,0,0,23.875,-81.375,3,0,3
2012-05,23,67,0,0,23.875,-81.125,2,0,2
2012-05,23,68,0,0,23.875,-80.875,1,0,1
2012-05,24,24,0,0,24.125,-91.875,0,2,2
2012-05,24,25,0,0,24.125,-91.625,0,4,4
2012-05,24,26,0,0,24.125,-91.375,0,1,1
2012-05,24,52,0,0,24.125,-84.875,3,0,3
2012-05,24,69,0,0,24.125,-80.625,2,0,2
2012-05,24,70,0,0,24.125,-80.375,4,0,4
2012-05,25,52,0,0,24.375,-84.875,5,0,5
2012-05,25,70,0,0,24.375,-80.375,3,0,3
2012-05,25,71,0,0,24.375,-80.125,1,0,1
2012-05,26,52,0,0,24.625,-84.875,6,0,6
2012-05,26,53,0,0,24.625,-84.625,4,0,4
2012-05,27,11,0,0,24.875,-95.125,0,1,1
2012-05,27,53,0,0,24.875,-84.625,4,0,4
2012-05,28,9,0,0,25.125,-95.625,0,1,1
2012-05,29,9,0,0,25.375,-95.625,0,1,1
2012-05,30,46,0,0,25.625,-86.375,0,17,17
2012-05,31,46,0,0,25.875,-86.375,0,13,13
2012-05,32,34,0,0,26.125,-89.375,10,0,10
2012-05,32,35,0,0,26.125,-89.125,5,0,5
2012-05,32,46,0,0,26.125,-86.375,0,1,1
2012-05,33,18,0,0,26.375,-93.375,13,0,13
2012-05,33,19,0,0,26.375,-93.125,9,0,9
2012-05,33,20,0,0,26.375,-92.875,9,0,9
2012-05,33,35,0,0,26.375,-89.125,2,0,2
2012-05,33,36,0,0,26.375,-88.875,7,0,7
2012-05,34,36,0,0,26.625,-88.875,1,0,1
2012-05,34,37,0,0,26.625,-88.625,6,0,6
2012-05,39,14,0,0,27.875,-94.375,0,1,1
2012-05,39,15,0,0,27.875,-94.125,0,1,1
2012-05,39,43,0,0,27.875,-87.125,3,0,3
2012-05,40,14,0,0,28.125,-94.375,0,2,2
2012-05,40,15,0,0,28.125,-94.125,0,1,1
2012-05,40,33,0,0,28.125,-89.625,0,1,1
2012-05,40,34,0,0,28.125,-89.375,0,2,2
2012-05,40,35,0,0,28.125,-89.125,0,6,6
2012-05,40,36,0,0,28.125,-88.875,0,19,19
2012-05,41,36,0,0,28.375,-88.875,0,3,3
2012-05,41,44,0,0,28.375,-86.875,1,0,1
2012-06,0,49,0,0,18.125,-85.625,0,4,4
2012-06,1,48,0,0,18.375,-85.875,0,2,2
2012-06,1,49,0,0,18.375,-85.625,0,4,4
2012-06,1,59,0,0,18.375,-83.125,2,0,2
2012-06,2,59,0,0,18.625,-83.125,2,0,2
2012-06,2,60,0,0,18.625,-82.875,3,0,3
2012-06,5,62,0,0,19.375,-82.375,0,4,4
2012-06,5,63,0,0,19.375,-82.125,0,5,5
2012-06,5,64,0,0,19.375,-81.875,0,4,4
2012-06,5,65,0,0,19.375,-81.625,0,2,2
2012-06,5,66,0,0,19.375,-81.375,0,1,1
2012-06,6,63,0,0,19.625,-82.125,0,5,5
2012-06,7,54,0,0,19.875,-84.375,4,0,4
2012-06,9,8,0,0,20.375,-95.875,6,0,6
2012-06,9,9,0,0,20.375,-95.625,2,0,2
2012-06,9,47,0,0,20.375,-86.125,1,0,1
2012-06,10,8,0,0,20.625,-95.875,2,0,2
2012-06,10,10,0,0,20.625,-95.375,1,0,1
2012-06,10,16,0,0,20.625,-93.875,0,3,3
2012-06,10,47,0,0,20.625,-86.125,1,0,1
2012-06,11,8,0,0,20.875,-95.875,2,0,2
2012-06,11,9,0,0,20.875,-95.625,8,0,8
2012-06,11,10,0,0,20.875,-95.375,6,0,6
2012-06,11,16,0,0,20.875,-93.875,0,5,5
2012-06,11,47,0,0,20.875,-86.125,2,0,2
2012-06,11,53,0,0,20.875,-84.625,0,3,3
2012-06,12,16,0,0,21.125,-93.875,0,4,4
2012-06,12,20,0,0,21.125,-92.875,1,0,1
2012-06,12,53,0,0,21.125,-84.625,0,5,5
2012-06,12,54,0,0,21.125,-84.375,0,11,11
2012-06,13,20,0,0,21.375,-92.875,3,0,3
2012-06,13,21,0,0,21.375,-92.625,5,0,5
2012-06,13,22,0,0,21.375,-92.375,1,0,1
2012-06,13,23,0,0,21.375,-92.125,4,0,4
2012-06,18,39,0,0,22.625,-88.125,5,0,5
2012-06,19,38,0,0,22.875,-88.375,6,0,6
2012-06,19,39,0,0,22.875,-88.125,12,0,12
2012-06,20,38,0,0,23.125,-88.375,4,0,4
2012-06,21,7,0,0,23.375,-96.125,3,0,3
2012-06,21,8,0,0,23.375,-95.875,12,0,12
2012-06,21,9,0,0,23.375,-95.625,7,0,7
2012-06,21,10,0,0,23.375,-95.375,4,0,4
2012-06,22,7,0,0,23.625,-96.125,1,0,1
2012-06,22,8,0,0,23.625,-95.875,1,0,1
2012-06,22,9,0,0,23.625,-95.625,1,0,1
2012-06,22,17,0,0,23.625,-93.625,0,7,7
2012-06,22,49,0,0,23.625,-85.625,5,0,5
2012-06,22,50,0,0,23.625,-85.375,3,0,3
2012-06,23,8,0,0,23.875,-95.875,1,0,1
2012-06,23,18,0,0,23.875,-93.375,0,6,6
2012-06,23,19,0,0,23.875,-93.125,0,8,8
2012-06,23,20,0,0,23.875,-92.875,0,7,7
2012-06,23,21,0,0,23.875,-92.625,0,2,2
2012-06,23,50,0,0,23.875,-85.375,4,0,4
2012-06,23,51,0,0,23.875,-85.125,6,0,6
2012-06,23,52,0,0,23.875,-84.875,12,0,12
2012-06,23,59,0,0,23.875,-83.125,0,1,1
2012-06,23,60,0,0,23.875,-82.875,0,4,4
2012-06,23,61,0,0,23.875,-82.625,0,1,1
2012-06,23,62,0,0,23.875,-82.375,0,6,6
2012-06,24,59,0,0,24.125,-83.125,0,1,1
2012-06,24,60,0,0,24.125,-82.875,0,1,1
2012-06,28,9,0,0,25.125,-95.625,0,1,1
2012-06,29,8,0,0,25.375,-95.875,0,8,8
2012-06,29,9,0,0,25.375,-95.625,0,11,11
2012-06,30,9,0,0,25.625,-95.625,0,8,8
2012-06,30,41,0,0,25.625,-87.625,0,5,5
2012-06,30,42,0,0,25.625,-87.375,0,5,5
2012-06,30,43,0,0,25.625,-87.125,0,2,2
2012-06,31,9,0,0,25.875,-95.625,0,1,1
2012-06,31,10,0,0,25.875,-95.375,0,1,1
2012-06,31,43,0,0,25.875,-87.125,0,2,2
2012-06,31,44,0,0,25.875,-86.875,0,5,5
2012-06,31,45,0,0,25.875,-86.625,0,11,11
2012-06,32,20,0,0,26.125,-92.875,3,0,3
2012-06,32,32,0,0,26.125,-89.875,9,0,9
2012-06,32,33,0,0,26.125,-89.625,7,0,7
2012-06,32,34,0,0,26.125,-89.375,2,0,2
2012-06,33,20,0,0,26.375,-92.875,27,0,27
2012-06,33,31,0,0,26.375,-90.125,5,0,5
2012-06,33,32,0,0,26.375,-89.875,1,0,1
2012-06,34,31,0,0,26.625,-90.125,5,0,5
2012-06,34,32,0,0,26.625,-89.875,1,0,1
2012-06,36,11,0,0,27.125,-95.125,0,1,1
2012-06,36,12,0,0,27.125,-94.875,0,2,2
2012-06,36,13,0,0,27.125,-94.625,0,5,5
2012-06,36,14,0,0,27.125,-94.375,0,1,1
2012-06,38,47,0,0,27.625,-86.125,1,0,1
2012-06,39,14,0,0,27.875,-94.375,0,8,8
2012-06,39,35,0,0,27.875,-89.125,0,2,2
2012-06,39,43,0,0,27.875,-87.125,2,0,2
2012-06,39,44,0,0,27.875,-86.875,1,0,1
2012-06,39,45,0,0,27.875,-86.625,5,0,5
2012-06,39,46,0,0,27.875,-86.375,14,0,14
2012-06,39,47,0,0,27.875,-86.125,2,0,2
2012-06,40,44,0,0,28.125,-86.875,1,0,1
2012-06,40,45,0,0,28.125,-86.625,4,0,4
2012-07,0,64,0,0,18.125,-81.875,1,0,1
2012-07,0,65,0,0,18.125,-81.625,2,0,2
2012-07,1,46,0,0,18.375,-86.375,0,1,1
2012-07,1,47,0,0,18.375,-86.125,0,1,1
2012-07,1,48,0,0,18.375,-85.875,0,3,3
2012-07,1,71,0,0,18.375,-80.125,0,5,5
2012-07,2,45,0,0,18.625,-86.625,0,2,2
2012-07,2,46,0,0,18.625,-86.375,0,5,5
2012-07,2,47,0,0,18.625,-86.125,0,2,2
2012-07,2,48,0,0,18.625,-85.875,0,1,1
2012-07,2,70,0,0,18.625,-80.375,0,3,3
2012-07,3,45,0,0,18.875,-86.625,0,3,3
2012-07,3,46,0,0,18.875,-86.375,0,1,1
2012-07,5,62,0,0,19.375,-82.375,0,1,1
2012-07,6,52,0,0,19.625,-84.875,1,0,1
2012-07,6,53,0,0,19.625,-84.625,4,0,4
2012-07,6,54,0,0,19.625,-84.375,1,0,1
2012-07,6,61,0,0,19.625,-82.625,0,2,2
2012-07,6,62,0,0,19.625,-82.375,0,4,4
2012-07,7,45,0,0,19.875,-86.625,0,1,1
2012-07,7,52,0,0,19.875,-84.875,3,0,3
2012-07,7,53,0,0,19.875,-84.625,6,0,6
2012-07,7,55,0,0,19.875,-84.125,0,4,4
2012-07,7,56,0,0,19.875,-83.875,0,5,5
2012-07,7,60,0,0,19.875,-82.875,0,3,3
2012-07,7,61,0,0,19.875,-82.625,0,1,1
2012-07,8,52,0,0,20.125,-84.875,5,0,5
2012-07,8,57,0,0,20.125,-83.625,0,4,4
2012-07,8,58,0,0,20.125,-83.375,0,4,4
2012-07,8,59,0,0,20.125,-83.125,0,3,3
2012-07,9,51,0,0,20.375,-85.125,2,0,2
2012-07,9,52,0,0,20.375,-84.875,3,0,3
2012-07,10,51,0,0,20.625,-85.125,2,0,2
2012-07,11,6,0,0,20.875,-96.375,3,0,3
2012-07,11,7,0,0,20.875,-96.125,4,0,4
2012-07,11,8,0,0,20.875,-95.875,4,0,4
2012-07,11,65,0,0,20.875,-81.625,3,0,3
2012-07,12,17,0,0,21.125,-93.625,5,0,5
2012-07,12,18,0,0,21.125,-93.375,7,0,7
2012-07,12,19,0,0,21.125,-93.125,4,0,4
2012-07,12,20,0,0,21.125,-92.875,1,0,1
2012-07,12,64,0,0,21.125,-81.875,3,0,3
2012-07,12,65,0,0,21.125,-81.625,1,0,1
2012-07,13,15,0,0,21.375,-94.125,6,0,6
2012-07,13,16,0,0,21.375,-93.875,5,0,5
2012-07,13,17,0,0,21.375,-93.625,3,0,3
2012-07,13,63,0,0,21.375,-82.125,1,0,1
2012-07,13,64,0,0,21.375,-81.875,3,0,3
2012-07,14,62,0,0,21.625,-82.375,1,0,1
2012-07,19,10,0,0,22.875,-95.375,0,4,4
2012-07,19,11,0,0,22.875,-95.125,0,4,4
2012-07,19,12,0,0,22.875,-94.875,0,2,2
2012-07,20,12,0,0,23.125,-94.875,0,3,3
2012-07,20,13,0,0,23.125,-94.625,0,4,4
2012-07,20,14,0,0,23.125,-94.375,0,1,1
2012-07,21,14,0,0,23.375,-94.375,0,4,4
2012-07,21,15,0,0,23.375,-94.125,0,4,4
2012-07,21,16,0,0,23.375,-93.875,0,1,1
2012-07,21,24,0,0,23.375,-91.875,1,0,1
2012-07,21,25,0,0,23.375,-91.625,5,0,5
2012-07,21,26,0,0,23.375,-91.375,4,0,4
2012-07,21,49,0,0,23.375,-85.625,13,0,13
2012-07,22,16,0,0,23.625,-93.875,0,4,4
2012-07,22,27,0,0,23.625,-91.125,4,0,4
2012-07,22,49,0,0,23.625,-85.625,9,0,9
2012-07,22,58,0,0,23.625,-83.375,0,4,4
2012-07,23,8,0,0,23.875,-95.875,5,0,5
2012-07,23,49,0,0,23.875,-85.625,2,0,2
2012-07,23,57,0,0,23.875,-83.625,0,3,3
2012-07,23,58,0,0,23.875,-83.375,0,15,15
2012-07,23,59,0,0,23.875,-83.125,0,6,6
2012-07,24,8,0,0,24.125,-95.875,4,0,4
2012-07,24,48,0,0,24.125,-85.875,3,0,3
2012-07,24,49,0,0,24.125,-85.625,4,0,4
2012-07,24,58,0,0,24.125,-83.375,0,3,3
2012-07,25,8,0,0,24.375,-95.875,4,0,4
2012-07,25,9,0,0,24.375,-95.625,3,0,3
2012-07,26,9,0,0,24.625,-95.625,8,0,8
2012-07,30,37,0,0,25.625,-88.625,0,1,1
2012-07,30,38,0,0,25.625,-88.375,0,10,10
2012-07,30,39,0,0,25.625,-88.125,0,10,10
2012-07,30,40,0,0,25.625,-87.875,0,5,5
2012-07,30,41,0,0,25.625,-87.625,0,5,5
2012-07,31,9,0,0,25.875,-95.625,0,4,4
2012-07,31,10,0,0,25.875,-95.375,0,1,1
2012-07,32,9,0,0,26.125,-95.625,0,14,14
2012-07,32,10,0,0,26.125,-95.375,0,10,10
2012-07,32,20,0,0,26.125,-92.875,25,0,25
2012-07,32,21,0,0,26.125,-92.625,6,0,6
2012-07,32,47,0,0,26.125,-86.125,0,1,1
2012-07,33,10,0,0,26.375,-95.375,0,2,2
2012-07,33,29,0,0,26.375,-90.625,4,0,4
2012-07,33,32,0,0,26.375,-89.875,2,0,2
2012-07,33,49,0,0,26.375,-85.625,0,2,2
2012-07,33,50,0,0,26.375,-85.375,0,2,2
2012-07,34,29,0,0,26.625,-90.625,1,0,1
2012-07,34,31,0,0,26.625,-90.125,4,0,4
2012-07,34,32,0,0,26.625,-89.875,9,0,9
2012-07,34,51,0,0,26.625,-85.125,0,9,9
2012-07,35,30,0,0,26.875,-90.375,2,0,2
2012-07,35,31,0,0,26.875,-90.125,5,0,5
2012-07,35,51,0,0,26.875,-85.125,0,2,2
2012-07,36,51,0,0,27.125,-85.125,0,2,2
2012-07,37,52,0,0,27.375,-84.875,0,1,1
2012-07,38,45,0,0,27.625,-86.625,2,0,2
2012-07,38,46,0,0,27.625,-86.375,5,0,5
2012-07,39,45,0,0,27.875,-86.625,2,0,2
2012-07,39,46,0,0,27.875,-86.375,22,0,22
2012-08,0,44,0,0,18.125,-86.875,1,0,1
2012-08,0,45,0,0,18.125,-86.625,3,0,3
2012-08,0,46,0,0,18.125,-86.375,5,0,5
2012-08,0,47,0,0,18.125,-86.125,4,0,4
2012-08,0,68,0,0,18.125,-80.875,0,3,3
2012-08,0,69,0,0,18.125,-80.625,0,5,5
2012-08,0,70,0,0,18.125,-80.375,0,5,5
2012-08,0,71,0,0,18.125,-80.125,0,3,3
2012-08,1,44,0,0,18.375,-86.875,4,0,4
2012-08,1,45,0,0,18.375,-86.625,13,0,13
2012-08,1,68,0,0,18.375,-80.875,0,1,1
2012-08,1,70,0,0,18.375,-80.375,0,1,1
2012-08,1,71,0,0,18.375,-80.125,0,2,2
2012-08,2,71,0,0,18.625,-80.125,2,0,2
2012-08,8,53,0,0,20.125,-84.625,0,3,3
2012-08,8,54,0,0,20.125,-84.375,0,16,16
2012-08,8,55,0,0,20.125,-84.125,0,1,1
2012-08,9,53,0,0,20.375,-84.625,0,1,1
2012-08,9,54,0,0,20.375,-84.375,0,10,10
2012-08,9,61,0,0,20.375,-82.625,5,0,5
2012-08,10,15,0,0,20.625,-94.125,2,0,2
2012-08,10,61,0,0,20.625,-82.625,8,0,8
2012-08,10,62,0,0,20.625,-82.375,4,0,4
2012-08,11,13,0,0,20.875,-94.625,8,0,8
2012-08,11,14,0,0,20.875,-94.375,8,0,8
2012-08,11,15,0,0,20.875,-94.125,9,0,9
2012-08,11,63,0,0,20.875,-82.125,1,0,1
2012-08,11,64,0,0,20.875,-81.875,3,0,3
2012-08,11,65,0,0,20.875,-81.625,5,0,5
2012-08,12,14,0,0,21.125,-94.375,3,0,3
2012-08,12,15,0,0,21.125,-94.125,1,0,1
2012-08,12,66,0,0,21.125,-81.375,4,0,4
2012-08,19,8,0,0,22.875,-95.875,0,8,8
2012-08,19,9,0,0,22.875,-95.625,0,6,6
2012-08,19,10,0,0,22.875,-95.375,0,1,1
2012-08,20,7,0,0,23.125,-96.125,0,7,7
2012-08,20,8,0,0,23.125,-95.875,0,1,1
2012-08,21,6,0,0,23.375,-96.375,0,3,3
2012-08,21,7,0,0,23.375,-96.125,0,5,5
2012-08,21,21,0,0,23.375,-92.625,3,0,3
2012-08,21,22,0,0,23.375,-92.375,1,0,1
2012-08,21,23,0,0,23.375,-92.125,6,0,6
2012-08,21,24,0,0,23.375,-91.875,4,0,4
2012-08,22,20,0,0,23.625,-92.875,10,0,10
2012-08,22,21,0,0,23.625,-92.625,7,0,7
2012-08,22,59,0,0,23.625,-83.125,0,5,5
2012-08,23,48,0,0,23.875,-85.875,6,0,6
2012-08,23,49,0,0,23.875,-85.625,11,0,11
2012-08,23,58,0,0,23.875,-83.375,0,3,3
2012-08,23,59,0,0,23.875,-83.125,0,9,9
2012-08,23,60,0,0,23.875,-82.875,0,8,8
2012-08,24,48,0,0,24.125,-85.875,10,0,10
2012-08,24,49,0,0,24.125,-85.625,4,0,4
2012-08,24,58,0,0,24.125,-83.375,0,2,2
2012-08,24,59,0,0,24.125,-83.125,0,1,1
2012-08,25,59,0,0,24.375,-83.125,0,1,1
2012-08,30,36,0,0,25.625,-88.875,0,3,3
2012-08,30,37,0,0,25.625,-88.625,0,10,10
2012-08,31,8,0,0,25.875,-95.875,0,1,1
2012-08,31,9,0,0,25.875,-95.625,0,1,1
2012-08,31,35,0,0,25.875,-89.125,0,1,1
2012-08,31,36,0,0,25.875,-88.875,0,11,11
2012-08,32,8,0,0,26.125,-95.875,0,1,1
2012-08,32,9,0,0,26.125,-95.625,0,2,2
2012-08,32,17,0,0,26.125,-93.625,2,0,2
2012-08,32,18,0,0,26.125,-93.375,5,0,5
2012-08,32,19,0,0,26.125,-93.125,7,0,7
2012-08,32,20,0,0,26.125,-92.875,6,0,6
2012-08,32,21,0,0,26.125,-92.625,11,0,11
2012-08,32,35,0,0,26.125,-89.125,0,4,4
2012-08,32,36,0,0,26.125,-88.875,0,2,2
2012-08,33,8,0,0,26.375,-95.875,0,3,3
2012-08,34,8,0,0,26.625,-95.875,0,2,2
2012-08,34,43,0,0,26.625,-87.125,5,0,5
2012-08,34,44,0,0,26.625,-86.875,2,0,2
2012-08,35,43,0,0,26.875,-87.125,11,0,11
2012-08,36,7,0,0,27.125,-96.125,0,9,9
2012-08,36,8,0,0,27.125,-95.875,0,2,2
2012-08,36,44,0,0,27.125,-86.875,2,0,2
2012-08,37,7,0,0,27.375,-96.125,0,8,8
2012-08,37,44,0,0,27.375,-86.875,1,0,1
2012-08,37,45,0,0,27.375,-86.625,1,0,1
2012-08,37,51,0,0,27.375,-85.125,0,1,1
2012-08,38,45,0,0,27.625,-86.625,5,0,5
2012-08,38,51,0,0,27.625,-85.125,0,6,6
2012-08,38,52,0,0,27.625,-84.875,0,2,2
2012-08,39,49,0,0,27.875,-85.625,0,3,3
2012-08,39,50,0,0,27.875,-85.375,0,1,1
2012-08,39,51,0,0,27.875,-85.125,0,2,2
2012-08,39,53,0,0,27.875,-84.625,0,1,1
2012-08,40,49,0,0,28.125,-85.625,0,1,1
2012-08,40,53,0,0,28.125,-84.625,0,1,1
2012-08,40,54,0,0,28.125,-84.375,0,3,3
2012-08,41,54,0,0,28.375,-84.375,0,3,3
2012-08,41,55,0,0,28.375,-84.125,0,1,1
2012-09,1,44,0,0,18.375,-86.875,1,0,1
2012-09,1,45,0,0,18.375,-86.625,1,0,1
2012-09,2,70,0,0,18.625,-80.375,2,0,2
2012-09,2,71,0,0,18.625,-80.125,4,0,4
2012-09,3,69,0,0,18.875,-80.625,1,0,1
2012-09,3,70,0,0,18.875,-80.375,5,0,5
2012-09,4,69,0,0,19.125,-80.625,8,0,8
2012-09,4,70,0,0,19.125,-80.375,2,0,2
2012-09,4,71,0,0,19.125,-80.125,6,0,6
2012-09,8,51,0,0,20.125,-85.125,0,1,1
2012-09,8,52,0,0,20.125,-84.875,0,1,1
2012-09,8,53,0,0,20.125,-84.625,0,2,2
2012-09,8,57,0,0,20.125,-83.625,3,0,3
2012-09,8,58,0,0,20.125,-83.375,4,0,4
2012-09,9,48,0,0,20.375,-85.875,0,5,5
2012-09,9,49,0,0,20.375,-85.625,0,3,3
2012-09,9,50,0,0,20.375,-85.375,0,10,10
2012-09,9,51,0,0,20.375,-85.125,0,8,8
2012-09,9,58,0,0,20.375,-83.375,1,0,1
2012-09,9,59,0,0,20.375,-83.125,4,0,4
2012-09,9,60,0,0,20.375,-82.875,4,0,4
2012-09,9,64,0,0,20.375,-81.875,0,3,3
2012-09,10,60,0,0,20.625,-82.875,3,0,3
2012-09,10,63,0,0,20.625,-82.125,0,4,4
2012-09,10,64,0,0,20.625,-81.875,0,1,1
2012-09,11,12,0,0,20.875,-94.875,8,0,8
2012-09,11,13,0,0,20.875,-94.625,2,0,2
2012-09,11,61,0,0,20.875,-82.625,0,5,5
2012-09,11,62,0,0,20.875,-82.375,0,1,1
2012-09,12,61,0,0,21.125,-82.625,0,3,3
2012-09,18,30,0,0,22.625,-90.375,1,0,1
2012-09,19,29,0,0,22.875,-90.625,1,0,1
2012-09,19,30,0,0,22.875,-90.375,8,0,8
2012-09,20,29,0,0,23.125,-90.625,1,0,1
2012-09,21,6,0,0,23.375,-96.375,0,10,10
2012-09,21,19,0,0,23.375,-93.125,5,0,5
2012-09,21,29,0,0,23.375,-90.625,1,0,1
2012-09,22,6,0,0,23.625,-96.375,0,3,3
2012-09,22,7,0,0,23.625,-96.125,0,1,1
2012-09,22,19,0,0,23.625,-93.125,2,0,2
2012-09,22,20,0,0,23.625,-92.875,3,0,3
2012-09,22,28,0,0,23.625,-90.875,3,0,3
2012-09,22,58,0,0,23.625,-83.375,0,3,3
2012-09,22,59,0,0,23.625,-83.125,0,8,8
2012-09,23,7,0,0,23.875,-96.125,0,2,2
2012-09,23,27,0,0,23.875,-91.125,2,0,2
2012-09,23,48,0,0,23.875,-85.875,5,0,5
2012-09,23,49,0,0,23.875,-85.625,5,0,5
2012-09,23,58,0,0,23.875,-83.375,0,1,1
2012-09,23,59,0,0,23.875,-83.125,0,14,14
2012-09,23,60,0,0,23.875,-82.875,0,2,2
2012-09,24,8,0,0,24.125,-95.875,0,1,1
2012-09,24,9,0,0,24.125,-95.625,0,9,9
2012-09,24,10,0,0,24.125,-95.375,0,1,1
2012-09,24,27,0,0,24.125,-91.125,4,0,4
2012-09,24,48,0,0,24.125,-85.875,4,0,4
2012-09,25,10,0,0,24.375,-95.375,0,3,3
2012-09,25,27,0,0,24.375,-91.125,2,0,2
2012-09,25,48,0,0,24.375,-85.875,16,0,16
2012-09,26,37,0,0,24.625,-88.625,0,4,4
2012-09,27,37,0,0,24.875,-88.625,0,15,15
2012-09,28,37,0,0,25.125,-88.625,0,6,6
2012-09,29,36,0,0,25.375,-88.875,0,2,2
2012-09,30,36,0,0,25.625,-88.875,0,3,3
2012-09,31,15,0,0,25.875,-94.125,15,0,15
2012-09,31,16,0,0,25.875,-93.875,11,0,11
2012-09,31,17,0,0,25.875,-93.625,2,0,2
2012-09,31,44,0,0,25.875,-86.875,1,0,1
2012-09,32,16,0,0,26.125,-93.875,1,0,1
2012-09,32,17,0,0,26.125,-93.625,1,0,1
2012-09,32,44,0,0,26.125,-86.875,5,0,5
2012-09,33,44,0,0,26.375,-86.875,4,0,4
2012-09,34,5,0,0,26.625,-96.625,0,2,2
2012-09,34,27,0,0,26.625,-91.125,0,10,10
2012-09,35,5,0,0,26.875,-96.625,0,6,6
2012-09,35,6,0,0,26.875,-96.375,0,3,3
2012-09,35,27,0,0,26.875,-91.125,0,2,2
2012-09,35,28,0,0,26.875,-90.875,0,5,5
2012-09,35,29,0,0,26.875,-90.625,0,4,4
2012-09,36,6,0,0,27.125,-96.375,0,1,1
2012-09,36,7,0,0,27.125,-96.125,0,7,7
2012-09,38,49,0,0,27.625,-85.625,0,1,1
2012-09,39,47,0,0,27.875,-86.125,0,2,2
2012-09,39,48,0,0,27.875,-85.875,0,2,2
2012-09,39,49,0,0,27.875,-85.625,0,3,3
2012-09,39,50,0,0,27.875,-85.375,0,8,8
2012-09,40,47,0,0,28.125,-86.125,0,10,10
2012-09,40,49,0,0,28.125,-85.625,0,1,1
2012-10,0,50,0,0,18.125,-85.375,0,2,2
2012-10,0,51,0,0,18.125,-85.125,0,1,1
2012-10,0,69,0,0,18.125,-80.625,1,0,1
2012-10,0,70,0,0,18.125,-80.375,3,0,3
2012-10,0,71,0,0,18.125,-80.125,1,0,1
2012-10,1,52,0,0,18.375,-84.875,0,1,1
2012-10,1,62,0,0,18.375,-82.375,1,0,1
2012-10,2,60,0,0,18.625,-82.875,1,0,1
2012-10,2,61,0,0,18.625,-82.625,4,0,4
2012-10,2,62,0,0,18.625,-82.375,1,0,1
2012-10,3,60,0,0,18.875,-82.875,1,0,1
2012-10,6,50,0,0,19.625,-85.375,1,0,1
2012-10,7,46,0,0,19.875,-86.375,2,0,2
2012-10,7,49,0,0,19.875,-85.625,3,0,3
2012-10,7,50,0,0,19.875,-85.375,5,0,5
2012-10,8,48,0,0,20.125,-85.875,5,0,5
2012-10,8,49,0,0,20.125,-85.625,2,0,2
2012-10,9,9,0,0,20.375,-95.625,3,0,3
2012-10,9,10,0,0,20.375,-95.375,9,0,9
2012-10,9,11,0,0,20.375,-95.125,3,0,3
2012-10,9,46,0,0,20.375,-86.375,0,3,3
2012-10,9,47,0,0,20.375,-86.125,0,5,5
2012-10,10,9,0,0,20.625,-95.625,9,0,9
2012-10,11,47,0,0,20.875,-86.125,0,1,1
2012-10,11,61,0,0,20.875,-82.625,0,5,5
2012-10,11,62,0,0,20.875,-82.375,0,1,1
2012-10,12,47,0,0,21.125,-86.125,0,1,1
2012-10,12,61,0,0,21.125,-82.625,0,5,5
2012-10,18,12,0,0,22.625,-94.875,2,0,2
2012-10,18,13,0,0,22.625,-94.625,1,0,1
2012-10,18,18,0,0,22.625,-93.375,0,2,2
2012-10,19,11,0,0,22.875,-95.125,4,0,4
2012-10,19,12,0,0,22.875,-94.875,2,0,2
2012-10,20,9,0,0,23.125,-95.625,1,0,1
2012-10,20,10,0,0,23.125,-95.375,4,0,4
2012-10,20,18,0,0,23.125,-93.375,0,6,6
2012-10,20,19,0,0,23.125,-93.125,0,1,1
2012-10,21,8,0,0,23.375,-95.875,4,0,4
2012-10,21,9,0,0,23.375,-95.625,5,0,5
2012-10,21,18,0,0,23.375,-93.375,0,5,5
2012-10,22,8,0,0,23.625,-95.875,1,0,1
2012-10,22,17,0,0,23.625,-93.625,0,4,4
2012-10,22,57,0,0,23.625,-83.625,0,7,7
2012-10,22,58,0,0,23.625,-83.375,0,1,1
2012-10,23,16,0,0,23.875,-93.875,0,5,5
2012-10,23,57,0,0,23.875,-83.625,0,5,5
2012-10,23,58,0,0,23.875,-83.375,0,1,1
2012-10,24,48,0,0,24.125,-85.875,5,0,5
2012-10,24,58,0,0,24.125,-83.375,0,6,6
2012-10,25,10,0,0,24.375,-95.375,0,7,7
2012-10,25,11,0,0,24.375,-95.125,0,1,1
2012-10,25,26,0,0,24.375,-91.375,3,0,3
2012-10,25,27,0,0,24.375,-91.125,9,0,9
2012-10,25,35,0,0,24.375,-89.125,0,5,5
2012-10,25,36,0,0,24.375,-88.875,0,13,13
2012-10,25,37,0,0,24.375,-88.625,0,6,6
2012-10,25,48,0,0,24.375,-85.875,4,0,4
2012-10,25,58,0,0,24.375,-83.375,0,3,3
2012-10,26,37,0,0,24.625,-88.625,0,7,7
2012-10,26,46,0,0,24.625,-86.375,4,0,4
2012-10,26,47,0,0,24.625,-86.125,9,0,9
2012-10,26,58,0,0,24.625,-83.375,0,2,2
2012-10,27,46,0,0,24.875,-86.375,7,0,7
2012-10,27,47,0,0,24.875,-86.125,2,0,2
2012-10,30,17,0,0,25.625,-93.625,23,0,23
2012-10,31,17,0,0,25.875,-93.625,8,0,8
2012-10,34,26,0,0,26.625,-91.375,0,29,29
2012-10,34,27,0,0,26.625,-91.125,0,2,2
2012-10,38,5,1,1,27.625,-96.625,0,0,0
2012-10,38,7,2,1,27.625,-96.125,0,0,0
2012-10,38,54,0,0,27.625,-84.375,0,1,1
2012-10,39,37,2,2,27.875,-88.625,0,0,0
2012-10,39,45,0,0,27.875,-86.625,0,2,2
2012-10,39,46,0,0,27.875,-86.375,0,5,5
2012-10,39,47,0,0,27.875,-86.125,0,3,3
2012-10,39,48,0,0,27.875,-85.875,0,1,1
2012-10,39,52,0,0,27.875,-84.875,0,1,1
2012-10,39,53,0,0,27.875,-84.625,0,3,3
2012-10,40,43,0,0,28.125,-87.125,0,12,12
2012-10,40,44,0,0,28.125,-86.875,0,4,4
2012-10,40,45,0,0,28.125,-86.625,0,1,1
2012-10,40,47,0,0,28.125,-86.125,0,1,1
2012-10,40,52,0,0,28.125,-84.875,0,1,1
2012-11,0,49,0,0,18.125,-85.625,0,2,2
2012-11,0,50,0,0,18.125,-85.375,0,3,3
2012-11,0,70,0,0,18.125,-80.375,3,0,3
2012-11,0,71,0,0,18.125,-80.125,3,0,3
2012-11,1,49,0,0,18.375,-85.625,0,2,2
2012-11,1,58,0,0,18.375,-83.375,1,0,1
2012-11,1,69,0,0,18.375,-80.625,6,0,6
2012-11,2,49,0,0,18.625,-85.625,0,2,2
2012-11,3,49,0,0,18.875,-85.625,0,4,4
2012-11,3,50,0,0,18.875,-85.375,1,0,1
2012-11,3,51,0,0,18.875,-85.125,2,0,2
2012-11,3,52,0,0,18.875,-84.875,1,0,1
2012-11,3,53,0,0,18.875,-84.625,2,0,2
2012-11,3,54,0,0,18.875,-84.375,1,0,1
2012-11,3,60,0,0,18.875,-82.875,3,0,3
2012-11,4,54,0,0,19.125,-84.375,1,0,1
2012-11,4,55,0,0,19.125,-84.125,2,0,2
2012-11,4,56,0,0,19.125,-83.875,3,0,3
2012-11,4,57,0,0,19.125,-83.625,3,0,3
2012-11,4,58,0,0,19.125,-83.375,3,0,3
2012-11,4,59,0,0,19.125,-83.125,3,0,3
2012-11,4,60,0,0,19.125,-82.875,2,0,2
2012-11,4,61,0,0,19.125,-82.625,1,0,1
2012-11,5,61,0,0,19.375,-82.625,1,0,1
2012-11,7,46,0,0,19.875,-86.375,4,0,4
2012-11,7,63,0,0,19.875,-82.125,0,1,1
2012-11,8,63,0,0,20.125,-82.125,0,2,2
2012-11,9,8,0,0,20.375,-95.875,16,0,16
2012-11,9,9,0,0,20.375,-95.625,5,0,5
2012-11,10,8,0,0,20.625,-95.875,2,0,2
2012-11,10,9,0,0,20.625,-95.625,7,0,7
2012-11,18,15,0,0,22.625,-94.125,0,14,14
2012-11,18,16,0,0,22.625,-93.875,0,9,9
2012-11,18,17,0,0,22.625,-93.625,0,7,7
2012-11,20,41,0,0,23.125,-87.625,0,1,1
2012-11,21,40,0,0,23.375,-87.875,0,2,2
2012-11,21,41,0,0,23.375,-87.625,0,7,7
2012-11,22,7,0,0,23.625,-96.125,8,0,8
2012-11,22,8,0,0,23.625,-95.875,6,0,6
2012-11,22,40,0,0,23.625,-87.875,0,10,10
2012-11,23,7,0,0,23.875,-96.125,10,0,10
2012-11,23,8,0,0,23.875,-95.875,2,0,2
2012-11,23,39,0,0,23.875,-88.125,0,1,1
2012-11,23,40,0,0,23.875,-87.875,0,2,2
2012-11,24,7,0,0,24.125,-96.125,1,0,1
2012-11,24,8,0,0,24.125,-95.875,1,0,1
2012-11,24,56,1,1,24.125,-83.875,0,0,0
2012-11,24,57,0,0,24.125,-83.625,0,8,8
2012-11,25,33,0,0,24.375,-89.625,0,1,1
2012-11,25,34,0,0,24.375,-89.375,0,6,6
2012-11,25,57,0,0,24.375,-83.625,0,3,3
2012-11,25,58,0,0,24.375,-83.375,0,3,3
2012-11,26,57,0,0,24.625,-83.625,0,3,3
2012-11,26,58,0,0,24.625,-83.375,0,8,8
2012-11,26,59,0,0,24.625,-83.125,0,1,1
2012-11,27,45,0,0,24.875,-86.625,1,0,1
2012-11,27,46,0,0,24.875,-86.375,2,0,2
2012-11,27,58,0,0,24.875,-83.375,0,4,4
2012-11,28,45,0,0,25.125,-86.625,7,0,7
2012-11,29,14,0,0,25.375,-94.375,3,0,3
2012-11,29,15,0,0,25.375,-94.125,5,0,5
2012-11,29,16,0,0,25.375,-93.875,6,0,6
2012-11,29,44,0,0,25.375,-86.875,9,0,9
2012-11,29,45,0,0,25.375,-86.625,6,0,6
2012-11,30,14,0,0,25.625,-94.375,3,0,3
2012-11,30,15,0,0,25.625,-94.125,1,0,1
2012-11,30,16,0,0,25.625,-93.875,6,0,6
2012-11,30,17,0,0,25.625,-93.625,6,0,6
2012-11,30,26,0,0,25.625,-91.375,0,2,2
2012-11,30,27,0,0,25.625,-91.125,0,3,3
2012-11,30,43,0,0,25.625,-87.125,2,0,2
2012-11,30,44,0,0,25.625,-86.875,3,0,3
2012-11,31,24,0,0,25.875,-91.875,0,1,1
2012-11,31,25,0,0,25.875,-91.625,0,8,8
2012-11,31,26,0,0,25.875,-91.375,0,3,3
2012-11,32,24,0,0,26.125,-91.875,0,3,3
2012-11,34,25,0,0,26.625,-91.625,0,3,3
2012-11,34,26,0,0,26.625,-91.375,0,7,7
2012-11,37,3,1,1,27.375,-97.125,0,0,0
2012-11,37,5,1,1,27.375,-96.625,0,0,0
2012-11,38,5,1,1,27.625,-96.625,0,0,0
2012-11,39,12,2,1,27.875,-94.875,0,0,0
2012-11,39,43,0,0,27.875,-87.125,0,2,2
2012-11,39,44,0,0,27.875,-86.875,0,8,8
2012-11,39,53,0,0,27.875,-84.625,0,7,7
2012-11,39,54,0,0,27.875,-84.375,0,8,8
2012-11,40,41,0,0,28.125,-87.625,0,4,4
2012-11,40,42,0,0,28.125,-87.375,0,6,6
2012-11,40,44,0,0,28.125,-86.875,0,2,2
2012-11,40,52,0,0,28.125,-84.875,0,3,3
2012-11,40,53,0,0,28.125,-84.625,0,4,4
2012-11,40,54,0,0,28.125,-84.375,0,1,1
2012-11,41,40,0,0,28.375,-87.875,0,3,3
2012-11,41,41,0,0,28.375,-87.625,0,5,5
2012-11,41,51,0,0,28.375,-85.125,0,1,1
2012-11,41,52,0,0,28.375,-84.875,0,2,2
2012-11,41,53,0,0,28.375,-84.625,0,1,1
2012-11,41,54,0,0,28.375,-84.375,0,3,3
2012-12,1,68,0,0,18.375,-80.875,2,0,2
2012-12,1,69,0,0,18.375,-80.625,6,0,6
2012-12,1,70,0,0,18.375,-80.375,3,0,3
2012-12,2,67,0,0,18.625,-81.125,3,0,3
2012-12,2,68,0,0,18.625,-80.875,9,0,9
2012-12,3,50,0,0,18.875,-85.375,2,0,2
2012-12,3,63,0,0,18.875,-82.125,2,0,2
2012-12,3,64,0,0,18.875,-81.875,3,0,3
2012-12,3,65,0,0,18.875,-81.625,1,0,1
2012-12,3,66,0,0,18.875,-81.375,2,0,2
2012-12,4,49,0,0,19.125,-85.625,3,0,3
2012-12,4,50,0,0,19.125,-85.375,2,0,2
2012-12,5,49,0,0,19.375,-85.625,1,0,1
2012-12,5,50,0,0,19.375,-85.375,2,0,2
2012-12,6,50,0,0,19.625,-85.375,4,0,4
2012-12,7,62,0,0,19.875,-82.375,0,1,1
2012-12,8,50,0,0,20.125,-85.375,1,0,1
2012-12,8,51,0,0,20.125,-85.125,6,0,6
2012-12,8,52,0,0,20.125,-84.875,3,0,3
2012-12,8,63,0,0,20.125,-82.125,0,4,4
2012-12,9,9,0,0,20.375,-95.625,20,0,20
2012-12,9,10,0,0,20.375,-95.375,4,0,4
2012-12,9,11,0,0,20.375,-95.125,7,0,7
2012-12,9,50,0,0,20.375,-85.375,3,0,3
2012-12,9,63,0,0,20.375,-82.125,0,1,1
2012-12,9,64,0,0,20.375,-81.875,0,1,1
2012-12,10,48,0,0,20.625,-85.875,1,0,1
2012-12,10,49,0,0,20.625,-85.625,1,0,1
2012-12,10,50,0,0,20.625,-85.375,2,0,2
2012-12,12,64,0,0,21.125,-81.875,0,2,2
2012-12,12,65,0,0,21.125,-81.625,0,8,8
2012-12,12,66,0,0,21.125,-81.375,0,1,1
2012-12,13,63,0,0,21.375,-82.125,0,2,2
2012-12,13,64,0,0,21.375,-81.875,0,7,7
2012-12,17,14,0,0,22.375,-94.375,0,27,27
2012-12,17,15,0,0,22.375,-94.125,0,1,1
2012-12,18,15,0,0,22.625,-94.125,0,3,3
2012-12,19,42,0,0,22.875,-87.375,0,5,5
2012-12,20,41,0,0,23.125,-87.625,0,7,7
2012-12,21,41,0,0,23.375,-87.625,0,2,2
2012-12,21,49,1,1,23.375,-85.625,0,0,0
2012-12,22,48,0,0,23.625,-85.875,0,1,1
2012-12,22,49,0,0,23.625,-85.625,0,6,6
2012-12,23,48,0,0,23.875,-85.875,0,2,2
2012-12,23,49,0,0,23.875,-85.625,0,2,2
2012-12,23,51,0,0,23.875,-85.125,0,4,4
2012-12,23,61,0,0,23.875,-82.625,0,2,2
2012-12,23,62,0,0,23.875,-82.375,0,3,3
2012-12,24,49,0,0,24.125,-85.625,0,1,1
2012-12,24,50,0,0,24.125,-85.375,0,13,13
2012-12,26,59,0,0,24.625,-83.125,0,1,1
2012-12,27,11,0,0,24.875,-95.125,2,0,2
2012-12,27,12,0,0,24.875,-94.875,4,0,4
2012-12,27,30,0,0,24.875,-90.375,9,0,9
2012-12,28,12,0,0,25.125,-94.875,7,0,7
2012-12,28,13,0,0,25.125,-94.625,4,0,4
2012-12,29,13,0,0,25.375,-94.625,7,0,7
2012-12,29,14,0,0,25.375,-94.375,7,0,7
2012-12,29,21,0,0,25.375,-92.625,0,1,1
2012-12,29,22,0,0,25.375,-92.375,0,3,3
2012-12,30,8,1,1,25.625,-95.875,0,0,0
2012-12,30,22,0,0,25.625,-92.375,0,6,6
2012-12,30,23,0,0,25.625,-92.125,0,6,6
2012-12,31,8,2,1,25.875,-95.875,0,0,0
2012-12,31,9,2,1,25.875,-95.625,0,0,0
2012-12,31,23,0,0,25.875,-92.125,0,4,4
2012-12,31,24,0,0,25.875,-91.875,0,10,10
2012-12,31,40,0,0,25.875,-87.875,1,0,1
2012-12,31,41,0,0,25.875,-87.625,8,0,8
2012-12,31,42,0,0,25.875,-87.375,3,0,3
2012-12,32,10,1,1,26.125,-95.375,0,0,0
2012-12,32,24,0,0,26.125,-91.875,0,1,1
2012-12,32,40,0,0,26.125,-87.875,2,0,2
2012-12,32,41,0,0,26.125,-87.625,2,0,2
2012-12,32,55,0,0,26.125,-84.125,0,2,2
2012-12,32,56,0,0,26.125,-83.875,0,5,5
2012-12,33,10,1,1,26.375,-95.375,0,0,0
2012-12,33,39,0,0,26.375,-88.125,8,0,8
2012-12,33,40,0,0,26.375,-87.875,7,0,7
2012-12,33,55,0,0,26.375,-84.125,0,5,5
2012-12,34,10,2,1,26.625,-95.375,0,0,0
2012-12,34,55,0,0,26.625,-84.125,0,3,3
2012-12,35,55,0,0,26.875,-84.125,0,1,1
2012-12,36,55,0,0,27.125,-84.125,0,1,1
2012-12,37,13,1,1,27.375,-94.625,0,0,0
2012-12,37,54,0,0,27.375,-84.375,0,2,2
2012-12,38,44,0,0,27.625,-86.875,0,1,1
2012-12,38,54,0,0,27.625,-84.375,0,1,1
2012-12,39,43,0,0,27.875,-87.125,0,1,1
2012-12,39,44,0,0,27.875,-86.875,0,1,1
2012-12,40,40,0,0,28.125,-87.875,0,1,1
2012-12,40,41,0,0,28.125,-87.625,0,5,5
2012-12,40,42,0,0,28.125,-87.375,0,3,3
2012-12,40,54,0,0,28.125,-84.375,0,3,3
2012-12,41,38,0,0,28.375,-88.375,0,3,3
2012-12,41,39,0,0,28.375,-88.125,0,3,3
2012-12,41,40,0,0,28.375,-87.875,0,2,2
2012-12,41,41,0,0,28.375,-87.625,0,4,4
2012-12,41,42,0,0,28.375,-87.375,0,5,5
2013-01,0,46,0,0,18.125,-86.375,0,3,3
2013-01,0,47,0,0,18.125,-86.125,0,4,4
2013-01,0,48,0,0,18.125,-85.875,0,4,4
2013-01,1,53,0,0,18.375,-84.625,2,0,2
2013-01,1,54,0,0,18.375,-84.375,3,0,3
2013-01,1,55,0,0,18.375,-84.125,3,0,3
2013-01,2,56,0,0,18.625,-83.875,3,0,3
2013-01,2,57,0,0,18.625,-83.625,2,0,2
2013-01,2,58,0,0,18.625,-83.375,3,0,3
2013-01,2,59,0,0,18.625,-83.125,1,0,1
2013-01,3,59,0,0,18.875,-83.125,1,0,1
2013-01,3,60,0,0,18.875,-82.875,2,0,2
2013-01,3,61,0,0,18.875,-82.625,5,0,5
2013-01,3,62,0,0,18.875,-82.375,4,0,4
2013-01,3,63,0,0,18.875,-82.125,2,0,2
2013-01,6,69,0,0,19.625,-80.625,0,2,2
2013-01,6,70,0,0,19.625,-80.375,0,8,8
2013-01,6,71,0,0,19.625,-80.125,0,1,1
2013-01,7,67,0,0,19.875,-81.125,0,2,2
2013-01,7,68,0,0,19.875,-80.875,0,2,2
2013-01,7,69,0,0,19.875,-80.625,0,3,3
2013-01,8,8,0,0,20.125,-95.875,4,0,4
2013-01,8,9,0,0,20.125,-95.625,2,0,2
2013-01,8,11,0,0,20.125,-95.125,2,0,2
2013-01,9,9,0,0,20.375,-95.625,4,0,4
2013-01,9,11,0,0,20.375,-95.125,2,0,2
2013-01,9,12,0,0,20.375,-94.875,13,0,13
2013-01,9,47,0,0,20.375,-86.125,1,0,1
2013-01,9,48,0,0,20.375,-85.875,1,0,1
2013-01,10,48,0,0,20.625,-85.875,2,0,2
2013-01,10,49,0,0,20.625,-85.625,1,0,1
2013-01,11,64,0,0,20.875,-81.875,0,3,3
2013-01,11,65,0,0,20.875,-81.625,0,2,2
2013-01,12,52,0,0,21.125,-84.875,5,0,5
2013-01,12,63,0,0,21.125,-82.125,0,1,1
2013-01,12,64,0,0,21.125,-81.875,0,2,2
2013-01,12,65,0,0,21.125,-81.625,0,1,1
2013-01,13,52,0,0,21.375,-84.875,1,0,1
2013-01,13,63,0,0,21.375,-82.125,0,1,1
2013-01,16,11,0,0,22.125,-95.125,0,2,2
2013-01,16,12,0,0,22.125,-94.875,0,11,11
2013-01,16,13,0,0,22.125,-94.625,0,4,4
2013-01,17,13,0,0,22.375,-94.625,0,7,7
2013-01,17,14,0,0,22.375,-94.375,0,7,7
2013-01,22,55,0,0,23.625,-84.125,7,0,7
2013-01,22,56,0,0,23.625,-83.875,6,0,6
2013-01,23,35,0,0,23.875,-89.125,0,7,7
2013-01,23,36,0,0,23.875,-88.875,0,3,3
2013-01,23,48,0,0,23.875,-85.875,0,3,3
2013-01,23,55,0,0,23.875,-84.125,1,0,1
2013-01,23,56,0,0,23.875,-83.875,5,0,5
2013-01,24,47,0,0,24.125,-86.125,0,1,1
2013-01,24,48,0,0,24.125,-85.875,0,1,1
2013-01,25,26,0,0,24.375,-91.375,4,0,4
2013-01,25,47,0,0,24.375,-86.125,0,1,1
2013-01,26,11,0,0,24.625,-95.125,17,0,17
2013-01,26,26,0,0,24.625,-91.375,2,0,2
2013-01,26,27,0,0,24.625,-91.125,7,0,7
2013-01,26,28,0,0,24.625,-90.875,7,0,7
2013-01,26,29,0,0,24.625,-90.625,7,0,7
2013-01,26,47,0,0,24.625,-86.125,0,2,2
2013-01,27,11,0,0,24.875,-95.125,14,0,14
2013-01,27,29,0,0,24.875,-90.625,4,0,4
2013-01,27,42,1,1,24.875,-87.375,0,0,0
2013-01,27,47,0,0,24.875,-86.125,0,2,2
2013-01,28,47,0,0,25.125,-86.125,0,1,1
2013-01,28,48,0,0,25.125,-85.875,0,13,13
2013-01,29,21,0,0,25.375,-92.625,0,10,10
2013-01,29,48,0,0,25.375,-85.875,0,7,7
2013-01,30,20,0,0,25.625,-92.875,0,5,5
2013-01,30,21,0,0,25.625,-92.625,0,1,1
2013-01,30,43,1,1,25.625,-87.125,0,0,0
2013-01,31,20,0,0,25.875,-92.875,0,14,14
2013-01,31,39,0,0,25.875,-88.125,9,0,9
2013-01,31,40,0,0,25.875,-87.875,3,0,3
2013-01,32,20,0,0,26.125,-92.875,0,1,1
2013-01,32,37,0,0,26.125,-88.625,1,0,1
2013-01,32,38,0,0,26.125,-88.375,3,0,3
2013-01,32,39,0,0,26.125,-88.125,14,0,14
2013-01,33,38,0,0,26.375,-88.375,1,0,1
2013-01,35,13,0,0,26.875,-94.625,5,0,5
2013-01,36,12,0,0,27.125,-94.875,4,0,4
2013-01,36,13,0,0,27.125,-94.625,2,0,2
2013-01,41,37,0,0,28.375,-88.625,0,1,1
2013-01,41,38,0,0,28.375,-88.375,0,5,5
2013-01,41,39,0,0,28.375,-88.125,0,18,18
2013-01,41,40,0,0,28.375,-87.875,0,7,7
2013-02,0,48,0,0,18.125,-85.875,7,0,7
2013-02,0,49,0,0,18.125,-85.625,3,0,3
2013-02,1,49,0,0,18.375,-85.625,1,0,1
2013-02,1,50,0,0,18.375,-85.375,3,0,3
2013-02,1,51,0,0,18.375,-85.125,1,0,1
2013-02,1,52,0,0,18.375,-84.875,2,0,2
2013-02,1,53,0,0,18.375,-84.625,1,0,1
2013-02,6,62,0,0,19.625,-82.375,0,2,2
2013-02,6,64,0,0,19.625,-81.875,0,4,4
2013-02,6,65,0,0,19.625,-81.625,0,4,4
2013-02,6,66,0,0,19.625,-81.375,0,3,3
2013-02,7,67,0,0,19.875,-81.125,0,4,4
2013-02,7,68,0,0,19.875,-80.875,0,1,1
2013-02,8,51,0,0,20.125,-85.125,1,0,1
2013-02,8,52,0,0,20.125,-84.875,4,0,4
2013-02,8,55,0,0,20.125,-84.125,5,0,5
2013-02,8,64,0,0,20.125,-81.875,0,2,2
2013-02,8,65,0,0,20.125,-81.625,0,8,8
2013-02,9,53,0,0,20.375,-84.625,1,0,1
2013-02,9,54,0,0,20.375,-84.375,2,0,2
2013-02,9,56,0,0,20.375,-83.875,8,0,8
2013-02,10,53,0,0,20.625,-84.625,1,0,1
2013-02,11,52,0,0,20.875,-84.875,4,0,4
2013-02,16,10,0,0,22.125,-95.375,0,13,13
2013-02,16,11,0,0,22.125,-95.125,0,6,6
2013-02,20,30,0,0,23.125,-90.375,0,2,2
2013-02,21,30,0,0,23.375,-90.375,0,2,2
2013-02,21,31,0,0,23.375,-90.125,0,3,3
2013-02,21,55,0,0,23.375,-84.125,2,0,2
2013-02,22,32,0,0,23.625,-89.875,0,1,1
2013-02,22,33,0,0,23.625,-89.625,0,1,1
2013-02,22,55,0,0,23.625,-84.125,1,0,1
2013-02,22,56,0,0,23.625,-83.875,8,0,8
2013-02,23,22,0,0,23.875,-92.375,3,0,3
2013-02,23,23,0,0,23.875,-92.125,2,0,2
2013-02,23,33,3,1,23.875,-89.625,0,1,1
2013-02,23,34,0,0,23.875,-89.375,0,1,1
2013-02,23,35,0,0,23.875,-89.125,0,6,6
2013-02,23,44,0,0,23.875,-86.875,0,2,2
2013-02,24,23,0,0,24.125,-92.125,3,0,3
2013-02,24,24,0,0,24.125,-91.875,10,0,10
2013-02,24,25,0,0,24.125,-91.625,5,0,5
2013-02,24,33,1,1,24.125,-89.625,0,0,0
2013-02,24,35,0,0,24.125,-89.125,0,11,11
2013-02,24,44,0,0,24.125,-86.875,0,4,4
2013-02,24,50,0,0,24.125,-85.375,0,1,1
2013-02,24,51,0,0,24.125,-85.125,0,4,4
2013-02,25,25,0,0,24.375,-91.625,3,0,3
2013-02,25,26,0,0,24.375,-91.375,1,0,1
2013-02,25,33,1,1,24.375,-89.625,0,0,0
2013-02,25,49,0,0,24.375,-85.625,0,1,1
2013-02,25,50,0,0,24.375,-85.375,0,2,2
2013-02,25,51,0,0,24.375,-85.125,0,1,1
2013-02,26,10,0,0,24.625,-95.375,1,0,1
2013-02,26,11,0,0,24.625,-95.125,5,0,5
2013-02,26,49,0,0,24.625,-85.625,0,3,3
2013-02,27,9,0,0,24.875,-95.625,1,0,1
2013-02,27,10,0,0,24.875,-95.375,18,0,18
2013-02,27,11,0,0,24.875,-95.125,3,0,3
2013-02,27,47,0,0,24.875,-86.125,0,5,5
2013-02,27,50,0,0,24.875,-85.375,0,6,6
2013-02,27,54,2,1,24.875,-84.375,0,0,0
2013-02,28,47,0,0,25.125,-86.125,0,3,3
2013-02,28,48,0,0,25.125,-85.875,0,1,1
2013-02,30,44,0,0,25.625,-86.875,0,1,1
2013-02,30,50,0,0,25.625,-85.375,3,0,3
2013-02,31,49,0,0,25.875,-85.625,4,0,4
2013-02,31,53,1,1,25.875,-84.625,0,0,0
2013-02,32,17,0,0,26.125,-93.625,0,2,2
2013-02,32,18,0,0,26.125,-93.375,0,7,7
2013-02,32,19,0,0,26.125,-93.125,0,13,13
2013-02,32,20,0,0,26.125,-92.875,0,6,6
2013-02,32,36,0,0,26.125,-88.875,15,0,15
2013-02,32,37,0,0,26.125,-88.625,4,0,4
2013-02,32,49,0,0,26.125,-85.625,4,0,4
2013-02,33,36,0,0,26.375,-88.875,8,0,8
2013-02,33,43,0,0,26.375,-87.125,0,4,4
2013-02,33,49,0,0,26.375,-85.625,3,0,3
2013-02,34,36,0,0,26.625,-88.875,1,0,1
2013-02,34,43,0,0,26.625,-87.125,0,9,9
2013-02,34,49,0,0,26.625,-85.625,4,0,4
2013-02,35,49,0,0,26.875,-85.625,1,0,1
2013-02,35,50,0,0,26.875,-85.375,1,0,1
2013-02,36,10,0,0,27.125,-95.375,1,0,1
2013-02,36,11,0,0,27.125,-95.125,9,0,9
2013-02,36,12,0,0,27.125,-94.875,7,0,7
2013-02,36,49,0,0,27.125,-85.625,3,0,3
2013-02,36,50,0,0,27.125,-85.375,4,0,4
2013-02,37,10,0,0,27.375,-95.375,3,0,3
2013-02,37,11,0,0,27.375,-95.125,3,0,3
2013-02,38,9,0,0,27.625,-95.625,1,0,1
2013-02,38,10,0,0,27.625,-95.375,3,0,3
2013-02,39,11,0,0,27.875,-95.125,1,0,1
2013-02,41,37,0,0,28.375,-88.625,0,1,1
2013-02,41,38,0,0,28.375,-88.375,0,4,4
2013-02,42,36,0,0,28.625,-88.875,0,3,3
2013-02,42,37,0,0,28.625,-88.625,0,5,5
2013-03,1,58,0,0,18.375,-83.375,0,1,1
2013-03,1,59,0,0,18.375,-83.125,0,1,1
2013-03,2,56,0,0,18.625,-83.875,0,1,1
2013-03,2,57,0,0,18.625,-83.625,0,1,1
2013-03,3,56,0,0,18.875,-83.875,0,1,1
2013-03,5,71,0,0,19.375,-80.125,2,0,2
2013-03,6,12,0,0,19.625,-94.875,4,0,4
2013-03,6,56,0,0,19.625,-83.875,2,0,2
2013-03,7,12,0,0,19.875,-94.875,12,0,12
2013-03,7,13,0,0,19.875,-94.625,3,0,3
2013-03,7,56,0,0,19.875,-83.875,1,0,1
2013-03,8,51,0,0,20.125,-85.125,2,0,2
2013-03,8,64,0,0,20.125,-81.875,0,7,7
2013-03,9,55,0,0,20.375,-84.125,4,0,4
2013-03,9,56,0,0,20.375,-83.875,1,0,1
2013-03,9,61,0,0,20.375,-82.625,0,6,6
2013-03,9,62,0,0,20.375,-82.375,0,6,6
2013-03,9,63,0,0,20.375,-82.125,0,9,9
2013-03,10,61,0,0,20.625,-82.625,0,1,1
2013-03,10,62,0,0,20.625,-82.375,0,1,1
2013-03,16,45,0,0,22.125,-86.625,0,5,5
2013-03,17,6,0,0,22.375,-96.375,0,7,7
2013-03,17,7,0,0,22.375,-96.125,0,10,10
2013-03,17,8,0,0,22.375,-95.875,0,4,4
2013-03,17,9,0,0,22.375,-95.625,0,9,9
2013-03,18,6,0,0,22.625,-96.375,0,1,1
2013-03,18,44,0,0,22.625,-86.875,0,2,2
2013-03,19,27,0,0,22.875,-91.125,0,5,5
2013-03,19,44,0,0,22.875,-86.875,0,1,1
2013-03,20,29,0,0,23.125,-90.625,0,2,2
2013-03,20,44,0,0,23.125,-86.875,0,1,1
2013-03,21,27,0,0,23.375,-91.125,0,4,4
2013-03,21,28,0,0,23.375,-90.875,0,6,6
2013-03,21,43,0,0,23.375,-87.125,0,2,2
2013-03,21,44,0,0,23.375,-86.875,0,2,2
2013-03,22,43,0,0,23.625,-87.125,0,2,2
2013-03,22,44,0,0,23.625,-86.875,0,5,5
2013-03,22,45,0,0,23.625,-86.625,0,4,4
2013-03,23,15,0,0,23.875,-94.125,1,0,1
2013-03,23,16,0,0,23.875,-93.875,8,0,8
2013-03,23,17,0,0,23.875,-93.625,2,0,2
2013-03,23,44,0,0,23.875,-86.875,0,6,6
2013-03,23,56,0,0,23.875,-83.875,0,5,5
2013-03,24,13,0,0,24.125,-94.625,6,0,6
2013-03,24,15,0,0,24.125,-94.125,5,0,5
2013-03,24,16,0,0,24.125,-93.875,6,0,6
2013-03,24,52,0,0,24.125,-84.875,0,2,2
2013-03,24,53,0,0,24.125,-84.625,0,5,5
2013-03,24,54,0,0,24.125,-84.375,0,5,5
2013-03,24,55,0,0,24.125,-84.125,0,6,6
2013-03,24,56,0,0,24.125,-83.875,0,7,7
2013-03,27,10,0,0,24.875,-95.375,2,0,2
2013-03,27,48,0,0,24.875,-85.875,3,0,3
2013-03,28,48,0,0,25.125,-85.875,7,0,7
2013-03,28,49,0,0,25.125,-85.625,10,0,10
2013-03,29,28,0,0,25.375,-90.875,3,0,3
2013-03,29,29,0,0,25.375,-90.625,1,0,1
2013-03,29,49,0,0,25.375,-85.625,9,0,9
2013-03,30,30,0,0,25.625,-90.375,2,0,2
2013-03,30,50,0,0,25.625,-85.375,2,0,2
2013-03,31,30,0,0,25.875,-90.375,3,0,3
2013-03,32,16,0,0,26.125,-93.875,0,16,16
2013-03,32,17,0,0,26.125,-93.625,0,15,15
2013-03,34,34,1,1,26.625,-89.375,0,0,0
2013-03,34,35,0,0,26.625,-89.125,6,0,6
2013-03,34,36,0,0,26.625,-88.875,8,0,8
2013-03,34,44,0,0,26.625,-86.875,0,1,1
2013-03,35,36,0,0,26.875,-88.875,2,0,2
2013-03,35,37,0,0,26.875,-88.625,1,0,1
2013-03,35,44,0,0,26.875,-86.875,0,9,9
2013-03,35,45,0,0,26.875,-86.625,0,10,10
2013-03,36,37,0,0,27.125,-88.625,5,0,5
2013-03,36,45,0,0,27.125,-86.625,0,11,11
2013-03,37,10,0,0,27.375,-95.375,2,0,2
2013-03,37,11,0,0,27.375,-95.125,23,0,23
2013-03,37,37,0,0,27.375,-88.625,6,0,6
2013-03,38,10,0,0,27.625,-95.375,3,0,3
2013-03,38,11,0,0,27.625,-95.125,1,0,1
2013-03,38,38,0,0,27.625,-88.375,3,0,3
2013-04,0,59,0,0,18.125,-83.125,1,0,1
2013-04,0,60,0,0,18.125,-82.875,1,0,1
2013-04,0,61,0,0,18.125,-82.625,3,0,3
2013-04,0,62,0,0,18.125,-82.375,1,0,1
2013-04,0,71,0,0,18.125,-80.125,0,3,3
2013-04,1,58,0,0,18.375,-83.375,1,0,1
2013-04,1,59,0,0,18.375,-83.125,1,0,1
2013-04,1,62,0,0,18.375,-82.375,1,0,1
2013-04,1,63,0,0,18.375,-82.125,3,0,3
2013-04,1,64,0,0,18.375,-81.875,1,0,1
2013-04,1,65,0,0,18.375,-81.625,1,0,1
2013-04,1,69,0,0,18.375,-80.625,0,3,3
2013-04,1,70,0,0,18.375,-80.375,0,2,2
2013-04,2,67,0,0,18.625,-81.125,3,0,3
2013-04,3,55,0,0,18.875,-84.125,0,1,1
2013-04,3,66,0,0,18.875,-81.375,2,0,2
2013-04,4,54,0,0,19.125,-84.375,0,1,1
2013-04,5,51,0,0,19.375,-85.125,5,1,6
2013-04,5,52,0,0,19.375,-84.875,4,1,5
2013-04,5,53,0,0,19.375,-84.625,3,0,3
2013-04,6,50,0,0,19.625,-85.375,0,1,1
2013-04,6,54,0,0,19.625,-84.375,3,0,3
2013-04,6,55,0,0,19.625,-84.125,3,0,3
2013-04,6,56,0,0,19.625,-83.875,1,0,1
2013-04,7,13,0,0,19.875,-94.625,4,0,4
2013-04,7,51,0,0,19.875,-85.125,0,2,2
2013-04,7,52,0,0,19.875,-84.875,0,3,3
2013-04,8,12,0,0,20.125,-94.875,3,0,3
2013-04,8,13,0,0,20.125,-94.625,4,0,4
2013-04,8,52,0,0,20.125,-84.875,0,1,1
2013-04,8,70,0,0,20.125,-80.375,3,0,3
2013-04,9,52,0,0,20.375,-84.875,0,10,10
2013-04,9,53,0,0,20.375,-84.625,0,6,6
2013-04,9,69,0,0,20.375,-80.625,5,0,5
2013-04,9,70,0,0,20.375,-80.375,2,0,2
2013-04,10,52,0,0,20.625,-84.875,0,1,1
2013-04,10,53,0,0,20.625,-84.625,0,2,2
2013-04,10,68,0,0,20.625,-80.875,2,0,2
2013-04,10,69,0,0,20.625,-80.625,1,0,1
2013-04,13,9,0,0,21.375,-95.625,1,0,1
2013-04,13,10,0,0,21.375,-95.375,5,0,5
2013-04,14,10,0,0,21.625,-95.375,4,0,4
2013-04,15,10,0,0,21.875,-95.375,3,0,3
2013-04,16,10,0,0,22.125,-95.375,1,0,1
2013-04,17,10,0,0,22.375,-95.375,1,0,1
2013-04,17,11,0,0,22.375,-95.125,1,0,1
2013-04,18,6,0,0,22.625,-96.375,0,8,8
2013-04,19,5,0,0,22.875,-96.625,0,6,6
2013-04,19,6,0,0,22.875,-96.375,0,1,1
2013-04,20,5,0,0,23.125,-96.625,0,5,5
2013-04,20,12,0,0,23.125,-94.875,1,0,1
2013-04,21,5,0,0,23.375,-96.625,0,7,7
2013-04,22,5,0,0,23.625,-96.625,0,1,1
2013-04,22,6,0,0,23.625,-96.375,0,2,2
2013-04,22,12,0,0,23.625,-94.875,1,0,1
2013-04,22,13,0,0,23.625,-94.625,1,0,1
2013-04,23,55,0,0,23.875,-84.125,0,12,12
2013-04,23,56,0,0,23.875,-83.875,0,10,10
2013-04,24,11,0,0,24.125,-95.125,1,0,1
2013-04,24,12,0,0,24.125,-94.875,5,0,5
2013-04,24,45,0,0,24.125,-86.625,2,0,2
2013-04,24,54,0,0,24.125,-84.375,0,3,3
2013-04,24,55,0,0,24.125,-84.125,0,1,1
2013-04,24,56,0,0,24.125,-83.875,0,4,4
2013-04,25,12,0,0,24.375,-94.875,4,0,4
2013-04,25,45,0,0,24.375,-86.625,11,0,11
2013-04,25,63,0,0,24.375,-82.125,2,0,2
2013-04,26,10,0,0,24.625,-95.375,2,0,2
2013-04,26,11,0,0,24.625,-95.125,3,0,3
2013-04,26,12,0,0,24.625,-94.875,1,0,1
2013-04,26,45,0,0,24.625,-86.625,2,0,2
2013-04,26,46,0,0,24.625,-86.375,7,0,7
2013-04,27,9,0,0,24.875,-95.625,2,0,2
2013-04,27,10,0,0,24.875,-95.375,4,0,4
2013-04,27,47,0,0,24.875,-86.125,8,0,8
2013-04,28,7,0,0,25.125,-96.125,5,0,5
2013-04,28,8,0,0,25.125,-95.875,3,0,3
2013-04,28,25,0,0,25.125,-91.625,9,0,9
2013-04,28,26,0,0,25.125,-91.375,8,0,8
2013-04,29,26,0,0,25.375,-91.375,2,0,2
2013-04,29,27,0,0,25.375,-91.125,9,0,9
2013-04,29,28,0,0,25.375,-90.875,2,0,2
2013-04,32,13,0,0,26.125,-94.625,0,2,2
2013-04,32,14,0,0,26.125,-94.375,0,7,7
2013-04,32,15,0,0,26.125,-94.125,0,8,8
2013-04,32,16,0,0,26.125,-93.875,0,1,1
2013-04,33,14,0,0,26.375,-94.375,0,9,9
2013-04,33,15,0,0,26.375,-94.125,0,3,3
2013-04,35,42,0,0,26.875,-87.375,0,1,1
2013-04,35,43,0,0,26.875,-87.125,0,4,4
2013-04,35,44,0,0,26.875,-86.875,0,6,6
2013-04,35,45,0,0,26.875,-86.625,0,11,11
2013-04,36,45,0,0,27.125,-86.625,0,8,8
2013-04,38,8,0,0,27.625,-95.875,1,0,1
2013-04,38,9,0,0,27.625,-95.625,2,0,2
2013-04,38,38,0,0,27.625,-88.375,1,0,1
2013-04,39,8,0,0,27.875,-95.875,5,0,5
2013-04,39,38,0,0,27.875,-88.375,2,0,2
2013-04,39,39,0,0,27.875,-88.125,3,0,3
2013-04,40,39,0,0,28.125,-88.125,6,0,6
2013-04,41,40,0,0,28.375,-87.875,7,0,7
2013-04,41,41,0,0,28.375,-87.625,5,0,5
2013-04,41,42,0,0,28.375,-87.375,5,0,5
2013-04,42,41,0,0,28.625,-87.625,1,0,1
2013-05,0,50,0,0,18.125,-85.375,1,0,1
2013-05,0,51,0,0,18.125,-85.125,2,0,2
2013-05,0,52,0,0,18.125,-84.875,3,0,3
2013-05,0,53,0,0,18.125,-84.625,2,0,2
2013-05,0,54,0,0,18.125,-84.375,2,0,2
2013-05,0,55,0,0,18.125,-84.125,2,0,2
2013-05,1,48,0,0,18.375,-85.875,3,0,3
2013-05,1,49,0,0,18.375,-85.625,3,0,3
2013-05,1,50,0,0,18.375,-85.375,2,0,2
2013-05,1,57,0,0,18.375,-83.625,1,0,1
2013-05,1,58,0,0,18.375,-83.375,1,0,1
2013-05,1,67,0,0,18.375,-81.125,0,1,1
2013-05,1,68,0,0,18.375,-80.875,0,1,1
2013-05,2,48,0,0,18.625,-85.875,1,0,1
2013-05,2,65,0,0,18.625,-81.625,0,1,1
2013-05,2,66,0,0,18.625,-81.375,0,1,1
2013-05,2,67,0,0,18.625,-81.125,0,1,1
2013-05,3,63,0,0,18.875,-82.125,0,2,2
2013-05,3,64,0,0,18.875,-81.875,0,1,1
2013-05,4,62,0,0,19.125,-82.375,0,4,4
2013-05,4,63,0,0,19.125,-82.125,0,2,2
2013-05,4,67,0,0,19.125,-81.125,0,1,1
2013-05,5,59,0,0,19.375,-83.125,0,1,1
2013-05,5,60,0,0,19.375,-82.875,0,1,1
2013-05,5,61,0,0,19.375,-82.625,0,3,3
2013-05,6,60,0,0,19.625,-82.875,0,1,1
2013-05,6,61,0,0,19.625,-82.625,0,1,1
2013-05,9,66,0,0,20.375,-81.375,2,0,2
2013-05,9,67,0,0,20.375,-81.125,4,0,4
2013-05,10,50,0,0,20.625,-85.375,0,2,2
2013-05,10,51,0,0,20.625,-85.125,0,3,3
2013-05,10,52,0,0,20.625,-84.875,0,2,2
2013-05,10,54,0,0,20.625,-84.375,3,0,3
2013-05,10,55,0,0,20.625,-84.125,5,0,5
2013-05,10,56,0,0,20.625,-83.875,3,0,3
2013-05,10,59,0,0,20.625,-83.125,0,4,4
2013-05,10,67,0,0,20.625,-81.125,2,0,2
2013-05,10,68,0,0,20.625,-80.875,9,0,9
2013-05,11,9,0,0,20.875,-95.625,16,0,16
2013-05,11,10,0,0,20.875,-95.375,3,0,3
2013-05,11,18,0,0,20.875,-93.375,0,3,3
2013-05,11,19,0,0,20.875,-93.125,0,6,6
2013-05,11,20,0,0,20.875,-92.875,0,2,2
2013-05,11,49,0,0,20.875,-85.625,0,2,2
2013-05,11,50,0,0,20.875,-85.375,0,2,2
2013-05,11,52,0,0,20.875,-84.875,4,0,4
2013-05,11,53,0,0,20.875,-84.625,4,0,4
2013-05,11,56,0,0,20.875,-83.875,1,0,1
2013-05,11,57,0,0,20.875,-83.625,7,0,7
2013-05,11,58,0,0,20.875,-83.375,1,0,1
2013-05,12,9,0,0,21.125,-95.625,8,0,8
2013-05,12,16,0,0,21.125,-93.875,0,1,1
2013-05,12,17,0,0,21.125,-93.625,0,6,6
2013-05,12,18,0,0,21.125,-93.375,0,1,1
2013-05,12,49,0,0,21.125,-85.625,0,2,2
2013-05,12,50,0,0,21.125,-85.375,0,2,2
2013-05,12,57,0,0,21.125,-83.625,1,0,1
2013-05,13,9,0,0,21.375,-95.625,4,0,4
2013-05,13,49,0,0,21.375,-85.625,0,1,1
2013-05,20,5,0,0,23.125,-96.625,0,5,5
2013-05,20,10,0,0,23.125,-95.375,1,0,1
2013-05,21,5,0,0,23.375,-96.625,0,7,7
2013-05,21,6,0,0,23.375,-96.375,0,10,10
2013-05,21,11,0,0,23.375,-95.125,3,0,3
2013-05,22,6,0,0,23.625,-96.375,0,9,9
2013-05,22,11,0,0,23.625,-95.125,1,0,1
2013-05,22,12,0,0,23.625,-94.875,6,0,6
2013-05,23,12,0,0,23.875,-94.875,3,0,3
2013-05,23,13,0,0,23.875,-94.625,5,0,5
2013-05,24,13,0,0,24.125,-94.625,8,0,8
2013-05,24,45,0,0,24.125,-86.625,11,0,11
2013-05,24,46,0,0,24.125,-86.375,2,0,2
2013-05,24,54,0,0,24.125,-84.375,0,6,6
2013-05,24,55,0,0,24.125,-84.125,0,25,25
2013-05,24,61,0,0,24.125,-82.625,2,0,2
2013-05,24,63,0,0,24.125,-82.125,10,0,10
2013-05,24,64,0,0,24.125,-81.875,1,0,1
2013-05,25,13,0,0,24.375,-94.625,4,0,4
2013-05,25,45,0,0,24.375,-86.625,10,0,10
2013-05,25,60,0,0,24.375,-82.875,3,0,3
2013-05,25,61,0,0,24.375,-82.625,2,0,2
2013-05,25,63,0,0,24.375,-82.125,6,0,6
2013-05,25,64,0,0,24.375,-81.875,3,0,3
2013-05,26,45,0,0,24.625,-86.625,8,0,8
2013-05,26,60,0,0,24.625,-82.875,1,0,1
2013-05,28,24,0,0,25.125,-91.875,6,0,6
2013-05,28,25,0,0,25.125,-91.625,1,0,1
2013-05,29,24,0,0,25.375,-91.875,8,0,8
2013-05,29,25,0,0,25.375,-91.625,6,0,6
2013-05,30,23,0,0,25.625,-92.125,4,0,4
2013-05,30,24,0,0,25.625,-91.875,6,0,6
2013-05,32,10,0,0,26.125,-95.375,0,14,14
2013-05,32,11,0,0,26.125,-95.125,0,2,2
2013-05,32,12,0,0,26.125,-94.875,0,3,3
2013-05,32,13,0,0,26.125,-94.625,0,2,2
2013-05,32,37,0,0,26.125,-88.625,0,2,2
2013-05,32,50,0,0,26.125,-85.375,0,2,2
2013-05,32,51,0,0,26.125,-85.125,0,3,3
2013-05,33,10,0,0,26.375,-95.375,0,1,1
2013-05,33,11,0,0,26.375,-95.125,0,6,6
2013-05,33,12,0,0,26.375,-94.875,0,3,3
2013-05,33,37,0,0,26.375,-88.625,0,2,2
2013-05,33,38,0,0,26.375,-88.375,0,4,4
2013-05,33,51,0,0,26.375,-85.125,0,3,3
2013-05,34,38,0,0,26.625,-88.375,0,3,3
2013-05,34,39,0,0,26.625,-88.125,0,3,3
2013-05,34,40,0,0,26.625,-87.875,0,4,4
2013-05,34,41,0,0,26.625,-87.625,0,1,1
2013-05,34,51,0,0,26.625,-85.125,0,3,3
2013-05,35,41,0,0,26.875,-87.625,0,6,6
2013-05,35,42,0,0,26.875,-87.375,0,6,6
2013-05,35,51,0,0,26.875,-85.125,0,2,2
2013-05,37,22,0,0,27.375,-92.375,0,2,2
2013-05,37,24,0,0,27.375,-91.875,0,4,4
2013-05,37,25,0,0,27.375,-91.625,0,4,4
2013-05,37,46,0,0,27.375,-86.375,1,0,1
2013-05,38,21,0,0,27.625,-92.625,0,7,7
2013-05,38,22,0,0,27.625,-92.375,0,3,3
2013-05,38,25,0,0,27.625,-91.625,0,4,4
2013-05,38,46,0,0,27.625,-86.375,1,0,1
2013-05,39,24,0,0,27.875,-91.875,0,1,1
2013-05,39,45,0,0,27.875,-86.625,9,0,9
2013-05,40,44,0,0,28.125,-86.875,5,0,5
2013-05,41,42,0,0,28.375,-87.375,1,0,1
2013-05,41,43,0,0,28.375,-87.125,2,0,2
2013-05,41,44,0,0,28.375,-86.875,3,0,3
2013-06,0,44,0,0,18.125,-86.875,1,0,1
2013-06,2,44,0,0,18.625,-86.875,2,0,2
2013-06,3,44,0,0,18.875,-86.875,2,0,2
2013-06,4,44,0,0,19.125,-86.875,1,0,1
2013-06,4,52,0,0,19.125,-84.875,0,4,4
2013-06,4,53,0,0,19.125,-84.625,0,4,4
2013-06,4,54,0,0,19.125,-84.375,0,4,4
2013-06,4,55,0,0,19.125,-84.125,0,1,1
2013-06,4,66,0,0,19.125,-81.375,2,0,2
2013-06,4,67,0,0,19.125,-81.125,4,0,4
2013-06,5,44,0,0,19.375,-86.875,1,0,1
2013-06,5,51,0,0,19.375,-85.125,0,2,2
2013-06,5,52,0,0,19.375,-84.875,0,3,3
2013-06,5,62,0,0,19.375,-82.375,5,0,5
2013-06,5,63,0,0,19.375,-82.125,4,0,4
2013-06,5,64,0,0,19.375,-81.875,3,0,3
2013-06,5,65,0,0,19.375,-81.625,3,0,3
2013-06,6,44,0,0,19.625,-86.875,2,0,2
2013-06,6,45,0,0,19.625,-86.625,1,0,1
2013-06,10,7,0,0,20.625,-96.125,4,0,4
2013-06,10,58,0,0,20.625,-83.375,0,3,3
2013-06,10,59,0,0,20.625,-83.125,0,2,2
2013-06,11,7,0,0,20.875,-96.125,8,0,8
2013-06,11,9,0,0,20.875,-95.625,2,0,2
2013-06,12,8,0,0,21.125,-95.875,7,0,7
2013-06,12,9,0,0,21.125,-95.625,2,0,2
2013-06,12,16,0,0,21.125,-93.875,0,2,2
2013-06,12,51,0,0,21.125,-85.125,1,0,1
2013-06,12,52,0,0,21.125,-84.875,2,0,2
2013-06,13,14,0,0,21.375,-94.375,0,1,1
2013-06,13,15,0,0,21.375,-94.125,0,2,2
2013-06,13,16,0,0,21.375,-93.875,0,11,11
2013-06,13,17,0,0,21.375,-93.625,0,1,1
2013-06,13,51,0,0,21.375,-85.125,3,0,3
2013-06,14,16,0,0,21.625,-93.875,0,13,13
2013-06,17,4,0,0,22.375,-96.875,0,11,11
2013-06,18,4,0,0,22.625,-96.875,0,2,2
2013-06,19,4,0,0,22.875,-96.875,0,2,2
2013-06,19,5,0,0,22.875,-96.625,0,2,2
2013-06,20,8,0,0,23.125,-95.875,9,0,9
2013-06,20,9,0,0,23.125,-95.625,12,0,12
2013-06,20,10,0,0,23.125,-95.375,5,0,5
2013-06,21,10,0,0,23.375,-95.375,1,0,1
2013-06,21,11,0,0,23.375,-95.125,1,0,1
2013-06,23,54,0,0,23.875,-84.375,0,1,1
2013-06,23,55,0,0,23.875,-84.125,0,9,9
2013-06,24,54,0,0,24.125,-84.375,0,7,7
2013-06,24,55,0,0,24.125,-84.125,0,13,13
2013-06,24,61,0,0,24.125,-82.625,1,0,1
2013-06,24,62,0,0,24.125,-82.375,4,0,4
2013-06,24,63,0,0,24.125,-82.125,8,0,8
2013-06,24,64,0,0,24.125,-81.875,3,0,3
2013-06,24,65,0,0,24.125,-81.625,2,0,2
2013-06,24,66,0,0,24.125,-81.375,3,0,3
2013-06,24,67,0,0,24.125,-81.125,1,0,1
2013-06,24,68,0,0,24.125,-80.875,2,0,2
2013-06,25,63,0,0,24.375,-82.125,1,0,1
2013-06,25,68,0,0,24.375,-80.875,2,0,2
2013-06,25,69,0,0,24.375,-80.625,1,0,1
2013-06,26,45,0,0,24.625,-86.625,1,0,1
2013-06,27,45,0,0,24.875,-86.625,17,0,17
2013-06,27,46,0,0,24.875,-86.375,10,0,10
2013-06,28,19,0,0,25.125,-93.125,1,0,1
2013-06,28,46,0,0,25.125,-86.375,2,0,2
2013-06,29,19,0,0,25.375,-93.125,3,0,3
2013-06,29,20,0,0,25.375,-92.875,11,0,11
2013-06,29,21,0,0,25.375,-92.625,8,0,8
2013-06,29,22,0,0,25.375,-92.375,3,0,3
2013-06,29,34,0,0,25.375,-89.375,0,2,2
2013-06,30,22,0,0,25.625,-92.375,3,0,3
2013-06,30,23,0,0,25.625,-92.125,1,0,1
2013-06,30,34,0,0,25.625,-89.375,0,3,3
2013-06,30,35,0,0,25.625,-89.125,0,10,10
2013-06,30,36,0,0,25.625,-88.875,0,5,5
2013-06,31,9,0,0,25.875,-95.625,0,8,8
2013-06,31,10,0,0,25.875,-95.375,0,10,10
2013-06,31,36,0,0,25.875,-88.875,0,4,4
2013-06,31,37,0,0,25.875,-88.625,0,3,3
2013-06,32,9,0,0,26.125,-95.625,0,3,3
2013-06,32,10,0,0,26.125,-95.375,0,9,9
2013-06,32,37,0,0,26.125,-88.625,0,3,3
2013-06,33,25,1,1,26.375,-91.625,0,0,0
2013-06,33,26,1,1,26.375,-91.375,0,0,0
2013-06,33,28,2,1,26.375,-90.875,0,0,0
2013-06,33,29,5,1,26.375,-90.625,0,0,0
2013-06,34,30,1,1,26.625,-90.375,0,0,0
2013-06,35,16,1,1,26.875,-93.875,0,0,0
2013-06,35,30,1,1,26.875,-90.375,0,0,0
2013-06,35,31,1,1,26.875,-90.125,0,0,0
2013-06,35,50,0,0,26.875,-85.375,0,11,11
2013-06,35,51,0,0,26.875,-85.125,0,13,13
2013-06,36,19,0,0,27.125,-93.125,0,2,2
2013-06,36,20,1,1,27.125,-92.875,0,5,5
2013-06,36,21,0,0,27.125,-92.625,0,4,4
2013-06,36,22,0,0,27.125,-92.375,0,10,10
2013-06,36,23,0,0,27.125,-92.125,0,2,2
2013-06,36,27,1,1,27.125,-91.125,0,0,0
2013-06,36,51,0,0,27.125,-85.125,0,3,3
2013-06,37,21,0,0,27.375,-92.625,0,1,1
2013-06,37,23,0,0,27.375,-92.125,0,6,6
2013-06,37,27,1,1,27.375,-91.125,0,0,0
2013-06,37,28,1,1,27.375,-90.875,0,0,0
2013-06,37,50,0,0,27.375,-85.375,0,1,1
2013-06,37,51,0,0,27.375,-85.125,0,2,2
2013-06,38,27,1,1,27.625,-91.125,0,0,0
2013-06,39,21,1,1,27.875,-92.625,0,0,0
2013-06,39,24,1,1,27.875,-91.875,0,0,0
2013-06,39,27,1,1,27.875,-91.125,0,0,0
2013-06,39,28,4,1,27.875,-90.875,0,0,0
2013-06,39,29,1,1,27.875,-90.625,0,0,0
2013-06,40,23,1,1,28.125,-92.125,0,0,0
2013-06,40,25,3,1,28.125,-91.625,0,0,0
2013-06,40,26,1,1,28.125,-91.375,0,0,0
2013-06,40,27,7,5,28.125,-91.125,0,0,0
2013-06,40,28,35,9,28.125,-90.875,0,0,0
2013-06,41,18,1,1,28.375,-93.375,0,0,0
2013-06,41,20,1,1,28.375,-92.875,0,0,0
2013-06,41,23,2,1,28.375,-92.125,0,0,0
2013-06,41,24,1,1,28.375,-91.875,0,0,0
2013-06,43,20,1,1,28.875,-92.875,0,0,0
2013-06,44,23,1,1,29.125,-92.125,0,0,0
2013-07,1,53,0,0,18.375,-84.625,1,0,1
2013-07,1,54,0,0,18.375,-84.375,3,0,3
2013-07,2,56,0,0,18.625,-83.875,3,0,3
2013-07,2,57,0,0,18.625,-83.625,4,0,4
2013-07,2,58,0,0,18.625,-83.375,4,0,4
2013-07,3,58,0,0,18.875,-83.375,2,0,2
2013-07,3,59,0,0,18.875,-83.125,2,0,2
2013-07,4,59,0,0,19.125,-83.125,2,0,2
2013-07,5,49,0,0,19.375,-85.625,0,4,4
2013-07,5,50,0,0,19.375,-85.375,0,7,7
2013-07,5,51,0,0,19.375,-85.125,0,2,2
2013-07,5,59,0,0,19.375,-83.125,3,0,3
2013-07,5,60,0,0,19.375,-82.875,3,0,3
2013-07,5,61,0,0,19.375,-82.625,4,0,4
2013-07,6,11,0,0,19.625,-95.125,2,0,2
2013-07,6,12,0,0,19.625,-94.875,9,0,9
2013-07,6,48,0,0,19.625,-85.875,0,1,1
2013-07,6,49,0,0,19.625,-85.625,0,1,1
2013-07,6,71,0,0,19.625,-80.125,0,3,3
2013-07,7,12,0,0,19.875,-94.875,2,0,2
2013-07,8,12,0,0,20.125,-94.875,4,0,4
2013-07,9,11,0,0,20.375,-95.125,1,0,1
2013-07,9,12,0,0,20.375,-94.875,3,0,3
2013-07,10,11,0,0,20.625,-95.125,4,0,4
2013-07,13,11,0,0,21.375,-95.125,0,2,2
2013-07,13,12,0,0,21.375,-94.875,0,8,8
2013-07,13,13,0,0,21.375,-94.625,0,4,4
2013-07,13,14,0,0,21.375,-94.375,0,1,1
2013-07,14,10,0,0,21.625,-95.375,0,1,1
2013-07,14,11,0,0,21.625,-95.125,0,5,5
2013-07,15,10,0,0,21.875,-95.375,0,1,1
2013-07,15,11,0,0,21.875,-95.125,0,8,8
2013-07,20,8,0,0,23.125,-95.875,4,0,4
2013-07,21,6,0,0,23.375,-96.375,3,0,3
2013-07,21,7,0,0,23.375,-96.125,12,0,12
2013-07,21,8,0,0,23.375,-95.875,1,0,1
2013-07,22,6,0,0,23.625,-96.375,11,0,11
2013-07,23,8,1,1,23.875,-95.875,0,0,0
2013-07,23,55,0,0,23.875,-84.125,0,18,18
2013-07,23,56,0,0,23.875,-83.875,0,4,4
2013-07,23,64,0,0,23.875,-81.875,5,0,5
2013-07,23,65,0,0,23.875,-81.625,5,0,5
2013-07,23,66,0,0,23.875,-81.375,2,0,2
2013-07,24,55,0,0,24.125,-84.125,0,9,9
2013-07,24,64,0,0,24.125,-81.875,6,0,6
2013-07,24,66,0,0,24.125,-81.375,2,0,2
2013-07,24,67,0,0,24.125,-81.125,4,0,4
2013-07,25,45,0,0,24.375,-86.625,1,0,1
2013-07,25,64,0,0,24.375,-81.875,1,0,1
2013-07,25,68,0,0,24.375,-80.875,1,0,1
2013-07,25,69,0,0,24.375,-80.625,1,0,1
2013-07,26,45,0,0,24.625,-86.625,10,0,10
2013-07,26,69,0,0,24.625,-80.625,2,0,2
2013-07,26,70,0,0,24.625,-80.375,2,0,2
2013-07,27,7,1,1,24.875,-96.125,0,0,0
2013-07,27,8,1,1,24.875,-95.875,0,0,0
2013-07,27,17,0,0,24.875,-93.625,7,0,7
2013-07,27,18,0,0,24.875,-93.375,3,0,3
2013-07,28,5,1,1,25.125,-96.625,0,0,0
2013-07,28,11,1,1,25.125,-95.125,0,0,0
2013-07,28,18,0,0,25.125,-93.375,12,0,12
2013-07,28,19,0,0,25.125,-93.125,9,0,9
2013-07,28,46,0,0,25.125,-86.375,9,0,9
2013-07,29,6,1,1,25.375,-96.375,0,0,0
2013-07,29,8,1,1,25.375,-95.875,0,0,0
2013-07,29,31,0,0,25.375,-90.125,0,1,1
2013-07,29,32,0,0,25.375,-89.875,0,6,6
2013-07,29,33,0,0,25.375,-89.625,0,7,7
2013-07,29,34,0,0,25.375,-89.375,0,6,6
2013-07,29,45,0,0,25.375,-86.625,7,0,7
2013-07,29,46,0,0,25.375,-86.375,4,0,4
2013-07,30,13,1,1,25.625,-94.625,0,0,0
2013-07,30,31,0,0,25.625,-90.125,0,1,1
2013-07,30,34,0,0,25.625,-89.375,0,10,10
2013-07,31,6,1,1,25.875,-96.375,0,0,0
2013-07,31,7,2,1,25.875,-96.125,0,0,0
2013-07,31,9,0,0,25.875,-95.625,0,9,9
2013-07,31,17,1,1,25.875,-93.625,0,0,0
2013-07,32,6,1,1,26.125,-96.375,0,0,0
2013-07,32,7,3,2,26.125,-96.125,0,0,0
2013-07,32,9,0,0,26.125,-95.625,0,1,1
2013-07,32,10,0,0,26.125,-95.375,0,10,10
2013-07,32,12,1,1,26.125,-94.875,0,0,0
2013-07,33,6,1,1,26.375,-96.375,0,0,0
2013-07,33,7,1,1,26.375,-96.125,0,0,0
2013-07,33,10,0,0,26.375,-95.375,0,11,11
2013-07,33,12,1,1,26.375,-94.875,0,0,0
2013-07,34,4,1,1,26.625,-96.875,0,0,0
2013-07,34,8,1,1,26.625,-95.875,0,0,0
2013-07,34,14,1,1,26.625,-94.375,0,0,0
2013-07,34,21,2,1,26.625,-92.625,0,0,0
2013-07,35,5,1,1,26.875,-96.625,0,0,0
2013-07,35,7,2,1,26.875,-96.125,0,0,0
2013-07,35,9,3,2,26.875,-95.625,0,0,0
2013-07,35,10,1,1,26.875,-95.375,0,0,0
2013-07,35,12,1,1,26.875,-94.875,0,0,0
2013-07,35,15,1,1,26.875,-94.125,0,0,0
2013-07,35,22,1,1,26.875,-92.375,0,0,0
2013-07,36,6,1,1,27.125,-96.375,0,0,0
2013-07,36,11,1,1,27.125,-95.125,0,0,0
2013-07,36,19,0,0,27.125,-93.125,0,1,1
2013-07,36,23,1,1,27.125,-92.125,0,0,0
2013-07,36,32,1,1,27.125,-89.875,0,0,0
2013-07,37,15,1,1,27.375,-94.125,0,0,0
2013-07,37,19,1,1,27.375,-93.125,0,0,0
2013-07,37,23,1,1,27.375,-92.125,0,0,0
2013-07,37,26,1,1,27.375,-91.375,0,0,0
2013-07,37,34,1,1,27.375,-89.375,0,0,0
2013-07,37,35,1,1,27.375,-89.125,0,0,0
2013-07,37,51,0,0,27.375,-85.125,0,1,1
2013-07,38,12,1,1,27.625,-94.875,0,0,0
2013-07,38,22,2,2,27.625,-92.375,0,0,0
2013-07,38,23,3,2,27.625,-92.125,0,0,0
2013-07,38,25,4,1,27.625,-91.625,0,0,0
2013-07,38,26,1,1,27.625,-91.375,0,0,0
2013-07,38,37,1,1,27.625,-88.625,0,0,0
2013-07,38,39,3,1,27.625,-88.125,0,0,0
2013-07,38,50,0,0,27.625,-85.375,0,2,2
2013-07,39,12,1,1,27.875,-94.875,0,0,0
2013-07,39,18,1,1,27.875,-93.375,0,0,0
2013-07,39,21,4,1,27.875,-92.625,0,0,0
2013-07,39,22,31,4,27.875,-92.375,0,0,0
2013-07,39,23,7,3,27.875,-92.125,0,0,0
2013-07,39,24,2,1,27.875,-91.875,0,0,0
2013-07,39,25,12,1,27.875,-91.625,0,0,0
2013-07,39,30,1,1,27.875,-90.375,0,0,0
2013-07,39,34,1,1,27.875,-89.375,0,0,0
2013-07,39,36,1,1,27.875,-88.875,0,0,0
2013-07,39,37,1,1,27.875,-88.625,0,0,0
2013-07,39,39,2,1,27.875,-88.125,0,0,0
2013-07,39,40,3,1,27.875,-87.875,0,0,0
2013-07,39,41,2,1,27.875,-87.625,0,0,0
2013-07,39,42,2,1,27.875,-87.375,0,0,0
2013-07,39,48,0,0,27.875,-85.875,0,6,6
2013-07,39,49,0,0,27.875,-85.625,0,16,16
2013-07,40,16,1,1,28.125,-93.875,0,0,0
2013-07,40,19,1,1,28.125,-93.125,0,0,0
2013-07,40,21,1,1,28.125,-92.625,0,0,0
2013-07,40,23,1,1,28.125,-92.125,0,0,0
2013-07,40,25,1,1,28.125,-91.625,0,0,0
2013-07,40,28,2,1,28.125,-90.875,0,0,0
2013-07,40,29,1,1,28.125,-90.625,0,0,0
2013-07,40,30,1,1,28.125,-90.375,0,0,0
2013-07,40,38,1,1,28.125,-88.375,0,0,0
2013-07,40,40,2,1,28.125,-87.875,0,0,0
2013-07,40,42,1,1,28.125,-87.375,0,0,0
2013-07,40,43,3,1,28.125,-87.125,0,0,0
2013-07,40,44,4,1,28.125,-86.875,0,0,0
2013-07,40,45,2,1,28.125,-86.625,0,0,0
2013-07,40,48,0,0,28.125,-85.875,0,4,4
2013-07,40,49,0,0,28.125,-85.625,0,1,1
2013-07,41,32,1,1,28.375,-89.875,0,0,0
2013-07,41,48,0,0,28.375,-85.875,0,1,1
2013-08,0,45,0,0,18.125,-86.625,3,0,3
2013-08,0,56,0,0,18.125,-83.875,2,0,2
2013-08,1,53,0,0,18.375,-84.625,2,0,2
2013-08,1,54,0,0,18.375,-84.375,2,0,2
2013-08,1,55,0,0,18.375,-84.125,2,0,2
2013-08,1,56,0,0,18.375,-83.875,1,0,1
2013-08,2,50,0,0,18.625,-85.375,1,0,1
2013-08,2,51,0,0,18.625,-85.125,1,0,1
2013-08,2,52,0,0,18.625,-84.875,2,0,2
2013-08,2,53,0,0,18.625,-84.625,2,0,2
2013-08,2,54,0,0,18.625,-84.375,1,0,1
2013-08,4,54,0,0,19.125,-84.375,0,4,4
2013-08,4,55,0,0,19.125,-84.125,0,2,2
2013-08,4,56,0,0,19.125,-83.875,0,1,1
2013-08,5,55,0,0,19.375,-84.125,0,1,1
2013-08,5,56,0,0,19.375,-83.875,0,2,2
2013-08,5,57,0,0,19.375,-83.625,0,1,1
2013-08,5,69,0,0,19.375,-80.625,0,1,1
2013-08,7,20,0,0,19.875,-92.875,2,0,2
2013-08,8,19,0,0,20.125,-93.125,2,0,2
2013-08,8,20,0,0,20.125,-92.875,3,0,3
2013-08,8,57,0,0,20.125,-83.625,2,0,2
2013-08,8,58,0,0,20.125,-83.375,4,0,4
2013-08,9,8,0,0,20.375,-95.875,5,0,5
2013-08,9,19,0,0,20.375,-93.125,1,0,1
2013-08,9,20,0,0,20.375,-92.875,1,0,1
2013-08,10,8,0,0,20.625,-95.875,1,0,1
2013-08,10,9,0,0,20.625,-95.625,7,0,7
2013-08,10,10,0,0,20.625,-95.375,3,0,3
2013-08,10,69,0,0,20.625,-80.625,6,0,6
2013-08,10,70,0,0,20.625,-80.375,4,0,4
2013-08,10,71,0,0,20.625,-80.125,2,0,2
2013-08,11,67,0,0,20.875,-81.125,2,0,2
2013-08,11,68,0,0,20.875,-80.875,2,0,2
2013-08,15,9,0,0,21.875,-95.625,0,11,11
2013-08,15,11,0,0,21.875,-95.125,0,5,5
2013-08,16,9,0,0,22.125,-95.625,0,2,2
2013-08,16,10,0,0,22.125,-95.375,0,8,8
2013-08,16,11,0,0,22.125,-95.125,0,5,5
2013-08,22,6,0,0,23.625,-96.375,3,0,3
2013-08,23,55,0,0,23.875,-84.125,0,5,5
2013-08,23,64,0,0,23.875,-81.875,0,1,1
2013-08,23,65,0,0,23.875,-81.625,0,7,7
2013-08,23,66,0,0,23.875,-81.375,0,5,5
2013-08,24,54,0,0,24.125,-84.375,0,5,5
2013-08,24,66,0,0,24.125,-81.375,0,2,2
2013-08,24,67,0,0,24.125,-81.125,0,2,2
2013-08,25,10,0,0,24.375,-95.375,1,0,1
2013-08,25,11,0,0,24.375,-95.125,6,0,6
2013-08,25,53,0,0,24.375,-84.625,0,2,2
2013-08,25,54,0,0,24.375,-84.375,0,2,2
2013-08,26,11,0,0,24.625,-95.125,3,0,3
2013-08,26,12,0,0,24.625,-94.875,3,0,3
2013-08,26,13,0,0,24.625,-94.625,7,0,7
2013-08,26,45,0,0,24.625,-86.625,12,0,12
2013-08,26,53,0,0,24.625,-84.625,0,8,8
2013-08,27,14,0,0,24.875,-94.375,1,0,1
2013-08,27,15,0,0,24.875,-94.125,1,0,1
2013-08,27,16,0,0,24.875,-93.875,6,0,6
2013-08,27,17,0,0,24.875,-93.625,3,0,3
2013-08,27,45,0,0,24.875,-86.625,9,0,9
2013-08,27,53,0,0,24.875,-84.625,0,2,2
2013-08,27,54,0,0,24.875,-84.375,0,7,7
2013-08,28,21,1,1,25.125,-92.625,0,0,0
2013-08,28,45,0,0,25.125,-86.625,10,0,10
2013-08,29,28,0,0,25.375,-90.875,0,8,8
2013-08,29,29,0,0,25.375,-90.625,0,10,10
2013-08,30,11,2,1,25.625,-95.125,0,0,0
2013-08,30,24,1,1,25.625,-91.875,0,0,0
2013-08,30,31,0,0,25.625,-90.125,0,3,3
2013-08,31,12,1,1,25.875,-94.875,0,0,0
2013-08,31,19,1,1,25.875,-93.125,0,0,0
2013-08,32,14,1,1,26.125,-94.375,0,0,0
2013-08,32,21,1,1,26.125,-92.625,0,0,0
2013-08,33,10,0,0,26.375,-95.375,0,31,31
2013-08,33,15,1,1,26.375,-94.125,0,0,0
2013-08,33,22,1,1,26.375,-92.375,0,0,0
2013-08,34,12,2,1,26.625,-94.875,0,0,0
2013-08,34,13,2,1,26.625,-94.625,0,0,0
2013-08,34,14,1,1,26.625,-94.375,0,0,0
2013-08,34,15,1,1,26.625,-94.125,0,0,0
2013-08,34,16,1,1,26.625,-93.875,0,0,0
2013-08,35,11,2,1,26.875,-95.125,0,0,0
2013-08,35,12,3,1,26.875,-94.875,0,0,0
2013-08,35,13,1,1,26.875,-94.625,0,0,0
2013-08,35,16,1,1,26.875,-93.875,0,0,0
2013-08,36,12,2,1,27.125,-94.875,0,0,0
2013-08,36,13,1,1,27.125,-94.625,0,0,0
2013-08,36,14,1,1,27.125,-94.375,0,0,0
2013-08,36,15,1,1,27.125,-94.125,0,0,0
2013-08,36,16,2,1,27.125,-93.875,0,0,0
2013-08,38,34,1,1,27.625,-89.375,0,0,0
2013-08,38,35,1,1,27.625,-89.125,0,0,0
2013-08,39,34,2,1,27.875,-89.375,0,0,0
2013-08,39,35,6,1,27.875,-89.125,0,0,0
2013-08,39,36,3,1,27.875,-88.875,0,0,0
2013-08,39,37,1,1,27.875,-88.625,0,0,0
2013-08,39,39,1,1,27.875,-88.125,0,0,0
2013-08,39,46,0,0,27.875,-86.375,0,2,2
2013-08,39,48,0,0,27.875,-85.875,0,2,2
2013-08,40,35,1,1,28.125,-89.125,0,0,0
2013-08,40,36,1,1,28.125,-88.875,0,0,0
2013-08,40,37,2,1,28.125,-88.625,0,0,0
2013-08,40,38,2,1,28.125,-88.375,0,0,0
2013-08,40,45,0,0,28.125,-86.625,0,8,8
2013-08,40,46,0,0,28.125,-86.375,0,3,3
2013-08,40,47,0,0,28.125,-86.125,0,2,2
2013-08,41,36,2,1,28.375,-88.875,0,0,0
2013-08,41,38,3,1,28.375,-88.375,0,0,0
2013-08,41,39,3,1,28.375,-88.125,0,0,0
2013-08,41,45,0,0,28.375,-86.625,0,3,3
2013-08,42,36,1,1,28.625,-88.875,0,0,0
2013-08,42,37,2,1,28.625,-88.625,0,0,0
2013-08,42,45,0,0,28.625,-86.625,0,11,11
2013-08,44,47,8,1,29.125,-86.125,0,0,0
2013-08,45,46,15,1,29.375,-86.375,0,0,0
2013-08,45,47,6,1,29.375,-86.125,0,0,0
2013-08,45,48,1,1,29.375,-85.875,0,0,0
2013-09,4,53,0,0,19.125,-84.625,0,4,4
2013-09,5,24,1,1,19.375,-91.875,0,0,0
2013-09,5,50,0,0,19.375,-85.375,1,0,1
2013-09,5,51,0,0,19.375,-85.125,3,0,3
2013-09,5,52,0,0,19.375,-84.875,3,5,8
2013-09,5,53,0,0,19.375,-84.625,2,2,4
2013-09,5,54,0,0,19.375,-84.375,2,0,2
2013-09,6,49,0,0,19.625,-85.625,2,0,2
2013-09,6,50,0,0,19.625,-85.375,2,1,3
2013-09,6,51,0,0,19.625,-85.125,0,5,5
2013-09,6,54,0,0,19.625,-84.375,1,0,1
2013-09,6,55,0,0,19.625,-84.125,3,0,3
2013-09,6,56,0,0,19.625,-83.875,5,0,5
2013-09,6,62,0,0,19.625,-82.375,1,0,1
2013-09,6,63,0,0,19.625,-82.125,1,0,1
2013-09,7,10,0,0,19.875,-95.375,3,0,3
2013-09,7,11,0,0,19.875,-95.125,6,0,6
2013-09,7,50,0,0,19.875,-85.375,0,2,2
2013-09,7,51,0,0,19.875,-85.125,0,1,1
2013-09,7,57,0,0,19.875,-83.625,4,0,4
2013-09,7,62,0,0,19.875,-82.375,1,0,1
2013-09,8,11,0,0,20.125,-95.125,7,0,7
2013-09,8,12,0,0,20.125,-94.875,9,0,9
2013-09,8,19,0,0,20.125,-93.125,1,0,1
2013-09,8,20,0,0,20.125,-92.875,1,0,1
2013-09,8,51,0,0,20.125,-85.125,0,1,1
2013-09,8,57,0,0,20.125,-83.625,2,0,2
2013-09,8,63,0,0,20.125,-82.125,3,0,3
2013-09,8,65,0,0,20.125,-81.625,1,0,1
2013-09,8,66,0,0,20.125,-81.375,1,0,1
2013-09,9,14,0,0,20.375,-94.375,1,0,1
2013-09,9,19,0,0,20.375,-93.125,5,0,5
2013-09,9,20,1,1,20.375,-92.875,7,0,7
2013-09,9,21,0,0,20.375,-92.625,5,0,5
2013-09,9,22,0,0,20.375,-92.375,6,0,6
2013-09,9,54,0,0,20.375,-84.375,0,5,5
2013-09,9,63,0,0,20.375,-82.125,1,0,1
2013-09,9,64,0,0,20.375,-81.875,4,0,4
2013-09,9,65,0,0,20.375,-81.625,3,0,3
2013-09,9,66,0,0,20.375,-81.375,2,0,2
2013-09,10,22,0,0,20.625,-92.375,2,0,2
2013-09,10,53,0,0,20.625,-84.625,0,3,3
2013-09,10,65,0,0,20.625,-81.625,3,0,3
2013-09,10,66,0,0,20.625,-81.375,3,0,3
2013-09,11,66,0,0,20.875,-81.375,3,0,3
2013-09,11,67,0,0,20.875,-81.125,3,0,3
2013-09,12,6,0,0,21.125,-96.375,0,1,1
2013-09,12,18,1,1,21.125,-93.375,0,0,0
2013-09,13,6,0,0,21.375,-96.375,0,3,3
2013-09,13,7,0,0,21.375,-96.125,0,1,1
2013-09,14,7,0,0,21.625,-96.125,0,1,1
2013-09,14,8,0,0,21.625,-95.875,0,4,4
2013-09,14,9,0,0,21.625,-95.625,0,1,1
2013-09,14,12,0,0,21.625,-94.875,0,7,7
2013-09,15,9,0,0,21.875,-95.625,0,2,2
2013-09,17,22,1,1,22.375,-92.375,0,0,0
2013-09,20,25,1,1,23.125,-91.625,0,0,0
2013-09,20,41,0,0,23.125,-87.625,0,5,5
2013-09,21,40,0,0,23.375,-87.875,0,10,10
2013-09,21,41,0,0,23.375,-87.625,0,2,2
2013-09,22,39,0,0,23.625,-88.125,0,5,5
2013-09,22,40,0,0,23.625,-87.875,0,5,5
2013-09,23,39,0,0,23.875,-88.125,0,2,2
2013-09,23,63,0,0,23.875,-82.125,1,0,1
2013-09,23,64,0,0,23.875,-81.875,5,0,5
2013-09,23,65,0,0,23.875,-81.625,7,0,7
2013-09,24,24,1,1,24.125,-91.875,0,0,0
2013-09,24,54,0,0,24.125,-84.375,0,9,9
2013-09,24,55,0,0,24.125,-84.125,0,10,10
2013-09,24,66,0,0,24.125,-81.375,3,0,3
2013-09,24,67,0,0,24.125,-81.125,4,0,4
2013-09,24,68,0,0,24.125,-80.875,3,1,4
2013-09,24,69,0,0,24.125,-80.625,0,4,4
2013-09,25,9,0,0,24.375,-95.625,3,0,3
2013-09,25,10,0,0,24.375,-95.375,16,0,16
2013-09,25,69,0,0,24.375,-80.625,2,5,7
2013-09,26,20,1,1,24.625,-92.875,0,0,0
2013-09,26,54,0,0,24.625,-84.375,0,4,4
2013-09,27,10,0,0,24.875,-95.375,11,0,11
2013-09,27,54,0,0,24.875,-84.375,0,5,5
2013-09,27,55,0,0,24.875,-84.125,0,2,2
2013-09,28,16,1,1,25.125,-93.875,0,0,0
2013-09,28,23,0,0,25.125,-92.125,0,1,1
2013-09,28,24,0,0,25.125,-91.875,0,2,2
2013-09,29,13,2,1,25.375,-94.625,0,0,0
2013-09,29,14,1,1,25.375,-94.375,0,0,0
2013-09,29,24,0,0,25.375,-91.875,0,6,6
2013-09,29,25,0,0,25.375,-91.625,0,6,6
2013-09,29,26,0,0,25.375,-91.375,0,7,7
2013-09,29,27,0,0,25.375,-91.125,0,8,8
2013-09,29,43,0,0,25.375,-87.125,4,0,4
2013-09,29,44,0,0,25.375,-86.875,10,0,10
2013-09,29,45,0,0,25.375,-86.625,8,0,8
2013-09,30,11,1,1,25.625,-95.125,0,0,0
2013-09,30,12,1,1,25.625,-94.875,0,0,0
2013-09,30,43,0,0,25.625,-87.125,6,0,6
2013-09,30,44,0,0,25.625,-86.875,2,0,2
2013-09,31,10,4,1,25.875,-95.375,0,0,0
2013-09,31,12,3,1,25.875,-94.875,0,0,0
2013-09,32,10,1,1,26.125,-95.375,0,0,0
2013-09,32,11,1,1,26.125,-95.125,0,0,0
2013-09,33,8,0,0,26.375,-95.875,0,5,5
2013-09,33,9,0,0,26.375,-95.625,0,18,18
2013-09,33,10,4,1,26.375,-95.375,0,3,3
2013-09,37,31,1,1,27.375,-90.125,0,0,0
2013-09,37,32,3,1,27.375,-89.875,0,0,0
2013-09,37,33,1,1,27.375,-89.625,0,0,0
2013-09,37,34,1,1,27.375,-89.375,0,0,0
2013-09,37,35,8,1,27.375,-89.125,0,0,0
2013-09,37,36,2,1,27.375,-88.875,0,0,0
2013-09,37,37,5,1,27.375,-88.625,0,0,0
2013-09,38,31,1,1,27.625,-90.125,0,0,0
2013-09,38,32,1,1,27.625,-89.875,0,0,0
2013-09,38,33,2,1,27.625,-89.625,0,0,0
2013-09,38,34,2,1,27.625,-89.375,0,0,0
2013-09,38,35,1,1,27.625,-89.125,0,0,0
2013-09,38,36,2,1,27.625,-88.875,0,0,0
2013-09,42,42,0,0,28.625,-87.375,0,16,16
2013-09,42,43,0,0,28.625,-87.125,0,2,2
2013-09,42,44,0,0,28.625,-86.875,0,4,4
2013-09,42,45,0,0,28.625,-86.625,0,8,8
2013-09,44,39,1,1,29.125,-88.125,0,0,0
2013-10,3,52,0,0,18.875,-84.875,1,0,1
2013-10,3,53,0,0,18.875,-84.625,3,0,3
2013-10,3,54,0,0,18.875,-84.375,2,0,2
2013-10,3,55,0,0,18.875,-84.125,3,0,3
2013-10,3,56,0,0,18.875,-83.875,1,0,1
2013-10,3,57,0,0,18.875,-83.625,1,0,1
2013-10,4,57,0,0,19.125,-83.625,1,0,1
2013-10,4,58,0,0,19.125,-83.375,2,0,2
2013-10,4,59,0,0,19.125,-83.125,2,0,2
2013-10,4,60,0,0,19.125,-82.875,1,0,1
2013-10,5,60,0,0,19.375,-82.875,1,0,1
2013-10,5,61,0,0,19.375,-82.625,4,0,4
2013-10,6,45,0,0,19.625,-86.625,0,1,1
2013-10,6,46,0,0,19.625,-86.375,0,2,2
2013-10,6,47,0,0,19.625,-86.125,0,1,1
2013-10,6,49,0,0,19.625,-85.625,1,0,1
2013-10,6,62,0,0,19.625,-82.375,5,0,5
2013-10,6,63,0,0,19.625,-82.125,3,0,3
2013-10,7,45,0,0,19.875,-86.625,0,1,1
2013-10,7,46,0,0,19.875,-86.375,0,1,1
2013-10,7,48,0,0,19.875,-85.875,6,1,7
2013-10,7,62,0,0,19.875,-82.375,1,0,1
2013-10,8,47,0,0,20.125,-86.125,4,0,4
2013-10,8,48,0,0,20.125,-85.875,0,2,2
2013-10,8,49,0,0,20.125,-85.625,0,2,2
2013-10,8,50,0,0,20.125,-85.375,0,3,3
2013-10,8,51,0,0,20.125,-85.125,0,3,3
2013-10,8,52,0,0,20.125,-84.875,0,2,2
2013-10,8,53,0,0,20.125,-84.625,0,2,2
2013-10,8,54,0,0,20.125,-84.375,0,3,3
2013-10,9,14,0,0,20.375,-94.375,5,0,5
2013-10,9,47,0,0,20.375,-86.125,1,0,1
2013-10,9,52,0,0,20.375,-84.875,0,2,2
2013-10,9,53,0,0,20.375,-84.625,0,2,2
2013-10,9,54,0,0,20.375,-84.375,0,1,1
2013-10,10,14,0,0,20.625,-94.375,3,0,3
2013-10,10,15,0,0,20.625,-94.125,3,0,3
2013-10,10,66,0,0,20.625,-81.375,4,0,4
2013-10,10,67,0,0,20.625,-81.125,5,0,5
2013-10,12,9,0,0,21.125,-95.625,0,6,6
2013-10,12,10,0,0,21.125,-95.375,0,6,6
2013-10,12,11,0,0,21.125,-95.125,0,2,2
2013-10,13,11,0,0,21.375,-95.125,0,2,2
2013-10,13,12,0,0,21.375,-94.875,0,10,10
2013-10,20,41,0,0,23.125,-87.625,0,3,3
2013-10,23,62,0,0,23.875,-82.375,19,0,19
2013-10,23,63,0,0,23.875,-82.125,4,0,4
2013-10,24,54,0,0,24.125,-84.375,0,14,14
2013-10,24,62,0,0,24.125,-82.375,2,0,2
2013-10,24,63,0,0,24.125,-82.125,1,0,1
2013-10,25,54,0,0,24.375,-84.375,0,4,4
2013-10,26,9,0,0,24.625,-95.625,21,0,21
2013-10,26,10,0,0,24.625,-95.375,9,0,9
2013-10,26,20,0,0,24.625,-92.875,0,1,1
2013-10,26,54,0,0,24.625,-84.375,0,5,5
2013-10,26,70,0,0,24.625,-80.375,2,0,2
2013-10,27,10,0,0,24.875,-95.375,1,0,1
2013-10,27,19,0,0,24.875,-93.125,0,2,2
2013-10,27,20,0,0,24.875,-92.875,0,6,6
2013-10,27,21,0,0,24.875,-92.625,0,7,7
2013-10,27,22,0,0,24.875,-92.375,0,2,2
2013-10,27,44,0,0,24.875,-86.875,12,0,12
2013-10,27,45,0,0,24.875,-86.625,5,0,5
2013-10,27,54,0,0,24.875,-84.375,0,7,7
2013-10,27,55,0,0,24.875,-84.125,0,1,1
2013-10,27,71,0,0,24.875,-80.125,1,0,1
2013-10,28,22,0,0,25.125,-92.375,0,5,5
2013-10,28,23,0,0,25.125,-92.125,0,8,8
2013-10,28,44,0,0,25.125,-86.875,4,0,4
2013-10,28,45,0,0,25.125,-86.625,10,0,10
2013-10,29,10,1,1,25.375,-95.375,0,0,0
2013-10,29,31,0,0,25.375,-90.125,3,0,3
2013-10,30,11,1,1,25.625,-95.125,0,0,0
2013-10,30,31,0,0,25.625,-90.125,9,0,9
2013-10,30,32,0,0,25.625,-89.875,4,0,4
2013-10,32,15,1,1,26.125,-94.125,0,0,0
2013-10,35,18,1,1,26.875,-93.375,0,0,0
2013-10,36,21,1,1,27.125,-92.625,0,0,0
2013-10,36,24,1,1,27.125,-91.875,0,0,0
2013-10,37,27,1,1,27.375,-91.125,0,0,0
2013-10,37,30,1,1,27.375,-90.375,0,0,0
2013-10,37,31,1,1,27.375,-90.125,0,0,0
2013-10,38,32,1,1,27.625,-89.875,0,0,0
2013-10,38,33,2,1,27.625,-89.625,0,0,0
2013-10,38,34,1,1,27.625,-89.375,0,0,0
2013-10,38,35,1,1,27.625,-89.125,0,0,0
2013-10,39,35,6,1,27.875,-89.125,0,0,0
2013-10,39,36,4,1,27.875,-88.875,0,0,0
2013-10,39,37,1,1,27.875,-88.625,0,0,0
2013-10,39,43,0,0,27.875,-87.125,0,2,2
2013-10,40,36,2,1,28.125,-88.875,0,0,0
2013-10,40,37,2,1,28.125,-88.625,0,0,0
2013-10,40,38,2,1,28.125,-88.375,0,0,0
2013-10,41,41,0,0,28.375,-87.625,0,1,1
2013-10,42,41,0,0,28.625,-87.625,0,1,1
2013-10,42,42,0,0,28.625,-87.375,0,5,5
2013-11,3,50,0,0,18.875,-85.375,2,0,2
2013-11,3,51,0,0,18.875,-85.125,1,0,1
2013-11,3,52,0,0,18.875,-84.875,1,0,1
2013-11,3,54,0,0,18.875,-84.375,4,0,4
2013-11,4,49,0,0,19.125,-85.625,1,0,1
2013-11,4,50,0,0,19.125,-85.375,1,0,1
2013-11,6,47,0,0,19.625,-86.125,3,0,3
2013-11,6,48,0,0,19.625,-85.875,1,0,1
2013-11,7,47,0,0,19.875,-86.125,2,0,2
2013-11,7,59,0,0,19.875,-83.125,1,0,1
2013-11,7,60,0,0,19.875,-82.875,2,0,2
2013-11,7,71,0,0,19.875,-80.125,0,3,3
2013-11,8,47,0,0,20.125,-86.125,5,0,5
2013-11,8,60,0,0,20.125,-82.875,1,0,1
2013-11,8,61,0,0,20.125,-82.625,4,0,4
2013-11,8,62,0,0,20.125,-82.375,4,0,4
2013-11,8,70,0,0,20.125,-80.375,0,1,1
2013-11,8,71,0,0,20.125,-80.125,0,7,7
2013-11,9,13,0,0,20.375,-94.625,1,0,1
2013-11,9,14,0,0,20.375,-94.375,5,0,5
2013-11,9,47,0,0,20.375,-86.125,2,0,2
2013-11,9,63,0,0,20.375,-82.125,4,0,4
2013-11,9,64,0,0,20.375,-81.875,2,0,2
2013-11,9,70,0,0,20.375,-80.375,0,5,5
2013-11,9,71,0,0,20.375,-80.125,0,2,2
2013-11,10,14,0,0,20.625,-94.375,10,0,10
2013-11,10,15,0,0,20.625,-94.125,4,0,4
2013-11,10,48,0,0,20.625,-85.875,3,0,3
2013-11,10,65,0,0,20.625,-81.625,4,0,4
2013-11,10,66,0,0,20.625,-81.375,4,0,4
2013-11,11,14,0,0,20.875,-94.375,4,0,4
2013-11,11,15,0,0,20.875,-94.125,1,0,1
2013-11,11,49,0,0,20.875,-85.625,2,0,2
2013-11,11,50,0,0,20.875,-85.375,1,0,1
2013-11,12,16,0,0,21.125,-93.875,3,0,3
2013-11,12,50,0,0,21.125,-85.375,5,0,5
2013-11,13,16,0,0,21.375,-93.875,1,0,1
2013-11,21,3,5,1,23.375,-97.125,0,0,0
2013-11,21,4,3,1,23.375,-96.875,0,0,0
2013-11,22,3,3,1,23.625,-97.125,0,0,0
2013-11,22,4,4,1,23.625,-96.875,0,0,0
2013-11,22,5,5,1,23.625,-96.625,0,0,0
2013-11,23,4,1,1,23.875,-96.875,0,0,0
2013-11,23,55,0,0,23.875,-84.125,0,8,8
2013-11,23,63,0,0,23.875,-82.125,3,0,3
2013-11,23,64,0,0,23.875,-81.875,1,0,1
2013-11,23,66,0,0,23.875,-81.375,14,0,14
2013-11,23,67,0,0,23.875,-81.125,2,0,2
2013-11,24,5,1,1,24.125,-96.625,0,0,0
2013-11,24,6,1,1,24.125,-96.375,0,0,0
2013-11,24,63,0,0,24.125,-82.125,2,0,2
2013-11,25,6,3,1,24.375,-96.375,0,0,0
2013-11,25,7,1,1,24.375,-96.125,0,0,0
2013-11,25,54,0,0,24.375,-84.375,0,1,1
2013-11,26,8,0,0,24.625,-95.875,9,0,9
2013-11,26,9,1,1,24.625,-95.625,0,0,0
2013-11,26,18,0,0,24.625,-93.375,0,3,3
2013-11,26,54,0,0,24.625,-84.375,0,7,7
2013-11,26,55,0,0,24.625,-84.125,0,9,9
2013-11,27,6,0,0,24.875,-96.375,1,0,1
2013-11,27,7,0,0,24.875,-96.125,13,0,13
2013-11,27,8,1,1,24.875,-95.875,4,0,4
2013-11,27,13,0,0,24.875,-94.625,0,2,2
2013-11,27,14,0,0,24.875,-94.375,0,6,6
2013-11,27,15,0,0,24.875,-94.125,0,6,6
2013-11,27,16,0,0,24.875,-93.875,0,4,4
2013-11,27,17,0,0,24.875,-93.625,0,4,4
2013-11,27,18,0,0,24.875,-93.375,0,1,1
2013-11,27,19,0,0,24.875,-93.125,0,4,4
2013-11,27,55,0,0,24.875,-84.125,0,5,5
2013-11,28,9,1,1,25.125,-95.625,0,0,0
2013-11,28,31,0,0,25.125,-90.125,12,0,12
2013-11,28,32,0,0,25.125,-89.875,7,0,7
2013-11,28,45,0,0,25.125,-86.625,21,0,21
2013-11,29,7,0,0,25.375,-96.125,3,0,3
2013-11,29,31,0,0,25.375,-90.125,6,0,6
2013-11,29,32,0,0,25.375,-89.875,3,0,3
2013-11,29,45,0,0,25.375,-86.625,9,0,9
2013-11,38,42,0,0,27.625,-87.375,0,2,2
2013-11,38,43,0,0,27.625,-87.125,0,9,9
2013-11,39,41,0,0,27.875,-87.625,0,2,2
2013-11,39,42,0,0,27.875,-87.375,0,5,5
2013-11,39,43,0,0,27.875,-87.125,0,12,12
2013-12,0,67,0,0,18.125,-81.125,1,0,1
2013-12,0,68,0,0,18.125,-80.875,2,0,2
2013-12,1,66,0,0,18.375,-81.375,3,0,3
2013-12,1,67,0,0,18.375,-81.125,1,0,1
2013-12,3,54,0,0,18.875,-84.375,4,0,4
2013-12,4,54,0,0,19.125,-84.375,4,0,4
2013-12,5,49,0,0,19.375,-85.625,4,0,4
2013-12,5,50,0,0,19.375,-85.375,5,0,5
2013-12,5,51,0,0,19.375,-85.125,5,0,5
2013-12,5,52,0,0,19.375,-84.875,3,0,3
2013-12,5,53,0,0,19.375,-84.625,4,0,4
2013-12,7,68,0,0,19.875,-80.875,0,1,1
2013-12,7,69,0,0,19.875,-80.625,0,3,3
2013-12,7,70,0,0,19.875,-80.375,0,1,1
2013-12,8,68,0,0,20.125,-80.875,0,3,3
2013-12,8,69,0,0,20.125,-80.625,0,6,6
2013-12,8,70,0,0,20.125,-80.375,0,4,4
2013-12,8,71,0,0,20.125,-80.125,0,5,5
2013-12,12,22,0,0,21.125,-92.375,0,3,3
2013-12,12,51,0,0,21.125,-85.125,1,0,1
2013-12,13,14,0,0,21.375,-94.375,1,0,1
2013-12,13,15,0,0,21.375,-94.125,4,0,4
2013-12,13,16,0,0,21.375,-93.875,2,0,2
2013-12,13,21,0,0,21.375,-92.625,0,4,4
2013-12,13,22,0,0,21.375,-92.375,0,3,3
2013-12,14,13,0,0,21.625,-94.625,1,0,1
2013-12,14,14,0,0,21.625,-94.375,12,0,12
2013-12,15,13,0,0,21.875,-94.625,7,0,7
2013-12,15,14,0,0,21.875,-94.375,1,0,1
2013-12,22,4,3,1,23.625,-96.875,0,0,0
2013-12,22,5,3,1,23.625,-96.625,0,0,0
2013-12,22,6,3,1,23.625,-96.375,0,0,0
2013-12,23,6,1,1,23.875,-96.375,0,0,0
2013-12,23,7,1,1,23.875,-96.125,0,0,0
2013-12,23,52,0,0,23.875,-84.875,0,1,1
2013-12,23,53,0,0,23.875,-84.625,0,4,4
2013-12,23,54,0,0,23.875,-84.375,0,4,4
2013-12,23,55,0,0,23.875,-84.125,0,5,5
2013-12,23,63,0,0,23.875,-82.125,13,0,13
2013-12,23,64,0,0,23.875,-81.875,4,0,4
2013-12,23,66,0,0,23.875,-81.375,1,0,1
2013-12,24,8,1,1,24.125,-95.875,0,0,0
2013-12,24,51,0,0,24.125,-85.125,0,10,10
2013-12,24,52,0,0,24.125,-84.875,0,7,7
2013-12,24,69,0,0,24.125,-80.625,1,0,1
2013-12,24,70,0,0,24.125,-80.375,2,0,2
2013-12,25,7,1,1,24.375,-96.125,0,0,0
2013-12,25,71,0,0,24.375,-80.125,1,0,1
2013-12,26,7,1,1,24.625,-96.125,0,0,0
2013-12,28,6,0,0,25.125,-96.375,2,0,2
2013-12,28,7,1,1,25.125,-96.125,0,0,0
2013-12,28,13,0,0,25.125,-94.625,0,9,9
2013-12,29,7,0,0,25.375,-96.125,3,0,3
2013-12,29,13,0,0,25.375,-94.625,0,12,12
2013-12,29,32,0,0,25.375,-89.875,1,0,1
2013-12,29,45,0,0,25.375,-86.625,4,0,4
2013-12,30,7,0,0,25.625,-96.125,1,0,1
2013-12,30,13,0,0,25.625,-94.625,0,10,10
2013-12,30,43,0,0,25.625,-87.125,5,0,5
2013-12,30,44,0,0,25.625,-86.875,21,0,21
2013-12,30,45,0,0,25.625,-86.625,1,0,1
2013-12,31,10,1,1,25.875,-95.375,0,0,0
2013-12,32,27,0,0,26.125,-91.125,15,0,15
2013-12,32,28,0,0,26.125,-90.875,4,0,4
2013-12,33,12,1,1,26.375,-94.875,0,0,0
2013-12,33,29,0,0,26.375,-90.625,4,0,4
2013-12,34,9,0,0,26.625,-95.625,4,0,4
2013-12,35,9,0,0,26.875,-95.625,5,0,5
2013-12,35,10,0,0,26.875,-95.375,1,0,1
2013-12,35,13,1,1,26.875,-94.625,0,0,0
2013-12,36,9,0,0,27.125,-95.625,1,0,1
2013-12,36,10,0,0,27.125,-95.375,1,0,1
2013-12,37,10,0,0,27.375,-95.375,3,0,3
2013-12,37,15,1,1,27.375,-94.125,0,0,0
2013-12,38,16,1,1,27.625,-93.875,0,0,0
2013-12,39,39,0,0,27.875,-88.125,0,5,5
2013-12,39,40,0,0,27.875,-87.875,0,3,3
2013-12,40,38,0,0,28.125,-88.375,0,1,1
2013-12,40,39,0,0,28.125,-88.125,0,9,9
2013-12,40,40,0,0,28.125,-87.875,0,10,10
2013-12,40,41,0,0,28.125,-87.625,0,2,2
2013-12,41,40,0,0,28.375,-87.875,0,1,1
2014-01,0,47,0,0,18.125,-86.125,0,3,3
2014-01,0,48,0,0,18.125,-85.875,0,1,1
2014-01,0,49,0,0,18.125,-85.625,0,2,2
2014-01,0,50,0,0,18.125,-85.375,0,3,3
2014-01,0,51,0,0,18.125,-85.125,0,3,3
2014-01,0,52,0,0,18.125,-84.875,0,3,3
2014-01,0,53,0,0,18.125,-84.625,0,1,1
2014-01,1,48,0,0,18.375,-85.875,0,3,3
2014-01,1,49,0,0,18.375,-85.625,0,1,1
2014-01,1,65,0,0,18.375,-81.625,2,0,2
2014-01,1,66,0,0,18.375,-81.375,1,0,1
2014-01,2,63,0,0,18.625,-82.125,2,0,2
2014-01,2,64,0,0,18.625,-81.875,4,0,4
2014-01,2,65,0,0,18.625,-81.625,1,0,1
2014-01,3,45,0,0,18.875,-86.625,2,0,2
2014-01,3,46,0,0,18.875,-86.375,1,0,1
2014-01,3,62,0,0,18.875,-82.375,1,2,3
2014-01,3,70,0,0,18.875,-80.375,0,4,4
2014-01,3,71,0,0,18.875,-80.125,0,6,6
2014-01,4,64,0,0,19.125,-81.875,0,4,4
2014-01,4,65,0,0,19.125,-81.625,0,3,3
2014-01,4,66,0,0,19.125,-81.375,0,2,2
2014-01,4,67,0,0,19.125,-81.125,0,3,3
2014-01,4,68,0,0,19.125,-80.875,0,4,4
2014-01,5,45,0,0,19.375,-86.625,1,0,1
2014-01,5,46,0,0,19.375,-86.375,2,0,2
2014-01,5,59,0,0,19.375,-83.125,1,0,1
2014-01,5,68,0,0,19.375,-80.875,0,1,1
2014-01,6,57,0,0,19.625,-83.625,1,0,1
2014-01,6,58,0,0,19.625,-83.375,1,0,1
2014-01,7,46,0,0,19.875,-86.375,1,0,1
2014-01,8,47,0,0,20.125,-86.125,2,0,2
2014-01,9,46,0,0,20.375,-86.375,4,0,4
2014-01,9,47,0,0,20.375,-86.125,1,0,1
2014-01,9,67,0,0,20.375,-81.125,0,1,1
2014-01,10,67,0,0,20.625,-81.125,0,1,1
2014-01,11,18,0,0,20.875,-93.375,0,1,1
2014-01,11,19,0,0,20.875,-93.125,0,1,1
2014-01,12,18,0,0,21.125,-93.375,0,1,1
2014-01,12,19,0,0,21.125,-93.125,0,3,3
2014-01,12,20,0,0,21.125,-92.875,0,1,1
2014-01,13,18,0,0,21.375,-93.375,0,1,1
2014-01,13,21,0,0,21.375,-92.625,0,1,1
2014-01,13,22,0,0,21.375,-92.375,0,2,2
2014-01,14,12,0,0,21.625,-94.875,1,0,1
2014-01,14,13,0,0,21.625,-94.625,4,0,4
2014-01,14,18,0,0,21.625,-93.375,0,4,4
2014-01,14,19,0,0,21.625,-93.125,0,1,1
2014-01,14,20,0,0,21.625,-92.875,0,2,2
2014-01,14,21,0,0,21.625,-92.625,0,2,2
2014-01,14,22,0,0,21.625,-92.375,0,1,1
2014-01,14,23,0,0,21.625,-92.125,0,3,3
2014-01,14,24,0,0,21.625,-91.875,0,3,3
2014-01,15,12,0,0,21.875,-94.875,8,0,8
2014-01,15,18,0,0,21.875,-93.375,0,1,1
2014-01,15,19,0,0,21.875,-93.125,0,1,1
2014-01,15,20,0,0,21.875,-92.875,0,1,1
2014-01,16,12,0,0,22.125,-94.875,4,0,4
2014-01,17,10,0,0,22.375,-95.375,3,0,3
2014-01,17,11,0,0,22.375,-95.125,6,0,6
2014-01,17,12,0,0,22.375,-94.875,4,0,4
2014-01,24,48,0,0,24.125,-85.875,0,4,4
2014-01,24,49,0,0,24.125,-85.625,0,4,4
2014-01,24,51,0,0,24.125,-85.125,0,8,8
2014-01,25,51,0,0,24.375,-85.125,0,12,12
2014-01,29,12,0,0,25.375,-94.875,0,14,14
2014-01,29,13,0,0,25.375,-94.625,0,11,11
2014-01,30,13,0,0,25.625,-94.625,0,6,6
2014-01,30,44,0,0,25.625,-86.875,4,0,4
2014-01,31,26,0,0,25.875,-91.375,1,0,1
2014-01,31,27,0,0,25.875,-91.125,20,0,20
2014-01,31,28,0,0,25.875,-90.875,2,0,2
2014-01,31,43,0,0,25.875,-87.125,11,0,11
2014-01,31,44,0,0,25.875,-86.875,16,0,16
2014-01,32,26,0,0,26.125,-91.375,5,0,5
2014-01,32,27,0,0,26.125,-91.125,1,0,1
2014-01,35,20,0,0,26.875,-92.875,0,3,3
2014-01,36,11,0,0,27.125,-95.125,3,0,3
2014-01,36,12,0,0,27.125,-94.875,6,0,6
2014-01,36,13,0,0,27.125,-94.625,1,0,1
2014-01,36,14,0,0,27.125,-94.375,1,0,1
2014-01,36,15,0,0,27.125,-94.125,1,0,1
2014-01,36,20,0,0,27.125,-92.875,0,4,4
2014-01,37,18,0,0,27.375,-93.375,0,4,4
2014-01,37,19,0,0,27.375,-93.125,0,7,7
2014-01,37,20,0,0,27.375,-92.875,0,4,4
2014-01,38,19,0,0,27.625,-93.125,0,4,4
2014-01,38,35,0,0,27.625,-89.125,0,1,1
2014-01,38,36,0,0,27.625,-88.875,0,6,6
2014-01,38,37,0,0,27.625,-88.625,0,4,4
2014-01,39,37,0,0,27.875,-88.625,0,1,1
2014-01,39,38,0,0,27.875,-88.375,0,15,15
2014-01,39,39,0,0,27.875,-88.125,0,4,4
2014-02,0,46,0,0,18.125,-86.375,0,5,5
2014-02,0,47,0,0,18.125,-86.125,0,1,1
2014-02,0,48,0,0,18.125,-85.875,0,1,1
2014-02,0,53,0,0,18.125,-84.625,3,0,3
2014-02,0,54,0,0,18.125,-84.375,2,0,2
2014-02,0,55,0,0,18.125,-84.125,1,0,1
2014-02,0,68,0,0,18.125,-80.875,3,0,3
2014-02,1,46,0,0,18.375,-86.375,0,2,2
2014-02,1,47,0,0,18.375,-86.125,0,3,3
2014-02,1,49,0,0,18.375,-85.625,0,1,1
2014-02,1,50,0,0,18.375,-85.375,0,1,1
2014-02,1,69,0,0,18.375,-80.625,1,0,1
2014-02,2,47,0,0,18.625,-86.125,0,1,1
2014-02,2,48,0,0,18.625,-85.875,0,2,2
2014-02,2,71,0,0,18.625,-80.125,2,0,2
2014-02,3,46,0,0,18.875,-86.375,0,4,4
2014-02,3,47,0,0,18.875,-86.125,0,3,3
2014-02,3,60,0,0,18.875,-82.875,0,1,1
2014-02,3,61,0,0,18.875,-82.625,0,1,1
2014-02,3,62,0,0,18.875,-82.375,0,2,2
2014-02,4,58,0,0,19.125,-83.375,0,2,2
2014-02,4,59,0,0,19.125,-83.125,0,1,1
2014-02,6,63,0,0,19.625,-82.125,0,1,1
2014-02,7,60,0,0,19.875,-82.875,0,3,3
2014-02,7,61,0,0,19.875,-82.625,0,3,3
2014-02,7,62,0,0,19.875,-82.375,0,3,3
2014-02,7,63,0,0,19.875,-82.125,0,1,1
2014-02,9,61,0,0,20.375,-82.625,0,1,1
2014-02,10,62,0,0,20.625,-82.375,0,5,5
2014-02,10,63,0,0,20.625,-82.125,0,1,1
2014-02,10,66,0,0,20.625,-81.375,0,3,3
2014-02,10,67,0,0,20.625,-81.125,0,1,1
2014-02,10,68,0,0,20.625,-80.875,1,0,1
2014-02,10,69,0,0,20.625,-80.625,3,0,3
2014-02,10,70,0,0,20.625,-80.375,2,0,2
2014-02,11,69,0,0,20.875,-80.625,1,0,1
2014-02,13,67,0,0,21.375,-81.125,7,0,7
2014-02,13,68,0,0,21.375,-80.875,5,0,5
2014-02,14,16,0,0,21.625,-93.875,0,4,4
2014-02,14,17,0,0,21.625,-93.625,0,6,6
2014-02,14,18,0,0,21.625,-93.375,0,9,9
2014-02,15,16,0,0,21.875,-93.875,0,6,6
2014-02,15,18,0,0,21.875,-93.375,0,3,3
2014-02,16,8,0,0,22.125,-95.875,6,0,6
2014-02,16,9,0,0,22.125,-95.625,3,0,3
2014-02,17,9,0,0,22.375,-95.625,12,0,12
2014-02,17,10,0,0,22.375,-95.375,3,0,3
2014-02,18,9,0,0,22.625,-95.625,4,0,4
2014-02,21,25,0,0,23.375,-91.625,0,6,6
2014-02,22,34,0,0,23.625,-89.375,0,3,3
2014-02,23,35,0,0,23.875,-89.125,0,7,7
2014-02,24,48,0,0,24.125,-85.875,0,4,4
2014-02,24,49,0,0,24.125,-85.625,0,7,7
2014-02,25,48,0,0,24.375,-85.875,0,6,6
2014-02,26,47,0,0,24.625,-86.125,0,1,1
2014-02,26,48,0,0,24.625,-85.875,0,2,2
2014-02,27,46,0,0,24.875,-86.375,0,1,1
2014-02,27,47,0,0,24.875,-86.125,0,4,4
2014-02,27,53,0,0,24.875,-84.625,1,0,1
2014-02,28,46,0,0,25.125,-86.375,0,1,1
2014-02,28,47,0,0,25.125,-86.125,0,2,2
2014-02,28,53,0,0,25.125,-84.625,2,0,2
2014-02,29,12,0,0,25.375,-94.875,0,28,28
2014-02,29,53,0,0,25.375,-84.625,5,0,5
2014-02,30,40,0,0,25.625,-87.875,7,0,7
2014-02,30,41,0,0,25.625,-87.625,9,0,9
2014-02,30,52,0,0,25.625,-84.875,3,0,3
2014-02,30,53,0,0,25.625,-84.625,5,0,5
2014-02,31,40,0,0,25.875,-87.875,6,0,6
2014-02,31,44,0,0,25.875,-86.875,3,0,3
2014-02,31,50,0,0,25.875,-85.375,2,0,2
2014-02,31,51,0,0,25.875,-85.125,3,0,3
2014-02,31,52,0,0,25.875,-84.875,3,0,3
2014-02,32,40,0,0,26.125,-87.875,1,0,1
2014-02,37,17,0,0,27.375,-93.625,0,3,3
2014-02,37,18,0,0,27.375,-93.375,0,2,2
2014-02,38,35,0,0,27.625,-89.125,0,4,4
2014-02,38,36,0,0,27.625,-88.875,0,4,4
2014-02,39,34,0,0,27.875,-89.375,0,4,4
2014-02,39,35,0,0,27.875,-89.125,0,16,16
2014-02,41,49,0,0,28.375,-85.625,2,0,2
2014-02,41,50,0,0,28.375,-85.375,3,0,3
2014-02,42,49,0,0,28.625,-85.625,5,0,5
2014-02,42,50,0,0,28.625,-85.375,2,0,2
2014-02,43,48,0,0,28.875,-85.875,1,0,1
2014-02,43,49,0,0,28.875,-85.625,1,0,1
2014-03,3,45,0,0,18.875,-86.625,0,1,1
2014-03,3,46,0,0,18.875,-86.375,0,1,1
2014-03,4,45,0,0,19.125,-86.625,0,3,3
2014-03,5,45,0,0,19.375,-86.625,0,3,3
2014-03,5,65,0,0,19.375,-81.625,0,5,5
2014-03,6,12,0,0,19.625,-94.875,4,0,4
2014-03,6,63,0,0,19.625,-82.125,0,3,3
2014-03,6,64,0,0,19.625,-81.875,0,2,2
2014-03,6,65,0,0,19.625,-81.625,0,1,1
2014-03,7,12,0,0,19.875,-94.875,8,0,8
2014-03,7,13,0,0,19.875,-94.625,3,0,3
2014-03,7,58,0,0,19.875,-83.375,0,3,3
2014-03,7,59,0,0,19.875,-83.125,0,3,3
2014-03,8,11,0,0,20.125,-95.125,2,0,2
2014-03,8,13,0,0,20.125,-94.625,4,0,4
2014-03,8,53,0,0,20.125,-84.625,1,0,1
2014-03,8,58,0,0,20.125,-83.375,0,4,4
2014-03,8,59,0,0,20.125,-83.125,0,1,1
2014-03,9,13,0,0,20.375,-94.625,2,0,2
2014-03,9,14,0,0,20.375,-94.375,1,0,1
2014-03,9,53,0,0,20.375,-84.625,1,0,1
2014-03,9,59,0,0,20.375,-83.125,0,9,9
2014-03,9,67,0,0,20.375,-81.125,4,0,4
2014-03,9,68,0,0,20.375,-80.875,1,0,1
2014-03,10,13,0,0,20.625,-94.625,1,0,1
2014-03,10,14,0,0,20.625,-94.375,3,0,3
2014-03,10,52,0,0,20.625,-84.875,11,0,11
2014-03,10,53,0,0,20.625,-84.625,2,0,2
2014-03,10,67,0,0,20.625,-81.125,7,0,7
2014-03,10,68,0,0,20.625,-80.875,11,0,11
2014-03,11,52,0,0,20.875,-84.875,6,0,6
2014-03,11,67,0,0,20.875,-81.125,2,0,2
2014-03,11,68,0,0,20.875,-80.875,6,0,6
2014-03,12,52,0,0,21.125,-84.875,2,0,2
2014-03,15,15,0,0,21.875,-94.125,0,6,6
2014-03,15,16,0,0,21.875,-93.875,0,1,1
2014-03,16,13,0,0,22.125,-94.625,0,4,4
2014-03,16,14,0,0,22.125,-94.375,0,7,7
2014-03,16,15,0,0,22.125,-94.125,0,2,2
2014-03,17,12,0,0,22.375,-94.875,0,3,3
2014-03,17,13,0,0,22.375,-94.625,0,5,5
2014-03,18,11,0,0,22.625,-95.125,0,2,2
2014-03,18,12,0,0,22.625,-94.875,0,1,1
2014-03,20,8,0,0,23.125,-95.875,4,0,4
2014-03,20,9,0,0,23.125,-95.625,8,0,8
2014-03,21,6,0,0,23.375,-96.375,2,0,2
2014-03,21,7,0,0,23.375,-96.125,10,0,10
2014-03,21,8,0,0,23.375,-95.875,5,0,5
2014-03,21,21,0,0,23.375,-92.625,0,2,2
2014-03,21,22,0,0,23.375,-92.375,0,1,1
2014-03,21,24,0,0,23.375,-91.875,0,1,1
2014-03,22,6,0,0,23.625,-96.375,2,0,2
2014-03,22,22,0,0,23.625,-92.375,0,8,8
2014-03,22,23,0,0,23.625,-92.125,0,7,7
2014-03,22,24,0,0,23.625,-91.875,0,6,6
2014-03,22,53,0,0,23.625,-84.625,3,0,3
2014-03,22,54,0,0,23.625,-84.375,6,0,6
2014-03,23,35,0,0,23.875,-89.125,0,2,2
2014-03,23,53,0,0,23.875,-84.625,3,0,3
2014-03,23,54,0,0,23.875,-84.375,4,0,4
2014-03,24,34,0,0,24.125,-89.375,0,5,5
2014-03,24,35,0,0,24.125,-89.125,0,4,4
2014-03,24,54,0,0,24.125,-84.375,4,0,4
2014-03,25,34,0,0,24.375,-89.375,0,8,8
2014-03,25,53,0,0,24.375,-84.625,2,0,2
2014-03,25,54,0,0,24.375,-84.375,3,0,3
2014-03,26,53,0,0,24.625,-84.625,4,0,4
2014-03,27,13,0,0,24.875,-94.625,0,1,1
2014-03,27,53,0,0,24.875,-84.625,2,0,2
2014-03,28,12,0,0,25.125,-94.875,0,3,3
2014-03,28,13,0,0,25.125,-94.625,0,6,6
2014-03,28,46,0,0,25.125,-86.375,0,16,16
2014-03,28,47,0,0,25.125,-86.125,0,7,7
2014-03,29,11,0,0,25.375,-95.125,0,3,3
2014-03,29,12,0,0,25.375,-94.875,0,18,18
2014-03,29,21,0,0,25.375,-92.625,5,0,5
2014-03,29,22,0,0,25.375,-92.375,17,0,17
2014-03,29,47,0,0,25.375,-86.125,0,8,8
2014-03,30,22,0,0,25.625,-92.375,3,0,3
2014-03,31,38,0,0,25.875,-88.375,10,0,10
2014-03,31,39,0,0,25.875,-88.125,1,0,1
2014-03,32,38,0,0,26.125,-88.375,6,0,6
2014-03,32,39,0,0,26.125,-88.125,12,0,12
2014-03,32,40,0,0,26.125,-87.875,2,0,2
2014-03,35,12,0,0,26.875,-94.875,1,0,1
2014-03,35,13,0,0,26.875,-94.625,12,0,12
2014-03,35,14,0,0,26.875,-94.375,12,0,12
2014-03,37,34,0,0,27.375,-89.375,0,5,5
2014-03,38,33,0,0,27.625,-89.625,0,4,4
2014-03,38,34,0,0,27.625,-89.375,0,16,16
2014-03,39,34,0,0,27.875,-89.375,0,6,6
2014-03,41,50,0,0,28.375,-85.375,10,0,10
2014-03,42,49,0,0,28.625,-85.625,6,0,6
2014-03,42,50,0,0,28.625,-85.375,1,0,1
2014-04,0,46,0,0,18.125,-86.375,9,0,9
2014-04,2,71,0,0,18.625,-80.125,0,2,2
2014-04,5,55,0,0,19.375,-84.125,0,5,5
2014-04,5,56,0,0,19.375,-83.875,0,1,1
2014-04,5,58,0,0,19.375,-83.375,0,1,1
2014-04,6,56,0,0,19.625,-83.875,0,9,9
2014-04,6,57,0,0,19.625,-83.625,0,2,2
2014-04,6,58,0,0,19.625,-83.375,0,2,2
2014-04,6,59,0,0,19.625,-83.125,0,3,3
2014-04,6,60,0,0,19.625,-82.875,0,1,1
2014-04,6,61,0,0,19.625,-82.625,0,3,3
2014-04,6,62,0,0,19.625,-82.375,0,3,3
2014-04,7,66,0,0,19.875,-81.375,2,0,2
2014-04,8,10,0,0,20.125,-95.375,1,0,1
2014-04,8,66,0,0,20.125,-81.375,2,0,2
2014-04,9,10,0,0,20.375,-95.375,7,0,7
2014-04,10,10,0,0,20.625,-95.375,5,0,5
2014-04,10,11,0,0,20.625,-95.125,7,0,7
2014-04,10,12,0,0,20.625,-94.875,5,0,5
2014-04,10,13,0,0,20.625,-94.625,5,0,5
2014-04,10,66,0,0,20.625,-81.375,1,0,1
2014-04,10,67,0,0,20.625,-81.125,6,0,6
2014-04,10,68,0,0,20.625,-80.875,2,0,2
2014-04,11,67,0,0,20.875,-81.125,1,0,1
2014-04,11,68,0,0,20.875,-80.875,6,0,6
2014-04,12,52,0,0,21.125,-84.875,4,0,4
2014-04,12,58,0,0,21.125,-83.375,8,0,8
2014-04,13,52,0,0,21.375,-84.875,2,0,2
2014-04,13,58,0,0,21.375,-83.375,2,0,2
2014-04,13,59,0,0,21.375,-83.125,2,0,2
2014-04,18,10,0,0,22.625,-95.375,0,4,4
2014-04,18,11,0,0,22.625,-95.125,0,2,2
2014-04,18,13,0,0,22.625,-94.625,0,5,5
2014-04,18,14,0,0,22.625,-94.375,0,1,1
2014-04,19,14,0,0,22.875,-94.375,0,3,3
2014-04,20,13,0,0,23.125,-94.625,0,1,1
2014-04,21,13,0,0,23.375,-94.625,0,5,5
2014-04,21,55,0,0,23.375,-84.125,2,0,2
2014-04,21,56,0,0,23.375,-83.875,2,0,2
2014-04,22,12,0,0,23.625,-94.875,0,2,2
2014-04,22,13,0,0,23.625,-94.625,0,3,3
2014-04,22,54,0,0,23.625,-84.375,1,0,1
2014-04,22,55,0,0,23.625,-84.125,3,0,3
2014-04,22,56,0,0,23.625,-83.875,2,0,2
2014-04,23,6,0,0,23.875,-96.375,5,0,5
2014-04,23,12,0,0,23.875,-94.875,0,3,3
2014-04,23,28,0,0,23.875,-90.875,0,2,2
2014-04,23,29,0,0,23.875,-90.625,0,1,1
2014-04,23,54,0,0,23.875,-84.375,2,0,2
2014-04,23,56,0,0,23.875,-83.875,3,0,3
2014-04,24,6,0,0,24.125,-96.375,8,0,8
2014-04,24,12,0,0,24.125,-94.875,0,1,1
2014-04,24,27,0,0,24.125,-91.125,0,12,12
2014-04,24,29,0,0,24.125,-90.625,0,1,1
2014-04,24,30,0,0,24.125,-90.375,0,1,1
2014-04,24,54,0,0,24.125,-84.375,7,0,7
2014-04,25,6,0,0,24.375,-96.375,6,0,6
2014-04,25,26,0,0,24.375,-91.375,0,3,3
2014-04,25,27,0,0,24.375,-91.125,0,5,5
2014-04,25,54,0,0,24.375,-84.375,3,0,3
2014-04,26,6,0,0,24.625,-96.375,2,0,2
2014-04,26,7,0,0,24.625,-96.125,4,0,4
2014-04,27,8,0,0,24.875,-95.875,5,0,5
2014-04,27,13,0,0,24.875,-94.625,0,6,6
2014-04,28,19,0,0,25.125,-93.125,7,0,7
2014-04,28,20,0,0,25.125,-92.875,11,0,11
2014-04,28,21,0,0,25.125,-92.625,8,0,8
2014-04,28,46,0,0,25.125,-86.375,0,7,7
2014-04,29,21,0,0,25.375,-92.625,3,0,3
2014-04,29,22,0,0,25.375,-92.375,1,0,1
2014-04,29,45,0,0,25.375,-86.625,0,5,5
2014-04,29,46,0,0,25.375,-86.375,0,3,3
2014-04,30,45,0,0,25.625,-86.625,0,6,6
2014-04,31,45,0,0,25.875,-86.625,0,3,3
2014-04,31,46,0,0,25.875,-86.375,0,1,1
2014-04,32,38,0,0,26.125,-88.375,13,0,13
2014-04,32,39,0,0,26.125,-88.125,8,0,8
2014-04,32,46,0,0,26.125,-86.375,0,5,5
2014-04,33,11,0,0,26.375,-95.125,2,0,2
2014-04,33,38,0,0,26.375,-88.375,4,0,4
2014-04,33,39,0,0,26.375,-88.125,2,0,2
2014-04,34,11,0,0,26.625,-95.125,18,0,18
2014-04,34,12,0,0,26.625,-94.875,1,0,1
2014-04,34,39,0,0,26.625,-88.125,3,0,3
2014-04,35,12,0,0,26.875,-94.875,9,0,9
2014-04,35,30,0,0,26.875,-90.375,0,3,3
2014-04,35,31,0,0,26.875,-90.125,0,2,2
2014-04,36,29,0,0,27.125,-90.625,0,8,8
2014-04,36,30,0,0,27.125,-90.375,0,2,2
2014-04,36,31,0,0,27.125,-90.125,0,6,6
2014-04,36,33,0,0,27.125,-89.625,0,4,4
2014-04,36,34,0,0,27.125,-89.375,0,3,3
2014-04,37,30,0,0,27.375,-90.375,0,1,1
2014-04,37,34,0,0,27.375,-89.375,0,1,1
2014-05,0,43,0,0,18.125,-87.125,3,0,3
2014-05,0,44,0,0,18.125,-86.875,7,0,7
2014-05,0,45,0,0,18.125,-86.625,2,0,2
2014-05,0,46,0,0,18.125,-86.375,1,0,1
2014-05,1,45,0,0,18.375,-86.625,6,0,6
2014-05,1,46,0,0,18.375,-86.375,3,0,3
2014-05,3,67,0,0,18.875,-81.125,0,3,3
2014-05,3,68,0,0,18.875,-80.875,0,3,3
2014-05,3,69,0,0,18.875,-80.625,0,2,2
2014-05,3,70,0,0,18.875,-80.375,0,4,4
2014-05,3,71,0,0,18.875,-80.125,0,4,4
2014-05,4,50,0,0,19.125,-85.375,0,2,2
2014-05,4,51,0,0,19.125,-85.125,0,6,6
2014-05,4,52,0,0,19.125,-84.875,0,7,7
2014-05,4,53,0,0,19.125,-84.625,0,5,5
2014-05,4,54,0,0,19.125,-84.375,0,8,8
2014-05,4,64,0,0,19.125,-81.875,0,1,1
2014-05,4,65,0,0,19.125,-81.625,0,3,3
2014-05,4,66,0,0,19.125,-81.375,0,2,2
2014-05,5,54,0,0,19.375,-84.375,0,2,2
2014-05,5,63,0,0,19.375,-82.125,0,2,2
2014-05,5,64,0,0,19.375,-81.875,0,2,2
2014-05,7,11,0,0,19.875,-95.125,3,0,3
2014-05,8,11,0,0,20.125,-95.125,12,0,12
2014-05,8,12,0,0,20.125,-94.875,16,0,16
2014-05,9,57,0,0,20.375,-83.625,14,0,14
2014-05,9,58,0,0,20.375,-83.375,7,0,7
2014-05,10,58,0,0,20.625,-83.375,4,0,4
2014-05,11,58,0,0,20.875,-83.375,5,0,5
2014-05,12,58,0,0,21.125,-83.375,1,0,1
2014-05,16,10,0,0,22.125,-95.375,0,1,1
2014-05,17,11,0,0,22.375,-95.125,0,6,6
2014-05,17,12,0,0,22.375,-94.875,0,8,8
2014-05,17,13,0,0,22.375,-94.625,0,2,2
2014-05,18,12,0,0,22.625,-94.875,0,8,8
2014-05,18,13,0,0,22.625,-94.625,0,6,6
2014-05,20,49,0,0,23.125,-85.625,1,0,1
2014-05,21,34,0,0,23.375,-89.375,0,1,1
2014-05,21,35,0,0,23.375,-89.125,0,7,7
2014-05,21,36,0,0,23.375,-88.875,0,9,9
2014-05,21,37,0,0,23.375,-88.625,0,2,2
2014-05,21,49,0,0,23.375,-85.625,5,0,5
2014-05,21,50,0,0,23.375,-85.375,1,0,1
2014-05,22,23,0,0,23.625,-92.125,0,1,1
2014-05,22,24,0,0,23.625,-91.875,0,13,13
2014-05,22,50,0,0,23.625,-85.375,5,0,5
2014-05,22,51,0,0,23.625,-85.125,1,0,1
2014-05,23,25,0,0,23.875,-91.625,0,4,4
2014-05,23,51,0,0,23.875,-85.125,8,0,8
2014-05,23,52,0,0,23.875,-84.875,3,0,3
2014-05,23,54,0,0,23.875,-84.375,5,0,5
2014-05,24,53,0,0,24.125,-84.625,1,0,1
2014-05,24,54,0,0,24.125,-84.375,1,0,1
2014-05,25,26,0,0,24.375,-91.375,0,8,8
2014-05,27,8,0,0,24.875,-95.875,2,0,2
2014-05,27,32,0,0,24.875,-89.875,2,0,2
2014-05,27,33,0,0,24.875,-89.625,3,0,3
2014-05,28,14,0,0,25.125,-94.375,10,0,10
2014-05,28,18,0,0,25.125,-93.375,6,0,6
2014-05,28,19,0,0,25.125,-93.125,1,0,1
2014-05,28,33,0,0,25.125,-89.625,8,0,8
2014-05,29,15,0,0,25.375,-94.125,14,0,14
2014-05,29,32,0,0,25.375,-89.875,1,0,1
2014-05,29,44,0,0,25.375,-86.875,0,4,4
2014-05,29,45,0,0,25.375,-86.625,0,2,2
2014-05,30,10,0,0,25.625,-95.375,1,0,1
2014-05,30,45,0,0,25.625,-86.625,0,3,3
2014-05,30,46,0,0,25.625,-86.375,0,5,5
2014-05,31,46,0,0,25.875,-86.375,0,2,2
2014-05,31,47,0,0,25.875,-86.125,0,11,11
2014-05,32,46,0,0,26.125,-86.375,0,4,4
2014-05,33,11,0,0,26.375,-95.125,2,0,2
2014-05,34,25,0,0,26.625,-91.625,0,1,1
2014-05,34,26,0,0,26.625,-91.375,0,8,8
2014-05,34,27,0,0,26.625,-91.125,0,9,9
2014-05,34,28,0,0,26.625,-90.875,0,4,4
2014-05,35,28,0,0,26.875,-90.875,0,6,6
2014-05,35,39,0,0,26.875,-88.125,1,0,1
2014-05,36,28,0,0,27.125,-90.875,0,3,3
2014-05,36,40,0,0,27.125,-87.875,1,0,1
2014-05,37,40,0,0,27.375,-87.875,2,0,2
2014-05,37,41,0,0,27.375,-87.625,3,0,3
2014-05,37,43,0,0,27.375,-87.125,2,0,2
2014-05,37,44,0,0,27.375,-86.875,4,0,4
2014-05,37,45,0,0,27.375,-86.625,3,0,3
2014-05,38,41,0,0,27.625,-87.625,2,0,2
2014-05,38,42,0,0,27.625,-87.375,5,0,5
2014-05,38,43,0,0,27.625,-87.125,8,0,8
2014-06,3,45,0,0,18.875,-86.625,0,1,1
2014-06,3,46,0,0,18.875,-86.375,0,5,5
2014-06,3,47,0,0,18.875,-86.125,0,1,1
2014-06,3,48,0,0,18.875,-85.875,0,4,4
2014-06,3,55,0,0,18.875,-84.125,1,0,1
2014-06,3,56,0,0,18.875,-83.875,5,0,5
2014-06,3,57,0,0,18.875,-83.625,5,0,5
2014-06,3,58,0,0,18.875,-83.375,4,0,4
2014-06,4,45,0,0,19.125,-86.625,0,2,2
2014-06,4,47,0,0,19.125,-86.125,0,2,2
2014-06,4,48,0,0,19.125,-85.875,0,5,5
2014-06,4,49,0,0,19.125,-85.625,0,4,4
2014-06,4,50,0,0,19.125,-85.375,0,1,1
2014-06,4,53,0,0,19.125,-84.625,0,4,4
2014-06,6,11,0,0,19.625,-95.125,6,0,6
2014-06,6,63,0,0,19.625,-82.125,0,3,3
2014-06,6,64,0,0,19.625,-81.875,0,2,2
2014-06,7,10,0,0,19.875,-95.375,6,0,6
2014-06,7,11,0,0,19.875,-95.125,18,0,18
2014-06,7,63,0,0,19.875,-82.125,0,2,2
2014-06,7,64,0,0,19.875,-81.875,0,1,1
2014-06,8,55,0,0,20.125,-84.125,3,0,3
2014-06,8,56,0,0,20.125,-83.875,3,0,3
2014-06,9,56,0,0,20.375,-83.875,3,0,3
2014-06,9,57,0,0,20.375,-83.625,6,0,6
2014-06,16,9,0,0,22.125,-95.625,0,17,17
2014-06,16,10,0,0,22.125,-95.375,0,11,11
2014-06,17,8,0,0,22.375,-95.875,0,2,2
2014-06,20,32,0,0,23.125,-89.875,0,1,1
2014-06,20,33,0,0,23.125,-89.625,0,11,11
2014-06,20,34,0,0,23.125,-89.375,0,3,3
2014-06,20,35,0,0,23.125,-89.125,0,1,1
2014-06,20,44,0,0,23.125,-86.875,1,0,1
2014-06,20,45,0,0,23.125,-86.625,1,0,1
2014-06,20,46,0,0,23.125,-86.375,1,0,1
2014-06,20,49,0,0,23.125,-85.625,7,0,7
2014-06,21,34,0,0,23.375,-89.375,0,1,1
2014-06,21,35,0,0,23.375,-89.125,0,10,10
2014-06,21,43,0,0,23.375,-87.125,1,0,1
2014-06,21,44,0,0,23.375,-86.875,1,0,1
2014-06,22,23,0,0,23.625,-92.125,0,3,3
2014-06,22,24,0,0,23.625,-91.875,0,7,7
2014-06,22,42,0,0,23.625,-87.375,1,0,1
2014-06,22,43,0,0,23.625,-87.125,2,0,2
2014-06,23,42,0,0,23.875,-87.375,2,0,2
2014-06,24,50,0,0,24.125,-85.375,0,1,1
2014-06,25,50,0,0,24.375,-85.375,0,6,6
2014-06,25,51,0,0,24.375,-85.125,0,3,3
2014-06,26,50,0,0,24.625,-85.375,0,3,3
2014-06,26,51,0,0,24.625,-85.125,0,1,1
2014-06,27,50,0,0,24.875,-85.375,0,6,6
2014-06,28,14,0,0,25.125,-94.375,4,0,4
2014-06,29,13,0,0,25.375,-94.625,12,0,12
2014-06,29,14,0,0,25.375,-94.375,14,0,14
2014-06,29,32,0,0,25.375,-89.875,8,0,8
2014-06,29,44,0,0,25.375,-86.875,0,10,10
2014-06,30,32,0,0,25.625,-89.875,9,0,9
2014-06,30,33,0,0,25.625,-89.625,2,0,2
2014-06,30,41,0,0,25.625,-87.625,0,1,1
2014-06,31,40,0,0,25.875,-87.875,0,1,1
2014-06,31,41,0,0,25.875,-87.625,0,2,2
2014-06,32,40,0,0,26.125,-87.875,0,4,4
2014-06,33,23,0,0,26.375,-92.125,0,4,4
2014-06,33,24,0,0,26.375,-91.875,0,3,3
2014-06,33,39,0,0,26.375,-88.125,0,3,3
2014-06,33,40,0,0,26.375,-87.875,0,1,1
2014-06,33,48,0,0,26.375,-85.875,5,0,5
2014-06,34,24,0,0,26.625,-91.875,0,13,13
2014-06,34,38,0,0,26.625,-88.375,0,3,3
2014-06,34,48,0,0,26.625,-85.875,5,0,5
2014-06,35,24,0,0,26.875,-91.875,0,2,2
2014-06,35,25,0,0,26.875,-91.625,0,8,8
2014-06,35,37,0,0,26.875,-88.625,0,1,1
2014-06,35,46,0,0,26.875,-86.375,1,0,1
2014-06,35,47,0,0,26.875,-86.125,6,0,6
2014-06,36,6,0,0,27.125,-96.375,0,8,8
2014-06,36,45,0,0,27.125,-86.625,2,0,2
2014-06,36,46,0,0,27.125,-86.375,10,0,10
2014-06,37,7,0,0,27.375,-96.125,0,10,10
2014-06,37,45,0,0,27.375,-86.625,1,0,1
2014-07,3,44,0,0,18.875,-86.875,0,2,2
2014-07,3,53,0,0,18.875,-84.625,2,0,2
2014-07,3,54,0,0,18.875,-84.375,3,0,3
2014-07,3,55,0,0,18.875,-84.125,1,0,1
2014-07,4,50,0,0,19.125,-85.375,1,0,1
2014-07,4,51,0,0,19.125,-85.125,1,0,1
2014-07,4,52,0,0,19.125,-84.875,2,0,2
2014-07,4,60,0,0,19.125,-82.875,0,1,1
2014-07,4,61,0,0,19.125,-82.625,0,3,3
2014-07,5,49,0,0,19.375,-85.625,3,0,3
2014-07,5,50,0,0,19.375,-85.375,1,0,1
2014-07,5,57,0,0,19.375,-83.625,0,2,2
2014-07,5,58,0,0,19.375,-83.375,0,5,5
2014-07,5,61,0,0,19.375,-82.625,0,2,2
2014-07,5,62,0,0,19.375,-82.375,0,4,4
2014-07,6,47,0,0,19.625,-86.125,1,0,1
2014-07,6,48,0,0,19.625,-85.875,4,0,4
2014-07,6,62,0,0,19.625,-82.375,0,9,9
2014-07,6,63,0,0,19.625,-82.125,0,5,5
2014-07,7,9,0,0,19.875,-95.625,10,0,10
2014-07,7,10,0,0,19.875,-95.375,13,0,13
2014-07,7,11,0,0,19.875,-95.125,1,0,1
2014-07,7,47,0,0,19.875,-86.125,3,0,3
2014-07,7,53,0,0,19.875,-84.625,4,0,4
2014-07,7,54,0,0,19.875,-84.375,6,0,6
2014-07,7,68,0,0,19.875,-80.875,3,0,3
2014-07,7,69,0,0,19.875,-80.625,4,0,4
2014-07,8,46,0,0,20.125,-86.375,3,0,3
2014-07,8,69,0,0,20.125,-80.625,1,0,1
2014-07,8,70,0,0,20.125,-80.375,4,0,4
2014-07,8,71,0,0,20.125,-80.125,17,0,17
2014-07,9,46,0,0,20.375,-86.375,1,0,1
2014-07,9,47,0,0,20.375,-86.125,1,0,1
2014-07,12,13,0,0,21.125,-94.625,0,4,4
2014-07,13,13,0,0,21.375,-94.625,0,4,4
2014-07,13,14,0,0,21.375,-94.375,0,5,5
2014-07,14,14,0,0,21.625,-94.375,0,3,3
2014-07,15,14,0,0,21.875,-94.375,0,4,4
2014-07,17,6,0,0,22.375,-96.375,0,1,1
2014-07,17,8,0,0,22.375,-95.875,0,5,5
2014-07,18,6,0,0,22.625,-96.375,0,2,2
2014-07,19,5,0,0,22.875,-96.625,0,3,3
2014-07,20,5,0,0,23.125,-96.625,0,2,2
2014-07,20,6,0,0,23.125,-96.375,0,4,4
2014-07,20,32,0,0,23.125,-89.875,0,1,1
2014-07,21,6,0,0,23.375,-96.375,0,8,8
2014-07,21,34,0,0,23.375,-89.375,0,3,3
2014-07,22,7,0,0,23.625,-96.125,0,4,4
2014-07,22,34,0,0,23.625,-89.375,0,3,3
2014-07,23,7,0,0,23.875,-96.125,0,2,2
2014-07,23,61,0,0,23.875,-82.625,1,0,1
2014-07,23,62,0,0,23.875,-82.375,7,0,7
2014-07,24,49,0,0,24.125,-85.625,0,2,2
2014-07,24,50,0,0,24.125,-85.375,0,19,19
2014-07,24,64,0,0,24.125,-81.875,2,0,2
2014-07,24,65,0,0,24.125,-81.625,5,0,5
2014-07,24,66,0,0,24.125,-81.375,2,0,2
2014-07,24,67,0,0,24.125,-81.125,1,0,1
2014-07,24,68,0,0,24.125,-80.875,1,0,1
2014-07,25,47,0,0,24.375,-86.125,0,2,2
2014-07,25,48,0,0,24.375,-85.875,0,1,1
2014-07,25,49,0,0,24.375,-85.625,0,3,3
2014-07,25,62,0,0,24.375,-82.375,5,0,5
2014-07,25,63,0,0,24.375,-82.125,1,0,1
2014-07,26,46,0,0,24.625,-86.375,0,4,4
2014-07,28,12,1,1,25.125,-94.875,0,0,0
2014-07,28,28,0,0,25.125,-90.875,6,0,6
2014-07,28,53,0,0,25.125,-84.625,1,0,1
2014-07,28,54,0,0,25.125,-84.375,2,0,2
2014-07,29,12,0,0,25.375,-94.875,7,0,7
2014-07,29,13,0,0,25.375,-94.625,12,0,12
2014-07,29,25,1,1,25.375,-91.625,0,0,0
2014-07,29,26,1,1,25.375,-91.375,0,0,0
2014-07,29,27,4,1,25.375,-91.125,0,0,0
2014-07,29,28,0,0,25.375,-90.875,2,0,2
2014-07,29,29,0,0,25.375,-90.625,7,0,7
2014-07,29,30,0,0,25.375,-90.375,2,0,2
2014-07,29,39,0,0,25.375,-88.125,2,0,2
2014-07,29,53,0,0,25.375,-84.625,2,0,2
2014-07,29,54,0,0,25.375,-84.375,1,0,1
2014-07,29,55,0,0,25.375,-84.125,4,0,4
2014-07,30,13,0,0,25.625,-94.625,5,0,5
2014-07,30,17,1,1,25.625,-93.625,0,0,0
2014-07,30,20,1,1,25.625,-92.875,0,0,0
2014-07,30,23,1,1,25.625,-92.125,0,0,0
2014-07,30,25,3,1,25.625,-91.625,0,0,0
2014-07,30,26,4,1,25.625,-91.375,0,0,0
2014-07,30,27,4,1,25.625,-91.125,0,0,0
2014-07,30,37,0,0,25.625,-88.625,1,0,1
2014-07,30,38,0,0,25.625,-88.375,2,0,2
2014-07,30,39,0,0,25.625,-88.125,2,0,2
2014-07,30,40,0,0,25.625,-87.875,1,0,1
2014-07,31,13,0,0,25.875,-94.625,6,0,6
2014-07,31,41,0,0,25.875,-87.625,5,0,5
2014-07,31,42,0,0,25.875,-87.375,6,0,6
2014-07,31,43,0,0,25.875,-87.125,3,0,3
2014-07,32,13,0,0,26.125,-94.625,1,0,1
2014-07,33,21,0,0,26.375,-92.625,0,16,16
2014-07,33,22,0,0,26.375,-92.375,0,10,10
2014-07,33,23,0,0,26.375,-92.125,0,5,5
2014-07,33,46,0,0,26.375,-86.375,1,0,1
2014-07,33,47,0,0,26.375,-86.125,5,0,5
2014-07,33,48,0,0,26.375,-85.875,3,0,3
2014-07,34,26,1,1,26.625,-91.375,0,0,0
2014-07,34,27,2,1,26.625,-91.125,0,0,0
2014-07,35,7,0,0,26.875,-96.125,0,12,12
2014-07,35,18,1,1,26.875,-93.375,0,0,0
2014-07,35,21,1,1,26.875,-92.625,0,0,0
2014-07,35,23,2,1,26.875,-92.125,0,0,0
2014-07,35,24,3,1,26.875,-91.875,0,0,0
2014-07,35,25,2,2,26.875,-91.625,0,0,0
2014-07,35,26,2,2,26.875,-91.375,0,0,0
2014-07,35,27,8,1,26.875,-91.125,0,0,0
2014-07,35,28,4,1,26.875,-90.875,0,0,0
2014-07,35,36,0,0,26.875,-88.875,0,1,1
2014-07,35,37,0,0,26.875,-88.625,0,2,2
2014-07,36,7,0,0,27.125,-96.125,0,9,9
2014-07,36,8,0,0,27.125,-95.875,0,6,6
2014-07,36,18,3,2,27.125,-93.375,0,0,0
2014-07,36,19,3,3,27.125,-93.125,0,0,0
2014-07,36,20,4,2,27.125,-92.875,0,0,0
2014-07,36,21,2,1,27.125,-92.625,0,0,0
2014-07,36,22,2,1,27.125,-92.375,0,0,0
2014-07,36,23,1,1,27.125,-92.125,0,0,0
2014-07,36,24,1,1,27.125,-91.875,0,0,0
2014-07,36,25,4,2,27.125,-91.625,0,0,0
2014-07,36,26,9,2,27.125,-91.375,0,0,0
2014-07,36,27,1,1,27.125,-91.125,0,0,0
2014-07,36,36,0,0,27.125,-88.875,0,5,5
2014-07,36,37,1,1,27.125,-88.625,0,0,0
2014-07,37,7,0,0,27.375,-96.125,0,2,2
2014-07,37,18,1,1,27.375,-93.375,0,0,0
2014-07,37,19,2,1,27.375,-93.125,0,0,0
2014-07,37,20,2,1,27.375,-92.875,0,0,0
2014-07,37,21,1,1,27.375,-92.625,0,0,0
2014-07,37,22,3,3,27.375,-92.375,0,0,0
2014-07,37,23,1,1,27.375,-92.125,0,0,0
2014-07,37,24,3,2,27.375,-91.875,0,0,0
2014-07,37,25,5,2,27.375,-91.625,0,0,0
2014-07,37,26,2,2,27.375,-91.375,0,0,0
2014-07,37,27,3,1,27.375,-91.125,0,0,0
2014-07,37,28,6,1,27.375,-90.875,0,0,0
2014-07,37,30,3,2,27.375,-90.375,0,0,0
2014-07,37,31,3,2,27.375,-90.125,0,0,0
2014-07,37,32,1,1,27.375,-89.875,0,0,0
2014-07,37,33,2,2,27.375,-89.625,0,0,0
2014-07,37,35,1,1,27.375,-89.125,0,8,8
2014-07,37,36,0,0,27.375,-88.875,0,15,15
2014-07,37,37,1,1,27.375,-88.625,0,0,0
2014-07,38,21,1,1,27.625,-92.625,0,0,0
2014-07,38,22,3,1,27.625,-92.375,0,0,0
2014-07,38,24,1,1,27.625,-91.875,0,0,0
2014-07,38,25,2,2,27.625,-91.625,0,0,0
2014-07,38,26,2,1,27.625,-91.375,0,0,0
2014-07,38,27,4,2,27.625,-91.125,0,0,0
2014-07,38,28,2,2,27.625,-90.875,0,0,0
2014-07,38,29,4,2,27.625,-90.625,0,0,0
2014-07,38,30,9,3,27.625,-90.375,0,0,0
2014-07,38,31,3,2,27.625,-90.125,0,0,0
2014-07,38,32,4,3,27.625,-89.875,0,0,0
2014-07,38,33,2,1,27.625,-89.625,0,0,0
2014-07,38,34,3,3,27.625,-89.375,0,0,0
2014-07,38,36,1,1,27.625,-88.875,0,0,0
2014-07,38,37,2,2,27.625,-88.625,0,0,0
2014-07,38,38,5,2,27.625,-88.375,0,0,0
2014-07,38,39,5,1,27.625,-88.125,0,0,0
2014-07,38,40,1,1,27.625,-87.875,0,0,0
2014-07,39,25,1,1,27.875,-91.625,0,0,0
2014-07,39,28,2,1,27.875,-90.875,0,0,0
2014-07,39,29,1,1,27.875,-90.625,0,0,0
2014-07,39,30,2,1,27.875,-90.375,0,0,0
2014-07,39,31,5,2,27.875,-90.125,0,0,0
2014-07,39,32,2,2,27.875,-89.875,0,0,0
2014-07,39,33,2,2,27.875,-89.625,0,0,0
2014-07,39,35,1,1,27.875,-89.125,0,0,0
2014-07,39,36,1,1,27.875,-88.875,0,0,0
2014-07,39,37,2,1,27.875,-88.625,0,0,0
2014-07,39,38,1,1,27.875,-88.375,0,0,0
2014-07,39,39,3,2,27.875,-88.125,0,0,0
2014-07,39,40,5,3,27.875,-87.875,0,0,0
2014-07,39,43,1,1,27.875,-87.125,0,0,0
2014-07,40,25,4,1,28.125,-91.625,0,0,0
2014-07,40,27,3,2,28.125,-91.125,0,0,0
2014-07,40,28,24,14,28.125,-90.875,0,0,0
2014-07,40,30,1,1,28.125,-90.375,0,0,0
2014-07,40,31,2,1,28.125,-90.125,0,0,0
2014-07,40,33,1,1,28.125,-89.625,0,0,0
2014-07,40,34,1,1,28.125,-89.375,0,0,0
2014-07,40,35,3,1,28.125,-89.125,0,0,0
2014-07,40,36,1,1,28.125,-88.875,0,0,0
2014-07,40,37,1,1,28.125,-88.625,0,0,0
2014-07,40,40,2,2,28.125,-87.875,0,0,0
2014-07,40,41,2,1,28.125,-87.625,0,0,0
2014-07,40,42,3,3,28.125,-87.375,0,0,0
2014-07,40,44,1,1,28.125,-86.875,0,0,0
2014-07,41,27,1,1,28.375,-91.125,0,0,0
2014-07,41,34,1,1,28.375,-89.375,0,0,0
2014-07,41,35,2,1,28.375,-89.125,0,0,0
2014-07,41,45,7,1,28.375,-86.625,0,0,0
2014-07,41,46,1,1,28.375,-86.375,0,0,0
2014-08,3,51,0,0,18.875,-85.125,0,1,1
2014-08,3,58,0,0,18.875,-83.375,0,1,1
2014-08,3,59,0,0,18.875,-83.125,0,1,1
2014-08,4,49,0,0,19.125,-85.625,0,3,3
2014-08,4,50,0,0,19.125,-85.375,0,6,6
2014-08,4,51,0,0,19.125,-85.125,0,1,1
2014-08,4,52,0,0,19.125,-84.875,0,1,1
2014-08,4,53,0,0,19.125,-84.625,0,3,3
2014-08,4,54,0,0,19.125,-84.375,0,2,2
2014-08,4,55,0,0,19.125,-84.125,0,3,3
2014-08,4,56,0,0,19.125,-83.875,0,2,2
2014-08,4,57,0,0,19.125,-83.625,0,2,2
2014-08,4,63,0,0,19.125,-82.125,1,0,1
2014-08,4,64,0,0,19.125,-81.875,1,0,1
2014-08,4,65,0,0,19.125,-81.625,3,0,3
2014-08,5,50,0,0,19.375,-85.375,0,5,5
2014-08,5,62,0,0,19.375,-82.375,5,0,5
2014-08,5,63,0,0,19.375,-82.125,2,0,2
2014-08,5,64,0,0,19.375,-81.875,1,0,1
2014-08,7,53,0,0,19.875,-84.625,2,0,2
2014-08,7,65,0,0,19.875,-81.625,4,0,4
2014-08,7,66,0,0,19.875,-81.375,5,0,5
2014-08,7,67,0,0,19.875,-81.125,6,0,6
2014-08,7,68,0,0,19.875,-80.875,3,0,3
2014-08,8,53,0,0,20.125,-84.625,2,0,2
2014-08,9,53,0,0,20.375,-84.625,3,0,3
2014-08,10,13,0,0,20.625,-94.625,0,15,15
2014-08,10,53,0,0,20.625,-84.625,1,0,1
2014-08,10,54,0,0,20.625,-84.375,8,0,8
2014-08,11,6,0,0,20.875,-96.375,1,0,1
2014-08,11,13,0,0,20.875,-94.625,0,1,1
2014-08,11,14,0,0,20.875,-94.375,0,10,10
2014-08,11,17,1,1,20.875,-93.625,0,0,0
2014-08,11,18,1,1,20.875,-93.375,0,0,0
2014-08,11,54,0,0,20.875,-84.375,2,0,2
2014-08,12,6,0,0,21.125,-96.375,1,0,1
2014-08,12,7,0,0,21.125,-96.125,2,0,2
2014-08,12,13,0,0,21.125,-94.625,0,3,3
2014-08,12,15,0,0,21.125,-94.125,0,1,1
2014-08,12,16,2,1,21.125,-93.875,0,0,0
2014-08,13,13,0,0,21.375,-94.625,0,1,1
2014-08,13,14,1,1,21.375,-94.375,0,0,0
2014-08,14,9,3,1,21.625,-95.625,0,0,0
2014-08,14,10,2,1,21.625,-95.375,0,0,0
2014-08,14,11,2,1,21.625,-95.125,0,0,0
2014-08,14,12,2,1,21.625,-94.875,0,0,0
2014-08,14,19,0,0,21.625,-93.125,6,0,6
2014-08,15,7,1,1,21.875,-96.125,0,0,0
2014-08,17,5,1,1,22.375,-96.625,0,0,0
2014-08,19,7,1,1,22.875,-96.125,0,0,0
2014-08,21,9,1,1,23.375,-95.625,0,0,0
2014-08,22,8,0,0,23.625,-95.875,0,14,14
2014-08,23,8,0,0,23.875,-95.875,0,14,14
2014-08,24,8,0,0,24.125,-95.875,0,3,3
2014-08,24,11,1,1,24.125,-95.125,0,0,0
2014-08,24,68,0,0,24.125,-80.875,1,0,1
2014-08,25,10,1,1,24.375,-95.375,0,0,0
2014-08,25,12,1,1,24.375,-94.875,0,0,0
2014-08,25,53,0,0,24.375,-84.625,2,0,2
2014-08,25,54,0,0,24.375,-84.375,3,0,3
2014-08,25,68,0,0,24.375,-80.875,1,0,1
2014-08,25,69,0,0,24.375,-80.625,3,0,3
2014-08,25,70,0,0,24.375,-80.375,2,0,2
2014-08,26,5,1,1,24.625,-96.625,0,0,0
2014-08,26,6,7,1,24.625,-96.375,0,0,0
2014-08,26,7,1,1,24.625,-96.125,0,0,0
2014-08,26,8,2,2,24.625,-95.875,0,0,0
2014-08,26,10,1,1,24.625,-95.375,0,0,0
2014-08,26,14,1,1,24.625,-94.375,0,0,0
2014-08,26,16,1,1,24.625,-93.875,0,0,0
2014-08,26,46,0,0,24.625,-86.375,0,3,3
2014-08,26,52,0,0,24.625,-84.875,6,0,6
2014-08,26,54,0,0,24.625,-84.375,6,0,6
2014-08,27,6,1,1,24.875,-96.375,0,0,0
2014-08,27,7,1,1,24.875,-96.125,0,0,0
2014-08,27,8,1,1,24.875,-95.875,0,0,0
2014-08,27,9,1,1,24.875,-95.625,0,0,0
2014-08,27,45,0,0,24.875,-86.625,0,8,8
2014-08,27,54,0,0,24.875,-84.375,4,0,4
2014-08,28,18,1,1,25.125,-93.375,0,0,0
2014-08,28,27,0,0,25.125,-91.125,11,0,11
2014-08,28,28,0,0,25.125,-90.875,2,0,2
2014-08,28,44,0,0,25.125,-86.875,0,5,5
2014-08,28,45,0,0,25.125,-86.625,0,2,2
2014-08,28,53,0,0,25.125,-84.625,1,0,1
2014-08,28,54,0,0,25.125,-84.375,2,0,2
2014-08,29,36,0,0,25.375,-88.875,2,0,2
2014-08,29,44,0,0,25.375,-86.875,0,1,1
2014-08,29,54,0,0,25.375,-84.375,2,0,2
2014-08,30,19,1,1,25.625,-93.125,0,0,0
2014-08,30,36,0,0,25.625,-88.875,8,0,8
2014-08,30,37,1,1,25.625,-88.625,3,0,3
2014-08,30,46,1,1,25.625,-86.375,0,0,0
2014-08,31,20,2,1,25.875,-92.875,0,0,0
2014-08,31,34,1,1,25.875,-89.375,0,0,0
2014-08,31,35,1,1,25.875,-89.125,0,0,0
2014-08,31,36,1,1,25.875,-88.875,0,0,0
2014-08,31,37,1,1,25.875,-88.625,0,0,0
2014-08,31,40,1,1,25.875,-87.875,0,0,0
2014-08,31,41,1,1,25.875,-87.625,0,0,0
2014-08,31,42,1,1,25.875,-87.375,0,0,0
2014-08,31,43,1,1,25.875,-87.125,0,0,0
2014-08,31,44,1,1,25.875,-86.875,0,0,0
2014-08,31,45,1,1,25.875,-86.625,0,0,0
2014-08,31,46,2,1,25.875,-86.375,0,0,0
2014-08,32,11,0,0,26.125,-95.125,7,0,7
2014-08,32,13,0,0,26.125,-94.625,6,0,6
2014-08,32,22,1,1,26.125,-92.375,0,0,0
2014-08,32,32,1,1,26.125,-89.875,0,0,0
2014-08,32,41,1,1,26.125,-87.625,0,0,0
2014-08,32,44,1,1,26.125,-86.875,0,0,0
2014-08,33,11,0,0,26.375,-95.125,10,0,10
2014-08,33,12,0,0,26.375,-94.875,8,0,8
2014-08,33,21,0,0,26.375,-92.625,0,15,15
2014-08,33,24,1,1,26.375,-91.875,0,0,0
2014-08,33,32,2,1,26.375,-89.875,0,0,0
2014-08,33,39,1,1,26.375,-88.125,0,0,0
2014-08,33,40,1,1,26.375,-87.875,0,0,0
2014-08,33,46,1,1,26.375,-86.375,0,0,0
2014-08,33,47,2,1,26.375,-86.125,0,0,0
2014-08,34,20,0,0,26.625,-92.875,0,5,5
2014-08,34,21,0,0,26.625,-92.625,0,11,11
2014-08,34,26,1,1,26.625,-91.375,0,0,0
2014-08,34,32,1,1,26.625,-89.875,0,0,0
2014-08,34,33,1,1,26.625,-89.625,0,0,0
2014-08,34,34,1,1,26.625,-89.375,0,0,0
2014-08,34,47,4,1,26.625,-86.125,0,0,0
2014-08,34,48,2,2,26.625,-85.875,0,0,0
2014-08,35,26,1,1,26.875,-91.375,0,0,0
2014-08,35,32,3,1,26.875,-89.875,0,0,0
2014-08,35,33,3,1,26.875,-89.625,0,0,0
2014-08,35,39,1,1,26.875,-88.125,0,3,3
2014-08,35,40,0,0,26.875,-87.875,0,9,9
2014-08,35,41,1,1,26.875,-87.625,0,0,0
2014-08,35,49,1,1,26.875,-85.625,0,0,0
2014-08,35,52,1,1,26.875,-84.875,0,0,0
2014-08,36,8,0,0,27.125,-95.875,0,12,12
2014-08,36,25,1,1,27.125,-91.625,0,0,0
2014-08,36,27,1,1,27.125,-91.125,0,0,0
2014-08,36,29,1,1,27.125,-90.625,0,0,0
2014-08,36,31,3,2,27.125,-90.125,0,0,0
2014-08,36,33,3,1,27.125,-89.625,0,0,0
2014-08,36,37,1,1,27.125,-88.625,0,0,0
2014-08,36,38,0,0,27.125,-88.375,0,3,3
2014-08,36,42,1,1,27.125,-87.375,0,0,0
2014-08,36,47,1,1,27.125,-86.125,0,0,0
2014-08,36,51,5,1,27.125,-85.125,0,0,0
2014-08,36,52,1,1,27.125,-84.875,0,0,0
2014-08,36,53,1,1,27.125,-84.625,0,0,0
2014-08,37,8,0,0,27.375,-95.875,0,8,8
2014-08,37,24,1,1,27.375,-91.875,0,0,0
2014-08,37,26,1,1,27.375,-91.375,0,0,0
2014-08,37,30,1,1,27.375,-90.375,0,0,0
2014-08,37,31,1,1,27.375,-90.125,0,0,0
2014-08,37,32,1,1,27.375,-89.875,0,0,0
2014-08,37,33,1,1,27.375,-89.625,0,0,0
2014-08,37,35,0,0,27.375,-89.125,0,11,11
2014-08,37,36,0,0,27.375,-88.875,0,3,3
2014-08,37,37,0,0,27.375,-88.625,0,2,2
2014-08,37,39,1,1,27.375,-88.125,0,0,0
2014-08,37,40,1,1,27.375,-87.875,0,0,0
2014-08,37,45,1,1,27.375,-86.625,0,0,0
2014-08,38,23,1,1,27.625,-92.125,0,0,0
2014-08,38,24,3,1,27.625,-91.875,0,0,0
2014-08,38,26,3,2,27.625,-91.375,0,0,0
2014-08,38,29,1,1,27.625,-90.625,0,0,0
2014-08,38,30,8,2,27.625,-90.375,0,0,0
2014-08,38,33,1,1,27.625,-89.625,0,0,0
2014-08,38,39,3,2,27.625,-88.125,0,0,0
2014-08,38,41,2,1,27.625,-87.625,0,0,0
2014-08,38,42,1,1,27.625,-87.375,0,0,0
2014-08,38,43,2,2,27.625,-87.125,0,0,0
2014-08,38,50,1,1,27.625,-85.375,0,0,0
2014-08,39,25,1,1,27.875,-91.625,0,0,0
2014-08,39,27,1,1,27.875,-91.125,0,0,0
2014-08,39,28,1,1,27.875,-90.875,0,0,0
2014-08,39,29,1,1,27.875,-90.625,0,0,0
2014-08,39,30,3,1,27.875,-90.375,0,0,0
2014-08,39,32,1,1,27.875,-89.875,0,0,0
2014-08,39,33,1,1,27.875,-89.625,0,0,0
2014-08,39,41,2,1,27.875,-87.625,0,0,0
2014-08,39,42,1,1,27.875,-87.375,0,0,0
2014-08,39,43,2,1,27.875,-87.125,0,0,0
2014-08,39,50,1,1,27.875,-85.375,0,0,0
2014-08,40,24,2,1,28.125,-91.875,0,0,0
2014-08,40,25,1,1,28.125,-91.625,0,0,0
2014-08,40,28,2,1,28.125,-90.875,0,0,0
2014-08,40,29,2,1,28.125,-90.625,0,0,0
2014-08,40,30,3,2,28.125,-90.375,0,0,0
2014-08,40,32,1,1,28.125,-89.875,0,0,0
2014-08,40,34,1,1,28.125,-89.375,0,0,0
2014-08,40,35,2,2,28.125,-89.125,0,0,0
2014-08,40,36,5,1,28.125,-88.875,0,0,0
2014-08,40,37,1,1,28.125,-88.625,0,0,0
2014-08,40,40,1,1,28.125,-87.875,0,0,0
2014-08,40,42,1,1,28.125,-87.375,0,0,0
2014-08,40,43,5,2,28.125,-87.125,0,0,0
2014-08,40,44,7,2,28.125,-86.875,0,0,0
2014-08,40,45,3,2,28.125,-86.625,0,0,0
2014-08,40,46,1,1,28.125,-86.375,0,0,0
2014-08,40,49,1,1,28.125,-85.625,0,0,0
2014-08,40,50,2,2,28.125,-85.375,0,0,0
2014-08,41,26,1,1,28.375,-91.375,0,0,0
2014-08,41,27,1,1,28.375,-91.125,0,0,0
2014-08,41,29,1,1,28.375,-90.625,0,0,0
2014-08,41,30,2,1,28.375,-90.375,0,0,0
2014-08,41,31,2,1,28.375,-90.125,0,0,0
2014-08,41,37,1,1,28.375,-88.625,0,0,0
2014-08,41,38,2,1,28.375,-88.375,0,0,0
2014-08,41,39,1,1,28.375,-88.125,0,0,0
2014-08,41,40,1,1,28.375,-87.875,0,0,0
2014-08,41,42,1,1,28.375,-87.375,0,0,0
2014-08,41,43,2,2,28.375,-87.125,0,0,0
2014-08,41,44,2,1,28.375,-86.875,0,0,0
2014-08,41,45,6,3,28.375,-86.625,0,0,0
2014-08,41,47,2,2,28.375,-86.125,0,0,0
2014-08,41,48,2,2,28.375,-85.875,0,0,0
2014-08,41,49,4,2,28.375,-85.625,0,0,0
2014-08,41,50,3,2,28.375,-85.375,0,0,0
2014-08,41,51,2,1,28.375,-85.125,0,0,0
2014-08,42,32,2,1,28.625,-89.875,0,0,0
2014-08,42,35,1,1,28.625,-89.125,0,0,0
2014-08,42,38,2,1,28.625,-88.375,0,0,0
2014-08,42,39,4,2,28.625,-88.125,0,0,0
2014-08,42,41,1,1,28.625,-87.625,0,0,0
2014-08,42,42,1,1,28.625,-87.375,0,0,0
2014-08,42,43,5,3,28.625,-87.125,0,0,0
2014-08,42,44,1,1,28.625,-86.875,0,0,0
2014-08,42,45,3,2,28.625,-86.625,0,0,0
2014-08,42,47,2,1,28.625,-86.125,0,0,0
2014-08,42,48,1,1,28.625,-85.875,0,0,0
2014-08,43,36,3,1,28.875,-88.875,0,0,0
2014-08,43,38,1,1,28.875,-88.375,0,0,0
2014-08,43,41,3,2,28.875,-87.625,0,0,0
2014-08,43,43,2,1,28.875,-87.125,0,0,0
2014-08,43,44,5,2,28.875,-86.875,0,0,0
2014-08,43,45,9,2,28.875,-86.625,0,0,0
2014-08,43,46,5,1,28.875,-86.375,0,0,0
2014-08,44,36,1,1,29.125,-88.875,0,0,0
2014-08,44,38,1,1,29.125,-88.375,0,0,0
2014-08,44,40,2,1,29.125,-87.875,2,0,2
2014-08,44,43,1,1,29.125,-87.125,0,0,0
2014-08,44,44,1,1,29.125,-86.875,0,0,0
2014-08,44,45,1,1,29.125,-86.625,0,0,0
2014-08,45,40,0,0,29.375,-87.875,4,0,4
2014-08,45,41,1,1,29.375,-87.625,0,0,0
2014-08,45,42,2,1,29.375,-87.375,0,0,0
2014-08,45,44,2,1,29.375,-86.875,0,0,0
2014-08,46,39,0,0,29.625,-88.125,1,0,1
2014-08,46,42,1,1,29.625,-87.375,0,0,0
2014-08,47,45,1,1,29.875,-86.625,0,0,0
2014-09,2,44,0,0,18.625,-86.875,0,2,2
2014-09,2,53,0,0,18.625,-84.625,1,0,1
2014-09,2,54,0,0,18.625,-84.375,2,0,2
2014-09,2,55,0,0,18.625,-84.125,1,0,1
2014-09,2,56,0,0,18.625,-83.875,3,0,3
2014-09,2,57,0,0,18.625,-83.625,2,0,2
2014-09,2,58,0,0,18.625,-83.375,3,0,3
2014-09,2,59,0,0,18.625,-83.125,2,0,2
2014-09,3,45,0,0,18.875,-86.625,0,3,3
2014-09,3,46,0,0,18.875,-86.375,0,1,1
2014-09,3,51,0,0,18.875,-85.125,2,0,2
2014-09,3,52,0,0,18.875,-84.875,2,0,2
2014-09,3,53,0,0,18.875,-84.625,2,0,2
2014-09,4,46,0,0,19.125,-86.375,0,2,2
2014-09,4,47,0,0,19.125,-86.125,0,3,3
2014-09,4,48,0,0,19.125,-85.875,0,2,2
2014-09,4,49,0,0,19.125,-85.625,2,0,2
2014-09,4,50,0,0,19.125,-85.375,2,0,2
2014-09,4,51,0,0,19.125,-85.125,1,0,1
2014-09,5,48,0,0,19.375,-85.875,0,1,1
2014-09,5,49,0,0,19.375,-85.625,0,3,3
2014-09,5,50,0,0,19.375,-85.375,0,1,1
2014-09,5,61,0,0,19.375,-82.625,4,0,4
2014-09,8,12,0,0,20.125,-94.875,0,8,8
2014-09,9,12,0,0,20.375,-94.875,0,3,3
2014-09,9,69,0,0,20.375,-80.625,2,0,2
2014-09,9,70,0,0,20.375,-80.375,6,0,6
2014-09,10,12,0,0,20.625,-94.875,0,12,12
2014-09,10,13,0,0,20.625,-94.625,0,7,7
2014-09,10,63,0,0,20.625,-82.125,1,0,1
2014-09,10,64,0,0,20.625,-81.875,1,0,1
2014-09,10,65,0,0,20.625,-81.625,2,0,2
2014-09,10,69,0,0,20.625,-80.625,2,0,2
2014-09,10,70,0,0,20.625,-80.375,3,0,3
2014-09,11,6,0,0,20.875,-96.375,1,0,1
2014-09,11,66,0,0,20.875,-81.375,2,0,2
2014-09,11,67,0,0,20.875,-81.125,1,0,1
2014-09,11,68,0,0,20.875,-80.875,3,0,3
2014-09,11,69,0,0,20.875,-80.625,3,0,3
2014-09,12,6,0,0,21.125,-96.375,23,0,23
2014-09,14,19,0,0,21.625,-93.125,3,0,3
2014-09,15,18,0,0,21.875,-93.375,4,0,4
2014-09,15,19,0,0,21.875,-93.125,1,0,1
2014-09,16,17,0,0,22.125,-93.625,1,0,1
2014-09,16,18,0,0,22.125,-93.375,5,0,5
2014-09,17,16,0,0,22.375,-93.875,1,0,1
2014-09,17,17,0,0,22.375,-93.625,14,0,14
2014-09,19,41,0,0,22.875,-87.625,7,0,7
2014-09,19,42,0,0,22.875,-87.375,1,0,1
2014-09,20,42,0,0,23.125,-87.375,3,0,3
2014-09,21,8,0,0,23.375,-95.875,0,5,5
2014-09,21,41,0,0,23.375,-87.625,1,0,1
2014-09,21,47,0,0,23.375,-86.125,0,1,1
2014-09,21,48,0,0,23.375,-85.875,0,3,3
2014-09,21,49,0,0,23.375,-85.625,0,6,6
2014-09,22,9,0,0,23.625,-95.625,0,1,1
2014-09,22,41,0,0,23.625,-87.625,2,0,2
2014-09,22,47,0,0,23.625,-86.125,0,2,2
2014-09,22,49,0,0,23.625,-85.625,0,4,4
2014-09,22,50,0,0,23.625,-85.375,0,4,4
2014-09,23,8,0,0,23.875,-95.875,0,10,10
2014-09,23,9,0,0,23.875,-95.625,0,8,8
2014-09,23,46,0,0,23.875,-86.375,0,1,1
2014-09,24,9,0,0,24.125,-95.625,0,6,6
2014-09,24,27,1,1,24.125,-91.125,0,0,0
2014-09,24,42,0,0,24.125,-87.375,1,0,1
2014-09,25,24,1,1,24.375,-91.875,0,0,0
2014-09,25,30,1,1,24.375,-90.375,0,0,0
2014-09,25,32,1,1,24.375,-89.875,0,0,0
2014-09,25,35,1,1,24.375,-89.125,0,0,0
2014-09,25,42,0,0,24.375,-87.375,3,0,3
2014-09,26,38,1,1,24.625,-88.375,0,0,0
2014-09,26,39,1,1,24.625,-88.125,0,0,0
2014-09,26,40,1,1,24.625,-87.875,0,0,0
2014-09,26,41,4,1,24.625,-87.625,0,0,0
2014-09,26,42,0,0,24.625,-87.375,1,0,1
2014-09,26,43,1,1,24.625,-87.125,0,0,0
2014-09,27,23,0,0,24.875,-92.125,2,0,2
2014-09,27,24,0,0,24.875,-91.875,4,0,4
2014-09,27,39,1,1,24.875,-88.125,0,0,0
2014-09,27,40,3,1,24.875,-87.875,0,0,0
2014-09,28,24,0,0,25.125,-91.875,2,0,2
2014-09,28,25,0,0,25.125,-91.625,4,0,4
2014-09,28,26,0,0,25.125,-91.375,4,0,4
2014-09,28,27,0,0,25.125,-91.125,2,0,2
2014-09,28,44,1,1,25.125,-86.875,0,0,0
2014-09,29,26,0,0,25.375,-91.375,1,0,1
2014-09,29,27,0,0,25.375,-91.125,4,0,4
2014-09,29,28,0,0,25.375,-90.875,1,0,1
2014-09,29,46,1,1,25.375,-86.375,0,0,0
2014-09,29,48,1,1,25.375,-85.875,0,0,0
2014-09,30,39,1,1,25.625,-88.125,0,0,0
2014-09,30,40,1,1,25.625,-87.875,0,0,0
2014-09,30,46,1,1,25.625,-86.375,0,0,0
2014-09,30,47,2,1,25.625,-86.125,0,0,0
2014-09,31,38,1,1,25.875,-88.375,0,0,0
2014-09,31,39,1,1,25.875,-88.125,0,0,0
2014-09,31,40,1,1,25.875,-87.875,0,0,0
2014-09,31,42,1,1,25.875,-87.375,0,0,0
2014-09,31,44,1,1,25.875,-86.875,0,0,0
2014-09,31,47,2,1,25.875,-86.125,0,0,0
2014-09,31,48,1,1,25.875,-85.875,0,0,0
2014-09,31,50,1,1,25.875,-85.375,0,0,0
2014-09,32,30,3,1,26.125,-90.375,0,0,0
2014-09,32,31,3,1,26.125,-90.125,0,0,0
2014-09,32,40,1,1,26.125,-87.875,0,0,0
2014-09,32,45,1,1,26.125,-86.625,0,0,0
2014-09,32,47,3,2,26.125,-86.125,0,0,0
2014-09,32,49,2,1,26.125,-85.625,0,0,0
2014-09,32,50,2,1,26.125,-85.375,0,0,0
2014-09,33,9,0,0,26.375,-95.625,6,0,6
2014-09,33,10,0,0,26.375,-95.375,6,0,6
2014-09,33,11,0,0,26.375,-95.125,3,0,3
2014-09,33,30,1,1,26.375,-90.375,0,0,0
2014-09,33,31,2,1,26.375,-90.125,0,0,0
2014-09,33,40,1,1,26.375,-87.875,0,0,0
2014-09,33,47,2,1,26.375,-86.125,0,0,0
2014-09,33,48,2,2,26.375,-85.875,0,0,0
2014-09,34,10,0,0,26.625,-95.375,9,0,9
2014-09,34,17,0,0,26.625,-93.625,0,2,2
2014-09,34,18,0,0,26.625,-93.375,0,14,14
2014-09,34,19,0,0,26.625,-93.125,0,7,7
2014-09,34,20,0,0,26.625,-92.875,0,7,7
2014-09,34,21,1,1,26.625,-92.625,0,0,0
2014-09,34,47,1,1,26.625,-86.125,0,0,0
2014-09,34,48,1,1,26.625,-85.875,0,0,0
2014-09,34,49,1,1,26.625,-85.625,0,0,0
2014-09,35,18,1,1,26.875,-93.375,0,0,0
2014-09,35,19,2,1,26.875,-93.125,0,0,0
2014-09,35,20,2,1,26.875,-92.875,0,0,0
2014-09,35,21,1,1,26.875,-92.625,0,0,0
2014-09,35,22,1,1,26.875,-92.375,0,0,0
2014-09,35,29,3,1,26.875,-90.625,0,0,0
2014-09,35,38,0,0,26.875,-88.375,0,6,6
2014-09,35,39,0,0,26.875,-88.125,0,10,10
2014-09,35,40,0,0,26.875,-87.875,0,14,14
2014-09,35,49,1,1,26.875,-85.625,0,0,0
2014-09,36,6,1,1,27.125,-96.375,0,0,0
2014-09,36,7,1,1,27.125,-96.125,0,0,0
2014-09,36,8,1,1,27.125,-95.875,0,0,0
2014-09,36,9,1,1,27.125,-95.625,0,0,0
2014-09,36,11,1,1,27.125,-95.125,0,0,0
2014-09,36,12,1,1,27.125,-94.875,0,0,0
2014-09,36,19,1,1,27.125,-93.125,0,0,0
2014-09,36,26,3,1,27.125,-91.375,0,0,0
2014-09,36,27,1,1,27.125,-91.125,0,0,0
2014-09,36,28,3,1,27.125,-90.875,0,0,0
2014-09,36,43,1,1,27.125,-87.125,0,0,0
2014-09,36,44,1,1,27.125,-86.875,0,0,0
2014-09,36,46,1,1,27.125,-86.375,0,0,0
2014-09,36,47,1,1,27.125,-86.125,0,0,0
2014-09,36,49,1,1,27.125,-85.625,0,0,0
2014-09,36,53,1,1,27.125,-84.625,0,0,0
2014-09,37,6,1,1,27.375,-96.375,0,0,0
2014-09,37,12,1,1,27.375,-94.875,0,0,0
2014-09,37,15,1,1,27.375,-94.125,0,0,0
2014-09,37,18,1,1,27.375,-93.375,0,0,0
2014-09,37,20,1,1,27.375,-92.875,0,0,0
2014-09,37,21,1,1,27.375,-92.625,0,0,0
2014-09,37,22,1,1,27.375,-92.375,0,0,0
2014-09,37,23,1,1,27.375,-92.125,0,0,0
2014-09,37,24,2,1,27.375,-91.875,0,0,0
2014-09,37,25,5,2,27.375,-91.625,0,0,0
2014-09,37,26,1,1,27.375,-91.375,0,0,0
2014-09,37,27,1,1,27.375,-91.125,0,0,0
2014-09,37,47,1,1,27.375,-86.125,0,0,0
2014-09,37,48,10,2,27.375,-85.875,0,0,0
2014-09,37,49,1,1,27.375,-85.625,0,0,0
2014-09,37,54,1,1,27.375,-84.375,0,0,0
2014-09,38,14,1,1,27.625,-94.375,0,0,0
2014-09,38,22,1,1,27.625,-92.375,0,0,0
2014-09,38,23,2,1,27.625,-92.125,0,0,0
2014-09,38,24,1,1,27.625,-91.875,0,0,0
2014-09,38,25,1,1,27.625,-91.625,0,0,0
2014-09,38,43,1,1,27.625,-87.125,0,0,0
2014-09,38,44,1,1,27.625,-86.875,0,0,0
2014-09,38,48,8,2,27.625,-85.875,0,0,0
2014-09,38,49,5,1,27.625,-85.625,0,0,0
2014-09,38,50,2,1,27.625,-85.375,0,0,0
2014-09,38,51,1,1,27.625,-85.125,0,0,0
2014-09,38,54,1,1,27.625,-84.375,0,0,0
2014-09,39,24,2,1,27.875,-91.875,0,0,0
2014-09,39,25,1,1,27.875,-91.625,0,0,0
2014-09,39,46,3,3,27.875,-86.375,0,0,0
2014-09,39,47,1,1,27.875,-86.125,0,0,0
2014-09,39,48,3,2,27.875,-85.875,0,0,0
2014-09,39,50,1,1,27.875,-85.375,0,0,0
2014-09,39,51,2,1,27.875,-85.125,0,0,0
2014-09,39,53,1,1,27.875,-84.625,0,0,0
2014-09,40,44,1,1,28.125,-86.875,0,0,0
2014-09,40,45,1,1,28.125,-86.625,0,0,0
2014-09,40,46,7,3,28.125,-86.375,0,0,0
2014-09,40,47,6,1,28.125,-86.125,0,0,0
2014-09,40,50,3,2,28.125,-85.375,0,0,0
2014-09,40,51,1,1,28.125,-85.125,0,0,0
2014-09,41,43,1,1,28.375,-87.125,1,0,1
2014-09,41,45,3,2,28.375,-86.625,0,0,0
2014-09,41,46,8,3,28.375,-86.375,0,0,0
2014-09,41,47,9,3,28.375,-86.125,0,0,0
2014-09,41,48,3,2,28.375,-85.875,0,0,0
2014-09,41,49,4,2,28.375,-85.625,0,0,0
2014-09,42,42,1,1,28.625,-87.375,1,0,1
2014-09,42,43,0,0,28.625,-87.125,3,0,3
2014-09,42,45,1,1,28.625,-86.625,0,0,0
2014-09,42,46,2,2,28.625,-86.375,0,0,0
2014-09,42,48,2,1,28.625,-85.875,0,0,0
2014-09,43,36,2,1,28.875,-88.875,0,0,0
2014-09,43,39,1,1,28.875,-88.125,1,0,1
2014-09,43,40,0,0,28.875,-87.875,1,0,1
2014-09,43,41,0,0,28.875,-87.625,1,0,1
2014-09,43,42,1,1,28.875,-87.375,1,0,1
2014-09,43,46,5,1,28.875,-86.375,0,0,0
2014-09,43,47,3,1,28.875,-86.125,0,0,0
2014-09,44,39,0,0,29.125,-88.125,19,0,19
2014-09,44,40,0,0,29.125,-87.875,2,0,2
2014-09,44,45,1,1,29.125,-86.625,0,0,0
2014-10,2,53,0,0,18.625,-84.625,0,2,2
2014-10,2,54,0,0,18.625,-84.375,0,3,3
2014-10,2,55,0,0,18.625,-84.125,0,1,1
2014-10,2,56,0,0,18.625,-83.875,0,3,3
2014-10,2,57,0,0,18.625,-83.625,0,3,3
2014-10,3,51,0,0,18.875,-85.125,0,2,2
2014-10,3,52,0,0,18.875,-84.875,0,1,1
2014-10,3,53,0,0,18.875,-84.625,0,1,1
2014-10,3,57,0,0,18.875,-83.625,0,2,2
2014-10,3,58,0,0,18.875,-83.375,0,1,1
2014-10,4,50,0,0,19.125,-85.375,0,1,1
2014-10,4,58,0,0,19.125,-83.375,0,1,1
2014-10,5,48,0,0,19.375,-85.875,1,0,1
2014-10,5,49,0,0,19.375,-85.625,2,0,2
2014-10,5,57,0,0,19.375,-83.625,0,1,1
2014-10,5,59,0,0,19.375,-83.125,1,0,1
2014-10,5,60,0,0,19.375,-82.875,4,0,4
2014-10,5,61,0,0,19.375,-82.625,2,0,2
2014-10,6,17,0,0,19.625,-93.625,1,0,1
2014-10,6,18,0,0,19.625,-93.375,2,0,2
2014-10,6,19,0,0,19.625,-93.125,1,0,1
2014-10,6,47,0,0,19.625,-86.125,6,0,6
2014-10,6,48,0,0,19.625,-85.875,4,0,4
2014-10,6,62,0,0,19.625,-82.375,2,0,2
2014-10,7,17,0,0,19.875,-93.625,1,0,1
2014-10,7,20,0,0,19.875,-92.875,1,0,1
2014-10,7,47,0,0,19.875,-86.125,6,0,6
2014-10,7,63,0,0,19.875,-82.125,3,0,3
2014-10,7,64,0,0,19.875,-81.875,3,0,3
2014-10,8,13,0,0,20.125,-94.625,0,7,7
2014-10,8,14,0,0,20.125,-94.375,0,13,13
2014-10,8,15,0,0,20.125,-94.125,0,1,1
2014-10,8,21,0,0,20.125,-92.625,3,0,3
2014-10,8,22,0,0,20.125,-92.375,1,0,1
2014-10,8,23,0,0,20.125,-92.125,1,0,1
2014-10,8,24,0,0,20.125,-91.875,2,0,2
2014-10,8,47,0,0,20.125,-86.125,1,0,1
2014-10,8,65,0,0,20.125,-81.625,5,0,5
2014-10,8,67,0,0,20.125,-81.125,2,0,2
2014-10,8,68,0,0,20.125,-80.875,1,0,1
2014-10,9,65,0,0,20.375,-81.625,2,0,2
2014-10,9,66,0,0,20.375,-81.375,5,0,5
2014-10,9,68,0,0,20.375,-80.875,1,0,1
2014-10,10,48,0,0,20.625,-85.875,1,0,1
2014-10,11,48,0,0,20.875,-85.875,4,0,4
2014-10,11,49,0,0,20.875,-85.625,1,0,1
2014-10,12,48,0,0,21.125,-85.875,3,0,3
2014-10,12,49,0,0,21.125,-85.625,2,0,2
2014-10,14,47,1,1,21.625,-86.125,0,0,0
2014-10,15,13,0,0,21.875,-94.625,1,0,1
2014-10,15,14,0,0,21.875,-94.375,5,0,5
2014-10,16,14,0,0,22.125,-94.375,3,0,3
2014-10,16,15,0,0,22.125,-94.125,6,0,6
2014-10,16,16,0,0,22.125,-93.875,4,0,4
2014-10,16,45,1,1,22.125,-86.625,0,0,0
2014-10,16,50,1,1,22.125,-85.375,0,0,0
2014-10,16,52,1,1,22.125,-84.875,0,0,0
2014-10,17,16,0,0,22.375,-93.875,5,0,5
2014-10,17,45,1,1,22.375,-86.625,0,0,0
2014-10,18,7,0,0,22.625,-96.125,0,10,10
2014-10,18,27,0,0,22.625,-91.125,0,2,2
2014-10,18,28,0,0,22.625,-90.875,0,5,5
2014-10,18,44,1,1,22.625,-86.875,0,0,0
2014-10,19,7,0,0,22.875,-96.125,0,12,12
2014-10,19,27,0,0,22.875,-91.125,0,1,1
2014-10,19,28,0,0,22.875,-90.875,0,7,7
2014-10,19,44,1,1,22.875,-86.875,0,0,0
2014-10,20,7,0,0,23.125,-96.125,0,2,2
2014-10,20,8,0,0,23.125,-95.875,0,4,4
2014-10,20,28,0,0,23.125,-90.875,0,10,10
2014-10,20,45,1,1,23.125,-86.625,0,0,0
2014-10,21,5,1,1,23.375,-96.625,0,0,0
2014-10,21,8,0,0,23.375,-95.875,0,3,3
2014-10,22,4,1,1,23.625,-96.875,0,0,0
2014-10,22,9,2,1,23.625,-95.625,0,0,0
2014-10,22,12,1,1,23.625,-94.875,0,0,0
2014-10,22,44,1,1,23.625,-86.875,0,0,0
2014-10,22,49,0,0,23.625,-85.625,0,2,2
2014-10,22,50,0,0,23.625,-85.375,0,5,5
2014-10,23,6,1,1,23.875,-96.375,0,0,0
2014-10,23,7,1,1,23.875,-96.125,0,0,0
2014-10,23,8,1,1,23.875,-95.875,0,0,0
2014-10,23,14,2,1,23.875,-94.375,0,0,0
2014-10,23,16,1,1,23.875,-93.875,0,0,0
2014-10,23,19,1,1,23.875,-93.125,0,0,0
2014-10,23,47,0,0,23.875,-86.125,0,1,1
2014-10,23,56,0,0,23.875,-83.875,5,0,5
2014-10,24,11,1,1,24.125,-95.125,0,0,0
2014-10,24,21,1,1,24.125,-92.625,0,0,0
2014-10,24,43,1,1,24.125,-87.125,0,0,0
2014-10,24,47,0,0,24.125,-86.125,0,1,1
2014-10,24,56,0,0,24.125,-83.875,3,0,3
2014-10,25,13,1,1,24.375,-94.625,0,0,0
2014-10,25,22,3,1,24.375,-92.375,0,0,0
2014-10,25,48,0,0,24.375,-85.875,0,1,1
2014-10,25,49,0,0,24.375,-85.625,0,1,1
2014-10,26,11,0,0,24.625,-95.125,6,0,6
2014-10,26,15,2,1,24.625,-94.125,0,0,0
2014-10,26,21,3,1,24.625,-92.625,2,0,2
2014-10,26,22,2,1,24.625,-92.375,2,0,2
2014-10,26,48,0,0,24.625,-85.875,0,2,2
2014-10,26,56,0,0,24.625,-83.875,3,0,3
2014-10,27,11,0,0,24.875,-95.125,9,0,9
2014-10,27,12,0,0,24.875,-94.875,5,0,5
2014-10,27,13,2,2,24.875,-94.625,0,0,0
2014-10,27,14,4,2,24.875,-94.375,0,0,0
2014-10,27,15,1,1,24.875,-94.125,0,0,0
2014-10,27,17,1,1,24.875,-93.625,0,0,0
2014-10,27,18,1,1,24.875,-93.375,0,0,0
2014-10,27,19,1,1,24.875,-93.125,0,0,0
2014-10,27,20,1,1,24.875,-92.875,2,0,2
2014-10,27,21,1,1,24.875,-92.625,0,0,0
2014-10,27,22,0,0,24.875,-92.375,3,0,3
2014-10,27,45,1,1,24.875,-86.625,0,0,0
2014-10,27,49,0,0,24.875,-85.625,0,3,3
2014-10,27,56,0,0,24.875,-83.875,3,0,3
2014-10,28,11,2,1,25.125,-95.125,0,0,0
2014-10,28,12,3,1,25.125,-94.875,5,0,5
2014-10,28,17,1,1,25.125,-93.625,0,0,0
2014-10,28,37,0,0,25.125,-88.625,1,0,1
2014-10,28,38,0,0,25.125,-88.375,4,0,4
2014-10,28,40,0,0,25.125,-87.875,2,0,2
2014-10,28,47,0,0,25.125,-86.125,0,2,2
2014-10,28,48,0,0,25.125,-85.875,0,8,8
2014-10,28,49,0,0,25.125,-85.625,0,1,1
2014-10,28,55,0,0,25.125,-84.125,1,0,1
2014-10,28,56,0,0,25.125,-83.875,7,0,7
2014-10,29,12,2,1,25.375,-94.875,0,0,0
2014-10,29,35,0,0,25.375,-89.125,1,0,1
2014-10,29,36,0,0,25.375,-88.875,3,0,3
2014-10,29,37,0,0,25.375,-88.625,4,0,4
2014-10,29,46,1,1,25.375,-86.375,0,0,0
2014-10,29,47,0,0,25.375,-86.125,0,4,4
2014-10,29,56,0,0,25.375,-83.875,1,0,1
2014-10,30,12,1,1,25.625,-94.875,0,0,0
2014-10,30,31,0,0,25.625,-90.125,3,0,3
2014-10,30,32,0,0,25.625,-89.875,6,0,6
2014-10,30,33,0,0,25.625,-89.625,2,0,2
2014-10,30,34,0,0,25.625,-89.375,4,0,4
2014-10,30,35,0,0,25.625,-89.125,1,0,1
2014-10,30,46,1,1,25.625,-86.375,0,0,0
2014-10,30,47,3,1,25.625,-86.125,0,0,0
2014-10,30,48,1,1,25.625,-85.875,0,0,0
2014-10,31,10,1,1,25.875,-95.375,0,0,0
2014-10,31,11,2,1,25.875,-95.125,0,0,0
2014-10,31,12,1,1,25.875,-94.875,0,0,0
2014-10,32,45,1,1,26.125,-86.625,0,0,0
2014-10,32,48,0,0,26.125,-85.875,3,0,3
2014-10,33,12,1,1,26.375,-94.875,0,0,0
2014-10,33,45,1,1,26.375,-86.625,0,0,0
2014-10,33,47,1,1,26.375,-86.125,0,0,0
2014-10,33,48,0,0,26.375,-85.875,6,0,6
2014-10,34,10,0,0,26.625,-95.375,0,1,1
2014-10,34,11,0,0,26.625,-95.125,0,4,4
2014-10,34,12,0,0,26.625,-94.875,0,6,6
2014-10,34,13,1,1,26.625,-94.625,0,6,6
2014-10,34,14,0,0,26.625,-94.375,0,3,3
2014-10,34,15,0,0,26.625,-94.125,0,4,4
2014-10,34,16,0,0,26.625,-93.875,0,4,4
2014-10,34,17,0,0,26.625,-93.625,0,3,3
2014-10,34,41,1,1,26.625,-87.625,0,0,0
2014-10,34,45,2,1,26.625,-86.625,0,0,0
2014-10,34,46,1,1,26.625,-86.375,0,0,0
2014-10,34,47,1,1,26.625,-86.125,1,0,1
2014-10,34,48,2,2,26.625,-85.875,2,0,2
2014-10,34,49,4,2,26.625,-85.625,0,0,0
2014-10,35,12,1,1,26.875,-94.875,0,0,0
2014-10,35,41,1,1,26.875,-87.625,0,5,5
2014-10,35,43,2,2,26.875,-87.125,0,0,0
2014-10,35,45,2,2,26.875,-86.625,0,0,0
2014-10,35,46,1,1,26.875,-86.375,0,0,0
2014-10,35,47,1,1,26.875,-86.125,2,0,2
2014-10,35,48,1,1,26.875,-85.875,0,0,0
2014-10,35,49,3,2,26.875,-85.625,0,0,0
2014-10,36,6,1,1,27.125,-96.375,0,0,0
2014-10,36,7,1,1,27.125,-96.125,0,0,0
2014-10,36,11,1,1,27.125,-95.125,0,0,0
2014-10,36,18,1,1,27.125,-93.375,0,0,0
2014-10,36,35,0,0,27.125,-89.125,0,12,12
2014-10,36,36,0,0,27.125,-88.875,0,5,5
2014-10,36,37,0,0,27.125,-88.625,0,8,8
2014-10,36,38,1,1,27.125,-88.375,0,0,0
2014-10,36,39,1,1,27.125,-88.125,0,0,0
2014-10,36,40,4,1,27.125,-87.875,0,0,0
2014-10,36,45,2,1,27.125,-86.625,0,0,0
2014-10,36,46,1,1,27.125,-86.375,0,0,0
2014-10,36,47,4,1,27.125,-86.125,0,0,0
2014-10,36,48,6,2,27.125,-85.875,0,0,0
2014-10,36,49,1,1,27.125,-85.625,0,0,0
2014-10,36,50,2,1,27.125,-85.375,0,0,0
2014-10,37,6,1,1,27.375,-96.375,0,0,0
2014-10,37,7,2,2,27.375,-96.125,0,0,0
2014-10,37,8,1,1,27.375,-95.875,0,0,0
2014-10,37,10,3,1,27.375,-95.375,0,0,0
2014-10,37,18,3,1,27.375,-93.375,0,0,0
2014-10,37,20,1,1,27.375,-92.875,0,0,0
2014-10,37,27,1,1,27.375,-91.125,0,0,0
2014-10,37,28,1,1,27.375,-90.875,0,0,0
2014-10,37,30,0,0,27.375,-90.375,0,5,5
2014-10,37,35,0,0,27.375,-89.125,0,1,1
2014-10,37,45,1,1,27.375,-86.625,0,0,0
2014-10,37,46,3,1,27.375,-86.375,0,0,0
2014-10,37,47,1,1,27.375,-86.125,0,0,0
2014-10,37,48,3,1,27.375,-85.875,0,0,0
2014-10,37,49,3,1,27.375,-85.625,0,0,0
2014-10,38,8,1,1,27.625,-95.875,0,0,0
2014-10,38,9,1,1,27.625,-95.625,0,0,0
2014-10,38,11,1,1,27.625,-95.125,0,0,0
2014-10,38,12,1,1,27.625,-94.875,0,0,0
2014-10,38,14,1,1,27.625,-94.375,0,0,0
2014-10,38,17,1,1,27.625,-93.625,0,0,0
2014-10,38,22,1,1,27.625,-92.375,0,0,0
2014-10,38,29,1,1,27.625,-90.625,0,0,0
2014-10,38,30,2,1,27.625,-90.375,0,0,0
2014-10,38,31,1,1,27.625,-90.125,0,0,0
2014-10,38,32,1,1,27.625,-89.875,0,0,0
2014-10,38,44,2,1,27.625,-86.875,0,0,0
2014-10,38,48,1,1,27.625,-85.875,0,0,0
2014-10,38,49,1,1,27.625,-85.625,0,0,0
2014-10,39,23,1,1,27.875,-92.125,0,0,0
2014-10,39,33,1,1,27.875,-89.625,0,0,0
2014-10,39,42,1,1,27.875,-87.375,0,0,0
2014-10,39,44,1,1,27.875,-86.875,1,0,1
2014-10,39,46,1,1,27.875,-86.375,4,0,4
2014-10,39,47,0,0,27.875,-86.125,1,0,1
2014-10,40,26,1,1,28.125,-91.375,0,0,0
2014-10,40,28,1,1,28.125,-90.875,0,0,0
2014-10,40,36,1,1,28.125,-88.875,0,0,0
2014-10,40,41,1,1,28.125,-87.625,0,0,0
2014-10,40,45,0,0,28.125,-86.625,2,0,2
2014-10,40,46,0,0,28.125,-86.375,2,0,2
2014-10,40,49,1,1,28.125,-85.625,0,0,0
2014-10,41,31,1,1,28.375,-90.125,0,0,0
2014-10,41,33,1,1,28.375,-89.625,0,0,0
2014-10,41,34,2,2,28.375,-89.375,0,0,0
2014-10,41,35,1,1,28.375,-89.125,0,0,0
2014-10,41,36,2,1,28.375,-88.875,0,0,0
2014-10,41,37,1,1,28.375,-88.625,0,0,0
2014-10,41,38,4,1,28.375,-88.375,0,0,0
2014-10,41,39,1,1,28.375,-88.125,0,0,0
2014-10,41,40,1,1,28.375,-87.875,8,0,8
2014-10,41,41,0,0,28.375,-87.625,2,0,2
2014-10,41,43,0,0,28.375,-87.125,1,0,1
2014-10,41,44,0,0,28.375,-86.875,2,0,2
2014-10,41,49,2,1,28.375,-85.625,0,0,0
2014-10,42,35,1,1,28.625,-89.125,0,0,0
2014-10,42,36,1,1,28.625,-88.875,0,0,0
2014-10,42,37,1,1,28.625,-88.625,0,0,0
2014-10,42,40,1,1,28.625,-87.875,1,0,1
2014-10,42,41,0,0,28.625,-87.625,1,0,1
2014-10,42,43,1,1,28.625,-87.125,0,0,0
2014-10,42,46,1,1,28.625,-86.375,0,0,0
2014-10,42,49,1,1,28.625,-85.625,0,0,0
2014-10,43,36,4,1,28.875,-88.875,0,0,0
2014-10,43,37,1,1,28.875,-88.625,0,0,0
2014-10,43,38,4,1,28.875,-88.375,0,0,0
2014-11,0,49,0,0,18.125,-85.625,2,0,2
2014-11,1,49,0,0,18.375,-85.625,2,0,2
2014-11,1,50,0,0,18.375,-85.375,2,0,2
2014-11,1,51,0,0,18.375,-85.125,2,0,2
2014-11,1,52,0,0,18.375,-84.875,2,0,2
2014-11,1,53,0,0,18.375,-84.625,2,0,2
2014-11,2,54,0,0,18.625,-84.375,2,0,2
2014-11,2,55,0,0,18.625,-84.125,2,0,2
2014-11,2,56,0,0,18.625,-83.875,1,0,1
2014-11,3,56,0,0,18.875,-83.875,1,0,1
2014-11,3,57,0,0,18.875,-83.625,2,0,2
2014-11,4,46,0,0,19.125,-86.375,0,1,1
2014-11,4,47,0,0,19.125,-86.125,0,2,2
2014-11,4,48,0,0,19.125,-85.875,0,2,2
2014-11,4,49,0,0,19.125,-85.625,0,2,2
2014-11,4,50,0,0,19.125,-85.375,0,2,2
2014-11,4,58,0,0,19.125,-83.375,1,0,1
2014-11,4,59,0,0,19.125,-83.125,1,0,1
2014-11,5,45,0,0,19.375,-86.625,0,1,1
2014-11,5,46,0,0,19.375,-86.375,0,2,2
2014-11,6,45,0,0,19.625,-86.625,0,1,1
2014-11,6,46,0,0,19.625,-86.375,0,1,1
2014-11,6,47,0,0,19.625,-86.125,0,1,1
2014-11,7,15,0,0,19.875,-94.125,1,0,1
2014-11,7,16,0,0,19.875,-93.875,4,0,4
2014-11,7,17,0,0,19.875,-93.625,2,0,2
2014-11,7,18,0,0,19.875,-93.375,4,0,4
2014-11,7,68,0,0,19.875,-80.875,0,8,8
2014-11,7,69,0,0,19.875,-80.625,0,11,11
2014-11,7,70,0,0,19.875,-80.375,0,3,3
2014-11,7,71,0,0,19.875,-80.125,0,2,2
2014-11,8,12,0,0,20.125,-94.875,3,0,3
2014-11,8,13,0,0,20.125,-94.625,2,0,2
2014-11,8,17,0,0,20.125,-93.625,3,0,3
2014-11,8,18,0,0,20.125,-93.375,4,0,4
2014-11,8,68,0,0,20.125,-80.875,0,2,2
2014-11,9,12,0,0,20.375,-94.875,7,0,7
2014-11,9,59,0,0,20.375,-83.125,0,1,1
2014-11,12,48,0,0,21.125,-85.875,2,0,2
2014-11,13,24,0,0,21.375,-91.875,0,1,1
2014-11,13,48,0,0,21.375,-85.875,4,0,4
2014-11,14,24,0,0,21.625,-91.875,0,4,4
2014-11,14,47,0,0,21.625,-86.125,2,0,2
2014-11,14,48,0,0,21.625,-85.875,1,0,1
2014-11,15,23,0,0,21.875,-92.125,0,2,2
2014-11,15,24,0,0,21.875,-91.875,0,1,1
2014-11,15,25,0,0,21.875,-91.625,0,3,3
2014-11,15,46,0,0,21.875,-86.375,3,0,3
2014-11,16,23,0,0,22.125,-92.125,0,5,5
2014-11,16,24,0,0,22.125,-91.875,0,2,2
2014-11,16,25,0,0,22.125,-91.625,0,1,1
2014-11,16,45,0,0,22.125,-86.625,1,0,1
2014-11,16,46,0,0,22.125,-86.375,3,0,3
2014-11,17,44,0,0,22.375,-86.875,1,0,1
2014-11,17,45,0,0,22.375,-86.625,7,0,7
2014-11,18,10,0,0,22.625,-95.375,0,4,4
2014-11,18,11,0,0,22.625,-95.125,0,5,5
2014-11,18,28,0,0,22.625,-90.875,0,2,2
2014-11,18,43,0,0,22.625,-87.125,1,0,1
2014-11,18,44,0,0,22.625,-86.875,2,0,2
2014-11,19,6,1,1,22.875,-96.375,0,0,0
2014-11,19,7,0,0,22.875,-96.125,0,5,5
2014-11,19,8,0,0,22.875,-95.875,0,3,3
2014-11,19,9,0,0,22.875,-95.625,0,8,8
2014-11,19,10,0,0,22.875,-95.375,0,3,3
2014-11,19,28,0,0,22.875,-90.875,0,4,4
2014-11,19,29,0,0,22.875,-90.625,0,1,1
2014-11,19,42,0,0,22.875,-87.375,1,0,1
2014-11,19,43,0,0,22.875,-87.125,1,0,1
2014-11,20,3,5,1,23.125,-97.125,0,0,0
2014-11,20,4,2,1,23.125,-96.875,0,0,0
2014-11,20,6,3,1,23.125,-96.375,0,0,0
2014-11,20,28,0,0,23.125,-90.875,0,1,1
2014-11,20,29,0,0,23.125,-90.625,0,1,1
2014-11,20,41,0,0,23.125,-87.625,1,0,1
2014-11,21,3,4,1,23.375,-97.125,0,0,0
2014-11,21,4,1,1,23.375,-96.875,0,0,0
2014-11,21,5,1,1,23.375,-96.625,0,0,0
2014-11,22,4,7,2,23.625,-96.875,0,0,0
2014-11,22,5,3,2,23.625,-96.625,0,0,0
2014-11,22,6,1,1,23.625,-96.375,0,0,0
2014-11,22,8,3,1,23.625,-95.875,0,0,0
2014-11,22,9,1,1,23.625,-95.625,0,0,0
2014-11,22,57,0,0,23.625,-83.625,6,0,6
2014-11,22,58,0,0,23.625,-83.375,5,0,5
2014-11,22,59,0,0,23.625,-83.125,2,0,2
2014-11,23,5,3,1,23.875,-96.625,0,0,0
2014-11,23,6,2,2,23.875,-96.375,0,0,0
2014-11,23,54,0,0,23.875,-84.375,0,2,2
2014-11,23,57,0,0,23.875,-83.625,2,0,2
2014-11,24,4,1,1,24.125,-96.875,0,0,0
2014-11,24,5,1,1,24.125,-96.625,0,0,0
2014-11,24,6,1,1,24.125,-96.375,0,0,0
2014-11,24,11,0,0,24.125,-95.125,11,0,11
2014-11,24,12,0,0,24.125,-94.875,10,0,10
2014-11,25,2,1,1,24.375,-97.375,0,0,0
2014-11,25,11,0,0,24.375,-95.125,5,0,5
2014-11,25,46,0,0,24.375,-86.375,0,1,1
2014-11,25,47,0,0,24.375,-86.125,0,1,1
2014-11,25,48,0,0,24.375,-85.875,0,1,1
2014-11,25,49,0,0,24.375,-85.625,0,8,8
2014-11,25,50,0,0,24.375,-85.375,0,13,13
2014-11,26,3,1,1,24.625,-97.125,0,0,0
2014-11,26,5,1,1,24.625,-96.625,0,0,0
2014-11,26,6,1,1,24.625,-96.375,0,0,0
2014-11,26,11,0,0,24.625,-95.125,4,0,4
2014-11,26,22,1,1,24.625,-92.375,0,0,0
2014-11,26,44,0,0,24.625,-86.875,0,1,1
2014-11,26,45,0,0,24.625,-86.625,0,1,1
2014-11,27,7,1,1,24.875,-96.125,0,0,0
2014-11,27,8,1,1,24.875,-95.875,0,0,0
2014-11,27,20,1,1,24.875,-92.875,0,0,0
2014-11,27,23,2,1,24.875,-92.125,0,0,0
2014-11,27,44,0,0,24.875,-86.875,0,1,1
2014-11,28,19,1,1,25.125,-93.125,0,0,0
2014-11,28,20,2,1,25.125,-92.875,0,0,0
2014-11,28,21,2,1,25.125,-92.625,0,0,0
2014-11,28,25,1,1,25.125,-91.625,0,0,0
2014-11,28,44,0,0,25.125,-86.875,0,3,3
2014-11,29,7,2,1,25.375,-96.125,0,0,0
2014-11,29,17,1,1,25.375,-93.625,0,0,0
2014-11,30,7,1,1,25.625,-96.125,0,0,0
2014-11,30,8,1,1,25.625,-95.875,0,0,0
2014-11,30,10,1,1,25.625,-95.375,0,0,0
2014-11,30,12,1,1,25.625,-94.875,0,0,0
2014-11,30,15,1,1,25.625,-94.125,0,0,0
2014-11,30,27,1,1,25.625,-91.125,0,0,0
2014-11,30,29,0,0,25.625,-90.625,6,0,6
2014-11,30,30,0,0,25.625,-90.375,14,0,14
2014-11,30,31,0,0,25.625,-90.125,3,0,3
2014-11,30,51,0,0,25.625,-85.125,1,0,1
2014-11,31,27,1,1,25.875,-91.125,0,0,0
2014-11,31,28,3,1,25.875,-90.875,0,0,0
2014-11,31,29,0,0,25.875,-90.625,6,0,6
2014-11,31,50,0,0,25.875,-85.375,2,0,2
2014-11,31,51,0,0,25.875,-85.125,5,0,5
2014-11,32,8,0,0,26.125,-95.875,0,11,11
2014-11,32,26,1,1,26.125,-91.375,0,0,0
2014-11,32,28,1,1,26.125,-90.875,0,0,0
2014-11,32,48,0,0,26.125,-85.875,2,0,2
2014-11,32,49,0,0,26.125,-85.625,13,0,13
2014-11,32,50,0,0,26.125,-85.375,7,0,7
2014-11,33,8,0,0,26.375,-95.875,0,4,4
2014-11,33,9,0,0,26.375,-95.625,0,10,10
2014-11,33,25,1,1,26.375,-91.625,0,0,0
2014-11,34,10,0,0,26.625,-95.375,0,5,5
2014-11,34,24,1,1,26.625,-91.875,0,0,0
2014-11,34,43,1,1,26.625,-87.125,0,0,0
2014-11,34,47,1,1,26.625,-86.125,0,0,0
2014-11,35,23,2,1,26.875,-92.125,0,0,0
2014-11,35,34,1,1,26.875,-89.375,0,0,0
2014-11,35,35,1,1,26.875,-89.125,0,0,0
2014-11,35,39,3,1,26.875,-88.125,0,0,0
2014-11,35,40,1,1,26.875,-87.875,0,2,2
2014-11,35,41,1,1,26.875,-87.625,0,24,24
2014-11,35,42,2,1,26.875,-87.375,0,0,0
2014-11,35,44,1,1,26.875,-86.875,0,0,0
2014-11,35,46,2,1,26.875,-86.375,0,0,0
2014-11,35,47,1,1,26.875,-86.125,0,0,0
2014-11,36,6,3,1,27.125,-96.375,0,0,0
2014-11,36,7,1,1,27.125,-96.125,0,0,0
2014-11,36,22,2,1,27.125,-92.375,0,0,0
2014-11,36,23,4,1,27.125,-92.125,0,0,0
2014-11,36,24,2,1,27.125,-91.875,0,0,0
2014-11,36,26,1,1,27.125,-91.375,0,0,0
2014-11,36,34,1,1,27.125,-89.375,0,0,0
2014-11,36,36,1,1,27.125,-88.875,0,0,0
2014-11,36,40,1,1,27.125,-87.875,0,3,3
2014-11,36,41,1,1,27.125,-87.625,0,0,0
2014-11,36,42,1,1,27.125,-87.375,0,0,0
2014-11,36,44,2,1,27.125,-86.875,0,0,0
2014-11,36,46,1,1,27.125,-86.375,0,0,0
2014-11,37,6,2,1,27.375,-96.375,0,0,0
2014-11,37,7,3,1,27.375,-96.125,0,0,0
2014-11,37,8,2,1,27.375,-95.875,0,0,0
2014-11,37,9,1,1,27.375,-95.625,0,0,0
2014-11,37,12,1,1,27.375,-94.875,0,0,0
2014-11,37,14,1,1,27.375,-94.375,0,0,0
2014-11,37,15,1,1,27.375,-94.125,0,0,0
2014-11,37,22,0,0,27.375,-92.375,0,1,1
2014-11,37,27,1,1,27.375,-91.125,0,0,0
2014-11,37,29,1,1,27.375,-90.625,0,1,1
2014-11,37,30,0,0,27.375,-90.375,0,4,4
2014-11,37,33,1,1,27.375,-89.625,0,0,0
2014-11,37,40,1,1,27.375,-87.875,0,1,1
2014-11,37,41,2,1,27.375,-87.625,0,0,0
2014-11,37,42,1,1,27.375,-87.375,0,0,0
2014-11,37,43,1,1,27.375,-87.125,0,0,0
2014-11,37,44,6,1,27.375,-86.875,0,0,0
2014-11,38,9,3,1,27.625,-95.625,0,0,0
2014-11,38,10,2,1,27.625,-95.375,0,0,0
2014-11,38,11,1,1,27.625,-95.125,0,0,0
2014-11,38,12,1,1,27.625,-94.875,0,0,0
2014-11,38,13,3,1,27.625,-94.625,0,0,0
2014-11,38,18,1,1,27.625,-93.375,0,0,0
2014-11,38,19,1,1,27.625,-93.125,0,0,0
2014-11,38,21,1,1,27.625,-92.625,0,0,0
2014-11,38,22,0,0,27.625,-92.375,0,3,3
2014-11,38,23,1,1,27.625,-92.125,0,7,7
2014-11,38,24,0,0,27.625,-91.875,0,2,2
2014-11,38,25,0,0,27.625,-91.625,0,1,1
2014-11,38,26,0,0,27.625,-91.375,0,3,3
2014-11,38,27,0,0,27.625,-91.125,0,4,4
2014-11,38,28,0,0,27.625,-90.875,0,1,1
2014-11,38,29,0,0,27.625,-90.625,0,3,3
2014-11,38,30,1,1,27.625,-90.375,0,0,0
2014-11,38,34,1,1,27.625,-89.375,0,0,0
2014-11,38,39,1,1,27.625,-88.125,0,0,0
2014-11,39,21,1,1,27.875,-92.625,0,0,0
2014-11,39,32,1,1,27.875,-89.875,0,0,0
2014-11,39,33,1,1,27.875,-89.625,0,0,0
2014-11,39,36,1,1,27.875,-88.875,0,0,0
2014-11,39,38,1,1,27.875,-88.375,0,0,0
2014-11,39,42,1,1,27.875,-87.375,0,0,0
2014-11,39,43,1,1,27.875,-87.125,0,0,0
2014-11,40,34,1,1,28.125,-89.375,0,0,0
2014-11,40,36,2,1,28.125,-88.875,0,0,0
2014-11,40,38,1,1,28.125,-88.375,0,0,0
2014-11,40,41,1,1,28.125,-87.625,12,0,12
2014-11,40,42,3,1,28.125,-87.375,0,0,0
2014-11,40,43,2,1,28.125,-87.125,0,0,0
2014-11,41,37,1,1,28.375,-88.625,0,0,0
2014-11,41,40,2,1,28.375,-87.875,2,0,2
2014-11,41,41,1,1,28.375,-87.625,6,0,6
2014-11,41,42,2,1,28.375,-87.375,8,0,8
2014-11,42,38,1,1,28.625,-88.375,0,0,0
2014-11,42,39,2,1,28.625,-88.125,0,0,0
2014-11,42,40,1,1,28.625,-87.875,1,0,1
2014-11,42,41,0,0,28.625,-87.625,1,0,1
2014-12,0,67,0,0,18.125,-81.125,7,0,7
2014-12,0,68,0,0,18.125,-80.875,4,0,4
2014-12,1,67,0,0,18.375,-81.125,1,0,1
2014-12,1,68,0,0,18.375,-80.875,3,0,3
2014-12,2,50,0,0,18.625,-85.375,2,0,2
2014-12,2,51,0,0,18.625,-85.125,3,0,3
2014-12,2,52,0,0,18.625,-84.875,3,0,3
2014-12,2,53,0,0,18.625,-84.625,2,0,2
2014-12,2,65,0,0,18.625,-81.625,1,0,1
2014-12,2,66,0,0,18.625,-81.375,3,0,3
2014-12,2,67,0,0,18.625,-81.125,4,0,4
2014-12,2,68,0,0,18.625,-80.875,1,0,1
2014-12,3,47,0,0,18.875,-86.125,5,0,5
2014-12,3,48,0,0,18.875,-85.875,4,0,4
2014-12,3,49,0,0,18.875,-85.625,4,0,4
2014-12,3,50,0,0,18.875,-85.375,3,0,3
2014-12,7,70,0,0,19.875,-80.375,0,2,2
2014-12,7,71,0,0,19.875,-80.125,0,7,7
2014-12,8,13,0,0,20.125,-94.625,6,0,6
2014-12,8,67,0,0,20.125,-81.125,0,3,3
2014-12,8,68,0,0,20.125,-80.875,0,3,3
2014-12,9,12,0,0,20.375,-94.875,4,0,4
2014-12,9,13,0,0,20.375,-94.625,3,0,3
2014-12,9,57,0,0,20.375,-83.625,0,1,1
2014-12,9,58,0,0,20.375,-83.375,0,5,5
2014-12,9,59,0,0,20.375,-83.125,0,5,5
2014-12,9,60,0,0,20.375,-82.875,0,1,1
2014-12,10,12,0,0,20.625,-94.875,5,0,5
2014-12,10,55,0,0,20.625,-84.125,0,5,5
2014-12,10,56,0,0,20.625,-83.875,0,3,3
2014-12,10,57,0,0,20.625,-83.625,0,1,1
2014-12,11,12,0,0,20.875,-94.875,4,0,4
2014-12,12,11,0,0,21.125,-95.125,5,0,5
2014-12,13,11,0,0,21.375,-95.125,4,0,4
2014-12,14,15,1,1,21.625,-94.125,0,0,0
2014-12,14,16,1,1,21.625,-93.875,0,0,0
2014-12,14,17,2,1,21.625,-93.625,0,0,0
2014-12,15,14,1,1,21.875,-94.375,0,0,0
2014-12,15,17,1,1,21.875,-93.625,0,15,15
2014-12,15,18,3,1,21.875,-93.375,0,0,0
2014-12,16,23,0,0,22.125,-92.125,0,1,1
2014-12,16,24,0,0,22.125,-91.875,0,2,2
2014-12,17,11,0,0,22.375,-95.125,0,1,1
2014-12,17,13,1,1,22.375,-94.625,0,0,0
2014-12,17,15,2,1,22.375,-94.125,0,0,0
2014-12,17,22,0,0,22.375,-92.375,0,1,1
2014-12,17,23,0,0,22.375,-92.125,0,2,2
2014-12,18,10,1,1,22.625,-95.375,0,0,0
2014-12,18,11,1,1,22.625,-95.125,0,5,5
2014-12,18,12,1,1,22.625,-94.875,0,0,0
2014-12,18,13,2,1,22.625,-94.625,0,0,0
2014-12,18,14,3,1,22.625,-94.375,0,0,0
2014-12,18,15,3,1,22.625,-94.125,0,0,0
2014-12,18,19,0,0,22.625,-93.125,0,1,1
2014-12,18,20,0,0,22.625,-92.875,0,2,2
2014-12,19,5,1,1,22.875,-96.625,0,0,0
2014-12,19,6,1,1,22.875,-96.375,0,0,0
2014-12,19,7,1,1,22.875,-96.125,0,0,0
2014-12,19,9,1,1,22.875,-95.625,0,0,0
2014-12,19,15,4,1,22.875,-94.125,0,0,0
2014-12,19,17,0,0,22.875,-93.625,0,1,1
2014-12,19,18,0,0,22.875,-93.375,0,3,3
2014-12,19,19,0,0,22.875,-93.125,0,3,3
2014-12,20,39,0,0,23.125,-88.125,4,0,4
2014-12,20,40,0,0,23.125,-87.875,2,0,2
2014-12,21,39,0,0,23.375,-88.125,6,0,6
2014-12,23,54,0,0,23.875,-84.375,0,1,1
2014-12,23,55,0,0,23.875,-84.125,0,3,3
2014-12,23,56,0,0,23.875,-83.875,0,1,1
2014-12,23,59,0,0,23.875,-83.125,0,2,2
2014-12,23,60,0,0,23.875,-82.875,0,9,9
2014-12,24,11,0,0,24.125,-95.125,6,0,6
2014-12,24,57,0,0,24.125,-83.625,0,3,3
2014-12,24,58,0,0,24.125,-83.375,0,5,5
2014-12,24,60,0,0,24.125,-82.875,0,1,1
2014-12,25,11,0,0,24.375,-95.125,7,0,7
2014-12,25,58,0,0,24.375,-83.375,0,1,1
2014-12,25,60,0,0,24.375,-82.875,0,3,3
2014-12,26,6,1,1,24.625,-96.375,0,0,0
2014-12,26,11,0,0,24.625,-95.125,15,0,15
2014-12,26,18,1,1,24.625,-93.375,0,0,0
2014-12,26,59,0,0,24.625,-83.125,0,1,1
2014-12,27,6,4,1,24.875,-96.375,0,0,0
2014-12,27,7,1,1,24.875,-96.125,0,0,0
2014-12,27,11,0,0,24.875,-95.125,1,0,1
2014-12,27,12,0,0,24.875,-94.875,2,0,2
2014-12,27,14,1,1,24.875,-94.375,0,0,0
2014-12,27,15,1,1,24.875,-94.125,0,0,0
2014-12,27,17,1,1,24.875,-93.625,0,0,0
2014-12,27,19,1,1,24.875,-93.125,0,0,0
2014-12,27,20,1,1,24.875,-92.875,0,0,0
2014-12,27,21,1,1,24.875,-92.625,0,0,0
2014-12,27,43,0,0,24.875,-87.125,0,1,1
2014-12,28,6,3,1,25.125,-96.375,0,0,0
2014-12,28,7,5,1,25.125,-96.125,0,0,0
2014-12,28,8,1,1,25.125,-95.875,0,0,0
2014-12,28,13,1,1,25.125,-94.625,0,0,0
2014-12,28,18,1,1,25.125,-93.375,0,0,0
2014-12,28,19,1,1,25.125,-93.125,0,0,0
2014-12,28,20,1,1,25.125,-92.875,0,0,0
2014-12,28,21,1,1,25.125,-92.625,0,0,0
2014-12,28,42,0,0,25.125,-87.375,0,4,4
2014-12,28,43,0,0,25.125,-87.125,0,4,4
2014-12,28,44,0,0,25.125,-86.875,0,5,5
2014-12,29,8,1,1,25.375,-95.875,0,0,0
2014-12,29,9,1,1,25.375,-95.625,0,0,0
2014-12,29,11,2,1,25.375,-95.125,0,0,0
2014-12,29,12,3,1,25.375,-94.875,0,0,0
2014-12,29,13,2,1,25.375,-94.625,0,0,0
2014-12,29,17,1,1,25.375,-93.625,0,0,0
2014-12,29,41,0,0,25.375,-87.625,0,6,6
2014-12,29,49,0,0,25.375,-85.625,3,0,3
2014-12,29,50,0,0,25.375,-85.375,7,0,7
2014-12,29,51,0,0,25.375,-85.125,4,0,4
2014-12,30,11,1,1,25.625,-95.125,0,0,0
2014-12,30,14,1,1,25.625,-94.375,0,0,0
2014-12,30,15,2,1,25.625,-94.125,0,0,0
2014-12,30,16,2,1,25.625,-93.875,0,0,0
2014-12,30,38,3,1,25.625,-88.375,0,0,0
2014-12,30,39,1,1,25.625,-88.125,0,0,0
2014-12,30,40,0,0,25.625,-87.875,0,4,4
2014-12,30,51,0,0,25.625,-85.125,8,0,8
2014-12,31,15,2,1,25.875,-94.125,0,0,0
2014-12,31,16,1,1,25.875,-93.875,0,0,0
2014-12,31,18,1,1,25.875,-93.375,0,0,0
2014-12,31,28,0,0,25.875,-90.875,16,0,16
2014-12,31,29,0,0,25.875,-90.625,10,0,10
2014-12,31,39,5,1,25.875,-88.125,0,4,4
2014-12,31,40,0,0,25.875,-87.875,0,1,1
2014-12,31,51,0,0,25.875,-85.125,7,0,7
2014-12,31,52,1,1,25.875,-84.875,0,0,0
2014-12,32,18,1,1,26.125,-93.375,0,0,0
2014-12,32,28,0,0,26.125,-90.875,2,0,2
2014-12,32,29,0,0,26.125,-90.625,3,0,3
2014-12,32,38,2,1,26.125,-88.375,0,1,1
2014-12,32,39,0,0,26.125,-88.125,0,1,1
2014-12,32,40,2,1,26.125,-87.875,0,0,0
2014-12,32,42,1,1,26.125,-87.375,0,0,0
2014-12,32,43,1,1,26.125,-87.125,0,0,0
2014-12,32,51,0,0,26.125,-85.125,2,0,2
2014-12,32,52,2,1,26.125,-84.875,0,0,0
2014-12,32,53,1,1,26.125,-84.625,0,0,0
2014-12,33,8,0,0,26.375,-95.875,0,12,12
2014-12,33,20,1,1,26.375,-92.875,0,0,0
2014-12,33,39,2,1,26.375,-88.125,0,0,0
2014-12,33,40,1,1,26.375,-87.875,0,0,0
2014-12,33,43,3,1,26.375,-87.125,0,0,0
2014-12,33,44,2,1,26.375,-86.875,0,0,0
2014-12,33,50,1,1,26.375,-85.375,0,0,0
2014-12,33,52,2,1,26.375,-84.875,0,0,0
2014-12,33,53,2,1,26.375,-84.625,0,0,0
2014-12,33,56,0,0,26.375,-83.875,0,2,2
2014-12,34,8,0,0,26.625,-95.875,0,3,3
2014-12,34,9,0,0,26.625,-95.625,0,2,2
2014-12,34,22,1,1,26.625,-92.375,0,0,0
2014-12,34,24,1,1,26.625,-91.875,0,0,0
2014-12,34,27,1,1,26.625,-91.125,0,0,0
2014-12,34,35,1,1,26.625,-89.125,0,0,0
2014-12,34,39,1,1,26.625,-88.125,0,0,0
2014-12,34,41,2,1,26.625,-87.625,0,0,0
2014-12,34,42,1,1,26.625,-87.375,0,0,0
2014-12,34,43,3,1,26.625,-87.125,0,0,0
2014-12,34,44,1,1,26.625,-86.875,0,0,0
2014-12,34,48,1,1,26.625,-85.875,0,0,0
2014-12,34,52,1,1,26.625,-84.875,0,0,0
2014-12,34,53,2,1,26.625,-84.625,0,0,0
2014-12,35,8,0,0,26.875,-95.875,0,10,10
2014-12,35,20,0,0,26.875,-92.875,0,4,4
2014-12,35,29,1,1,26.875,-90.625,0,0,0
2014-12,35,30,1,1,26.875,-90.375,0,0,0
2014-12,35,32,1,1,26.875,-89.875,0,0,0
2014-12,35,34,2,2,26.875,-89.375,0,0,0
2014-12,35,35,1,1,26.875,-89.125,0,0,0
2014-12,35,46,1,1,26.875,-86.375,0,0,0
2014-12,36,22,0,0,27.125,-92.375,0,2,2
2014-12,36,32,1,1,27.125,-89.875,0,0,0
2014-12,36,33,2,1,27.125,-89.625,0,0,0
2014-12,36,34,5,2,27.125,-89.375,0,0,0
2014-12,36,35,3,1,27.125,-89.125,0,0,0
2014-12,36,46,1,1,27.125,-86.375,0,0,0
2014-12,37,20,0,0,27.375,-92.875,0,13,13
2014-12,37,21,0,0,27.375,-92.625,0,3,3
2014-12,37,22,0,0,27.375,-92.375,0,8,8
2014-12,37,25,4,1,27.375,-91.625,0,0,0
2014-12,37,30,1,1,27.375,-90.375,0,0,0
2014-12,37,32,1,1,27.375,-89.875,0,0,0
2014-12,37,34,2,1,27.375,-89.375,0,0,0
2014-12,37,35,2,1,27.375,-89.125,0,0,0
2014-12,37,40,0,0,27.375,-87.875,0,3,3
2014-12,37,45,0,0,27.375,-86.625,0,5,5
2014-12,37,48,1,1,27.375,-85.875,0,0,0
2014-12,38,24,2,1,27.625,-91.875,0,0,0
2014-12,38,28,1,1,27.625,-90.875,0,0,0
2014-12,38,30,1,1,27.625,-90.375,0,0,0
2014-12,38,31,1,1,27.625,-90.125,0,0,0
2014-12,38,32,1,1,27.625,-89.875,0,0,0
2014-12,38,34,2,1,27.625,-89.375,0,0,0
2014-12,38,35,3,1,27.625,-89.125,0,0,0
2014-12,38,36,1,1,27.625,-88.875,0,0,0
2014-12,38,46,0,0,27.625,-86.375,0,5,5
2014-12,38,47,0,0,27.625,-86.125,0,12,12
2014-12,38,48,2,1,27.625,-85.875,0,0,0
2014-12,39,37,1,1,27.875,-88.625,0,0,0
2014-12,39,40,0,0,27.875,-87.875,5,0,5
2014-12,39,42,1,1,27.875,-87.375,0,0,0
2014-12,39,47,1,1,27.875,-86.125,0,0,0
2014-12,39,49,1,1,27.875,-85.625,0,0,0
2014-12,40,39,1,1,28.125,-88.125,0,0,0
2014-12,40,40,1,1,28.125,-87.875,3,0,3
2014-12,40,41,0,0,28.125,-87.625,4,0,4
2014-12,40,47,1,1,28.125,-86.125,0,0,0
2014-12,40,48,1,1,28.125,-85.875,0,0,0
2014-12,41,41,1,1,28.375,-87.625,6,0,6
2014-12,41,42,0,0,28.375,-87.375,1,0,1
2014-12,41,47,1,1,28.375,-86.125,0,0,0
2014-12,41,49,2,1,28.375,-85.625,0,0,0
2014-12,42,41,0,0,28.625,-87.625,7,0,7
2014-12,42,42,0,0,28.625,-87.375,2,0,2
2014-12,42,43,1,1,28.625,-87.125,0,0,0
2014-12,42,46,1,1,28.625,-86.375,0,0,0
2014-12,43,41,0,0,28.875,-87.625,2,0,2
2015-01,0,45,0,0,18.125,-86.625,1,0,1
2015-01,0,48,0,0,18.125,-85.875,5,0,5
2015-01,0,58,0,0,18.125,-83.375,3,0,3
2015-01,0,59,0,0,18.125,-83.125,2,0,2
2015-01,1,45,0,0,18.375,-86.625,1,0,1
2015-01,1,46,0,0,18.375,-86.375,4,0,4
2015-01,1,47,0,0,18.375,-86.125,4,0,4
2015-01,1,48,0,0,18.375,-85.875,2,0,2
2015-01,1,58,0,0,18.375,-83.375,1,0,1
2015-01,2,63,0,0,18.625,-82.125,2,0,2
2015-01,2,64,0,0,18.625,-81.875,3,0,3
2015-01,2,65,0,0,18.625,-81.625,2,0,2
2015-01,3,46,0,0,18.875,-86.375,2,0,2
2015-01,4,18,0,0,19.125,-93.375,0,2,2
2015-01,4,46,0,0,19.125,-86.375,1,0,1
2015-01,4,62,0,0,19.125,-82.375,0,1,1
2015-01,5,9,2,1,19.375,-95.625,0,0,0
2015-01,5,18,0,0,19.375,-93.375,0,1,1
2015-01,5,46,0,0,19.375,-86.375,2,0,2
2015-01,5,62,0,0,19.375,-82.375,0,6,6
2015-01,5,69,0,0,19.375,-80.625,3,0,3
2015-01,5,70,0,0,19.375,-80.375,5,0,5
2015-01,6,46,0,0,19.625,-86.375,2,0,2
2015-01,6,61,0,0,19.625,-82.625,0,1,1
2015-01,6,62,0,0,19.625,-82.375,0,1,1
2015-01,6,71,0,0,19.625,-80.125,3,0,3
2015-01,7,9,1,1,19.875,-95.625,0,0,0
2015-01,7,45,0,0,19.875,-86.625,1,0,1
2015-01,7,46,0,0,19.875,-86.375,6,0,6
2015-01,7,61,0,0,19.875,-82.625,0,2,2
2015-01,8,45,0,0,20.125,-86.625,2,0,2
2015-01,8,46,0,0,20.125,-86.375,1,0,1
2015-01,8,59,0,0,20.125,-83.125,0,1,1
2015-01,8,60,0,0,20.125,-82.875,0,7,7
2015-01,8,61,0,0,20.125,-82.625,0,2,2
2015-01,8,62,0,0,20.125,-82.375,0,8,8
2015-01,9,7,1,1,20.375,-96.125,0,0,0
2015-01,9,46,0,0,20.375,-86.375,1,0,1
2015-01,9,59,0,0,20.375,-83.125,0,1,1
2015-01,9,61,0,0,20.375,-82.625,0,1,1
2015-01,11,6,1,1,20.875,-96.375,0,0,0
2015-01,13,4,1,1,21.375,-96.875,0,0,0
2015-01,13,10,0,0,21.375,-95.375,1,0,1
2015-01,13,11,0,0,21.375,-95.125,1,0,1
2015-01,14,4,1,1,21.625,-96.875,0,0,0
2015-01,14,10,0,0,21.625,-95.375,5,0,5
2015-01,14,16,2,1,21.625,-93.875,0,0,0
2015-01,15,4,1,1,21.875,-96.875,0,0,0
2015-01,15,9,0,0,21.875,-95.625,2,0,2
2015-01,15,10,0,0,21.875,-95.375,3,0,3
2015-01,15,16,1,1,21.875,-93.875,0,0,0
2015-01,15,17,0,0,21.875,-93.625,0,2,2
2015-01,15,18,1,1,21.875,-93.375,0,0,0
2015-01,15,21,0,0,21.875,-92.625,0,1,1
2015-01,16,3,1,1,22.125,-97.125,0,0,0
2015-01,16,9,0,0,22.125,-95.625,3,0,3
2015-01,16,15,2,1,22.125,-94.125,0,0,0
2015-01,16,16,0,0,22.125,-93.875,0,2,2
2015-01,16,17,0,0,22.125,-93.625,0,4,4
2015-01,16,20,0,0,22.125,-92.875,0,1,1
2015-01,16,21,0,0,22.125,-92.625,0,1,1
2015-01,17,3,1,1,22.375,-97.125,0,0,0
2015-01,17,9,0,0,22.375,-95.625,4,0,4
2015-01,17,12,1,1,22.375,-94.875,0,0,0
2015-01,17,13,1,1,22.375,-94.625,0,0,0
2015-01,17,15,1,1,22.375,-94.125,0,0,0
2015-01,17,16,0,0,22.375,-93.875,0,11,11
2015-01,17,17,0,0,22.375,-93.625,0,1,1
2015-01,17,18,0,0,22.375,-93.375,0,6,6
2015-01,17,20,0,0,22.375,-92.875,0,2,2
2015-01,18,2,1,1,22.625,-97.375,0,0,0
2015-01,18,3,1,1,22.625,-97.125,0,0,0
2015-01,18,4,2,1,22.625,-96.875,0,0,0
2015-01,18,8,0,0,22.625,-95.875,4,0,4
2015-01,18,9,0,0,22.625,-95.625,2,0,2
2015-01,18,10,1,1,22.625,-95.375,0,0,0
2015-01,18,11,1,1,22.625,-95.125,0,0,0
2015-01,19,5,1,1,22.875,-96.625,0,0,0
2015-01,19,8,0,0,22.875,-95.875,3,0,3
2015-01,19,9,1,1,22.875,-95.625,0,0,0
2015-01,19,10,1,1,22.875,-95.375,0,0,0
2015-01,19,30,0,0,22.875,-90.375,0,1,1
2015-01,20,5,1,1,23.125,-96.625,0,0,0
2015-01,20,6,1,1,23.125,-96.375,0,0,0
2015-01,20,7,1,1,23.125,-96.125,0,0,0
2015-01,20,30,0,0,23.125,-90.375,0,1,1
2015-01,20,48,0,0,23.125,-85.875,0,12,12
2015-01,21,46,0,0,23.375,-86.375,0,1,1
2015-01,21,47,0,0,23.375,-86.125,0,3,3
2015-01,21,48,0,0,23.375,-85.875,0,5,5
2015-01,22,48,0,0,23.625,-85.875,0,1,1
2015-01,23,9,0,0,23.875,-95.625,3,0,3
2015-01,23,60,0,0,23.875,-82.875,0,1,1
2015-01,23,61,0,0,23.875,-82.625,0,11,11
2015-01,23,62,0,0,23.875,-82.375,0,4,4
2015-01,23,63,0,0,23.875,-82.125,0,4,4
2015-01,23,64,0,0,23.875,-81.875,0,3,3
2015-01,23,65,0,0,23.875,-81.625,0,4,4
2015-01,24,66,0,0,24.125,-81.375,0,1,1
2015-01,27,12,0,0,24.875,-94.875,7,0,7
2015-01,27,13,0,0,24.875,-94.625,3,0,3
2015-01,27,14,0,0,24.875,-94.375,3,0,3
2015-01,27,15,0,0,24.875,-94.125,2,0,2
2015-01,27,16,0,0,24.875,-93.875,6,0,6
2015-01,27,20,0,0,24.875,-92.875,1,0,1
2015-01,28,21,0,0,25.125,-92.625,9,0,9
2015-01,29,6,1,1,25.375,-96.375,0,0,0
2015-01,29,7,1,1,25.375,-96.125,0,0,0
2015-01,29,45,0,0,25.375,-86.625,5,0,5
2015-01,29,46,0,0,25.375,-86.375,1,0,1
2015-01,29,47,0,0,25.375,-86.125,1,0,1
2015-01,29,48,0,0,25.375,-85.875,5,0,5
2015-01,29,49,0,0,25.375,-85.625,3,0,3
2015-01,30,7,1,1,25.625,-96.125,0,0,0
2015-01,30,46,0,0,25.625,-86.375,10,0,10
2015-01,30,47,0,0,25.625,-86.125,4,0,4
2015-01,30,48,0,0,25.625,-85.875,2,0,2
2015-01,31,9,1,1,25.875,-95.625,0,0,0
2015-01,31,10,1,1,25.875,-95.375,0,0,0
2015-01,31,28,0,0,25.875,-90.875,3,0,3
2015-01,31,32,3,1,25.875,-89.875,0,0,0
2015-01,31,34,2,1,25.875,-89.375,0,0,0
2015-01,31,35,1,1,25.875,-89.125,0,0,0
2015-01,31,36,1,1,25.875,-88.875,0,0,0
2015-01,31,37,1,1,25.875,-88.625,0,0,0
2015-01,32,22,1,1,26.125,-92.375,0,0,0
2015-01,32,24,0,0,26.125,-91.875,2,0,2
2015-01,32,28,0,0,26.125,-90.875,2,0,2
2015-01,32,33,3,1,26.125,-89.625,0,0,0
2015-01,32,34,6,1,26.125,-89.375,0,0,0
2015-01,32,37,2,1,26.125,-88.625,0,0,0
2015-01,32,38,2,1,26.125,-88.375,0,1,1
2015-01,33,16,0,0,26.375,-93.875,0,1,1
2015-01,33,17,0,0,26.375,-93.625,0,4,4
2015-01,33,23,1,1,26.375,-92.125,0,0,0
2015-01,33,24,1,1,26.375,-91.875,0,0,0
2015-01,33,26,1,1,26.375,-91.375,0,0,0
2015-01,33,28,0,0,26.375,-90.875,3,0,3
2015-01,33,29,1,1,26.375,-90.625,0,0,0
2015-01,33,31,1,1,26.375,-90.125,0,0,0
2015-01,33,33,1,1,26.375,-89.625,0,0,0
2015-01,33,34,4,1,26.375,-89.375,0,0,0
2015-01,33,38,1,1,26.375,-88.375,0,6,6
2015-01,33,57,0,0,26.375,-83.625,0,1,1
2015-01,34,10,1,1,26.625,-95.375,0,0,0
2015-01,34,17,2,1,26.625,-93.625,0,5,5
2015-01,34,18,1,1,26.625,-93.375,0,5,5
2015-01,34,19,1,1,26.625,-93.125,0,0,0
2015-01,34,21,5,2,26.625,-92.625,0,0,0
2015-01,34,22,4,1,26.625,-92.375,0,0,0
2015-01,34,23,2,1,26.625,-92.125,0,0,0
2015-01,34,24,1,1,26.625,-91.875,0,0,0
2015-01,34,25,2,1,26.625,-91.625,0,0,0
2015-01,34,27,0,0,26.625,-91.125,5,0,5
2015-01,34,31,1,1,26.625,-90.125,0,0,0
2015-01,34,33,1,1,26.625,-89.625,0,0,0
2015-01,34,35,2,1,26.625,-89.125,0,0,0
2015-01,34,38,0,0,26.625,-88.375,0,8,8
2015-01,34,51,1,1,26.625,-85.125,0,0,0
2015-01,34,52,1,1,26.625,-84.875,0,0,0
2015-01,34,56,0,0,26.625,-83.875,0,4,4
2015-01,34,57,0,0,26.625,-83.625,0,1,1
2015-01,34,58,0,0,26.625,-83.375,0,3,3
2015-01,35,9,2,1,26.875,-95.625,0,0,0
2015-01,35,10,4,1,26.875,-95.375,0,0,0
2015-01,35,11,1,1,26.875,-95.125,0,0,0
2015-01,35,15,2,1,26.875,-94.125,0,0,0
2015-01,35,16,1,1,26.875,-93.875,0,0,0
2015-01,35,18,1,1,26.875,-93.375,0,5,5
2015-01,35,19,3,1,26.875,-93.125,0,8,8
2015-01,35,20,3,2,26.875,-92.875,0,1,1
2015-01,35,21,2,2,26.875,-92.625,0,0,0
2015-01,35,22,1,1,26.875,-92.375,0,0,0
2015-01,35,25,1,1,26.875,-91.625,0,0,0
2015-01,35,27,0,0,26.875,-91.125,4,0,4
2015-01,35,28,1,1,26.875,-90.875,0,0,0
2015-01,35,33,1,1,26.875,-89.625,0,0,0
2015-01,35,36,0,0,26.875,-88.875,0,1,1
2015-01,35,37,0,0,26.875,-88.625,0,15,15
2015-01,35,52,1,1,26.875,-84.875,0,0,0
2015-01,35,53,1,1,26.875,-84.625,0,0,0
2015-01,35,56,0,0,26.875,-83.875,0,3,3
2015-01,35,57,0,0,26.875,-83.625,0,2,2
2015-01,35,58,0,0,26.875,-83.375,0,1,1
2015-01,36,12,1,1,27.125,-94.875,0,0,0
2015-01,36,13,1,1,27.125,-94.625,0,0,0
2015-01,36,14,1,1,27.125,-94.375,0,0,0
2015-01,36,15,4,1,27.125,-94.125,0,0,0
2015-01,36,16,1,1,27.125,-93.875,0,0,0
2015-01,36,19,2,1,27.125,-93.125,0,0,0
2015-01,36,24,1,1,27.125,-91.875,0,0,0
2015-01,36,25,2,1,27.125,-91.625,0,0,0
2015-01,36,26,1,1,27.125,-91.375,0,0,0
2015-01,36,29,1,1,27.125,-90.625,0,0,0
2015-01,36,30,1,1,27.125,-90.375,0,0,0
2015-01,36,31,3,2,27.125,-90.125,0,0,0
2015-01,36,32,4,1,27.125,-89.875,0,0,0
2015-01,36,34,2,2,27.125,-89.375,0,0,0
2015-01,36,36,1,1,27.125,-88.875,0,0,0
2015-01,36,50,1,1,27.125,-85.375,0,0,0
2015-01,36,52,1,1,27.125,-84.875,0,0,0
2015-01,36,58,0,0,27.125,-83.375,0,2,2
2015-01,37,12,1,1,27.375,-94.875,0,0,0
2015-01,37,27,1,1,27.375,-91.125,0,0,0
2015-01,37,30,1,1,27.375,-90.375,0,0,0
2015-01,37,31,4,2,27.375,-90.125,0,0,0
2015-01,37,32,1,1,27.375,-89.875,0,0,0
2015-01,37,33,1,1,27.375,-89.625,0,0,0
2015-01,37,34,1,1,27.375,-89.375,0,0,0
2015-01,37,35,1,1,27.375,-89.125,0,0,0
2015-01,37,37,1,1,27.375,-88.625,0,0,0
2015-01,37,39,1,1,27.375,-88.125,0,0,0
2015-01,37,41,1,1,27.375,-87.625,0,0,0
2015-01,37,42,1,1,27.375,-87.375,0,0,0
2015-01,37,46,1,1,27.375,-86.375,0,0,0
2015-01,37,47,1,1,27.375,-86.125,0,0,0
2015-01,37,48,1,1,27.375,-85.875,0,0,0
2015-01,37,49,1,1,27.375,-85.625,0,0,0
2015-01,37,57,0,0,27.375,-83.625,0,1,1
2015-01,37,58,0,0,27.375,-83.375,0,3,3
2015-01,38,11,2,1,27.625,-95.125,0,0,0
2015-01,38,12,4,1,27.625,-94.875,0,0,0
2015-01,38,34,2,1,27.625,-89.375,0,0,0
2015-01,38,37,1,1,27.625,-88.625,0,0,0
2015-01,38,39,1,1,27.625,-88.125,0,0,0
2015-01,38,40,3,2,27.625,-87.875,0,0,0
2015-01,38,43,2,1,27.625,-87.125,0,0,0
2015-01,38,44,1,1,27.625,-86.875,0,0,0
2015-01,38,45,2,1,27.625,-86.625,0,0,0
2015-01,38,46,1,1,27.625,-86.375,0,0,0
2015-01,38,47,0,0,27.625,-86.125,0,5,5
2015-01,38,48,0,0,27.625,-85.875,0,10,10
2015-01,39,38,1,1,27.875,-88.375,0,0,0
2015-01,41,44,0,0,28.375,-86.875,8,0,8
2015-01,41,45,0,0,28.375,-86.625,5,0,5
2015-01,42,41,0,0,28.625,-87.625,8,0,8
2015-01,42,42,0,0,28.625,-87.375,3,0,3
2015-01,42,43,0,0,28.625,-87.125,7,0,7
2015-02,0,48,0,0,18.125,-85.875,2,0,2
2015-02,0,49,0,0,18.125,-85.625,1,0,1
2015-02,0,54,0,0,18.125,-84.375,1,0,1
2015-02,0,55,0,0,18.125,-84.125,4,0,4
2015-02,0,56,0,0,18.125,-83.875,2,0,2
2015-02,0,57,0,0,18.125,-83.625,1,0,1
2015-02,0,67,0,0,18.125,-81.125,0,1,1
2015-02,0,68,0,0,18.125,-80.875,0,3,3
2015-02,1,45,0,0,18.375,-86.625,4,0,4
2015-02,1,56,0,0,18.375,-83.875,1,0,1
2015-02,1,57,0,0,18.375,-83.625,2,0,2
2015-02,1,67,0,0,18.375,-81.125,0,7,7
2015-02,2,67,0,0,18.625,-81.125,0,2,2
2015-02,3,56,0,0,18.875,-83.875,0,1,1
2015-02,3,57,0,0,18.875,-83.625,0,1,1
2015-02,4,57,0,0,19.125,-83.625,0,2,2
2015-02,4,58,0,0,19.125,-83.375,0,3,3
2015-02,4,69,0,0,19.125,-80.625,1,0,1
2015-02,5,17,0,0,19.375,-93.625,0,4,4
2015-02,5,18,0,0,19.375,-93.375,0,1,1
2015-02,5,58,0,0,19.375,-83.375,0,2,2
2015-02,5,60,0,0,19.375,-82.875,0,1,1
2015-02,5,61,0,0,19.375,-82.625,0,3,3
2015-02,5,62,0,0,19.375,-82.375,0,2,2
2015-02,5,68,0,0,19.375,-80.875,2,0,2
2015-02,5,69,0,0,19.375,-80.625,5,0,5
2015-02,6,10,3,1,19.625,-95.375,0,0,0
2015-02,6,17,0,0,19.625,-93.625,0,3,3
2015-02,6,59,0,0,19.625,-83.125,0,1,1
2015-02,6,61,0,0,19.625,-82.625,0,6,6
2015-02,6,68,0,0,19.625,-80.875,5,0,5
2015-02,7,59,0,0,19.875,-83.125,0,3,3
2015-02,7,64,0,0,19.875,-81.875,2,0,2
2015-02,7,65,0,0,19.875,-81.625,1,0,1
2015-02,7,66,0,0,19.875,-81.375,3,0,3
2015-02,7,67,0,0,19.875,-81.125,3,0,3
2015-02,7,68,0,0,19.875,-80.875,6,0,6
2015-02,8,16,0,0,20.125,-93.875,0,7,7
2015-02,8,17,0,0,20.125,-93.625,0,10,10
2015-02,8,18,0,0,20.125,-93.375,0,3,3
2015-02,8,58,0,0,20.125,-83.375,0,2,2
2015-02,17,17,0,0,22.375,-93.625,0,3,3
2015-02,18,15,0,0,22.625,-94.125,0,9,9
2015-02,18,16,0,0,22.625,-93.875,0,8,8
2015-02,18,17,0,0,22.625,-93.625,0,5,5
2015-02,18,42,0,0,22.625,-87.375,5,0,5
2015-02,18,43,0,0,22.625,-87.125,8,0,8
2015-02,19,15,0,0,22.875,-94.125,0,2,2
2015-02,19,16,0,0,22.875,-93.875,0,1,1
2015-02,20,30,0,0,23.125,-90.375,0,2,2
2015-02,21,28,0,0,23.375,-90.875,0,1,1
2015-02,21,31,0,0,23.375,-90.125,0,4,4
2015-02,22,28,0,0,23.625,-90.875,0,6,6
2015-02,22,29,0,0,23.625,-90.625,0,3,3
2015-02,22,30,0,0,23.625,-90.375,0,5,5
2015-02,22,31,0,0,23.625,-90.125,0,1,1
2015-02,22,47,0,0,23.625,-86.125,0,1,1
2015-02,22,48,0,0,23.625,-85.875,0,5,5
2015-02,22,55,0,0,23.625,-84.125,1,0,1
2015-02,22,56,0,0,23.625,-83.875,2,0,2
2015-02,23,8,0,0,23.875,-95.875,1,0,1
2015-02,23,9,0,0,23.875,-95.625,1,0,1
2015-02,23,28,0,0,23.875,-90.875,0,4,4
2015-02,23,46,0,0,23.875,-86.375,0,3,3
2015-02,23,47,0,0,23.875,-86.125,0,5,5
2015-02,23,55,0,0,23.875,-84.125,5,0,5
2015-02,24,8,0,0,24.125,-95.875,23,0,23
2015-02,24,9,0,0,24.125,-95.625,1,0,1
2015-02,24,45,0,0,24.125,-86.625,0,10,10
2015-02,24,46,0,0,24.125,-86.375,0,2,2
2015-02,24,55,0,0,24.125,-84.125,7,0,7
2015-02,25,8,0,0,24.375,-95.875,2,0,2
2015-02,25,46,0,0,24.375,-86.375,0,2,2
2015-02,25,55,0,0,24.375,-84.125,1,0,1
2015-02,26,35,0,0,24.625,-89.125,2,0,2
2015-02,26,36,0,0,24.625,-88.875,4,0,4
2015-02,26,37,0,0,24.625,-88.625,3,0,3
2015-02,26,38,0,0,24.625,-88.375,2,0,2
2015-02,27,33,0,0,24.875,-89.625,1,0,1
2015-02,27,34,0,0,24.875,-89.375,4,0,4
2015-02,27,39,0,0,24.875,-88.125,5,0,5
2015-02,27,40,0,0,24.875,-87.875,2,0,2
2015-02,28,20,0,0,25.125,-92.875,6,0,6
2015-02,28,21,0,0,25.125,-92.625,19,0,19
2015-02,29,21,0,0,25.375,-92.625,3,0,3
2015-02,29,45,0,0,25.375,-86.625,5,0,5
2015-02,31,13,0,0,25.875,-94.625,0,9,9
2015-02,31,14,0,0,25.875,-94.375,0,5,5
2015-02,31,36,1,1,25.875,-88.875,0,0,0
2015-02,32,14,0,0,26.125,-94.375,0,2,2
2015-02,32,15,0,0,26.125,-94.125,0,8,8
2015-02,32,16,0,0,26.125,-93.875,0,2,2
2015-02,32,35,1,1,26.125,-89.125,0,0,0
2015-02,33,16,0,0,26.375,-93.875,0,2,2
2015-02,33,34,1,1,26.375,-89.375,0,0,0
2015-02,34,24,1,1,26.625,-91.875,0,0,0
2015-02,34,27,1,1,26.625,-91.125,0,0,0
2015-02,34,34,1,1,26.625,-89.375,0,0,0
2015-02,34,36,3,1,26.625,-88.875,0,0,0
2015-02,35,24,1,1,26.875,-91.875,0,0,0
2015-02,35,25,1,1,26.875,-91.625,0,0,0
2015-02,35,26,3,1,26.875,-91.375,0,1,1
2015-02,35,27,3,1,26.875,-91.125,0,0,0
2015-02,35,32,1,1,26.875,-89.875,0,0,0
2015-02,35,33,4,2,26.875,-89.625,0,0,0
2015-02,35,34,1,1,26.875,-89.375,0,3,3
2015-02,35,35,1,1,26.875,-89.125,0,17,17
2015-02,35,36,0,0,26.875,-88.875,0,8,8
2015-02,35,37,2,1,26.875,-88.625,0,0,0
2015-02,35,38,2,1,26.875,-88.375,0,0,0
2015-02,35,45,0,0,26.875,-86.625,3,0,3
2015-02,36,19,1,1,27.125,-93.125,0,0,0
2015-02,36,27,3,1,27.125,-91.125,0,0,0
2015-02,36,31,1,1,27.125,-90.125,0,0,0
2015-02,36,32,2,2,27.125,-89.875,0,0,0
2015-02,36,33,3,2,27.125,-89.625,0,0,0
2015-02,36,34,3,2,27.125,-89.375,0,0,0
2015-02,36,35,5,1,27.125,-89.125,0,0,0
2015-02,36,36,3,1,27.125,-88.875,0,0,0
2015-02,36,37,6,2,27.125,-88.625,0,0,0
2015-02,36,38,4,1,27.125,-88.375,0,0,0
2015-02,36,44,0,0,27.125,-86.875,8,0,8
2015-02,37,18,1,1,27.375,-93.375,0,0,0
2015-02,37,19,1,1,27.375,-93.125,0,0,0
2015-02,37,29,1,1,27.375,-90.625,0,0,0
2015-02,37,30,1,1,27.375,-90.375,0,0,0
2015-02,37,32,2,2,27.375,-89.875,0,0,0
2015-02,37,33,3,2,27.375,-89.625,0,0,0
2015-02,37,34,2,2,27.375,-89.375,0,0,0
2015-02,37,35,1,1,27.375,-89.125,0,0,0
2015-02,37,36,4,2,27.375,-88.875,0,0,0
2015-02,37,37,5,2,27.375,-88.625,0,0,0
2015-02,37,39,1,1,27.375,-88.125,0,0,0
2015-02,37,40,2,1,27.375,-87.875,0,0,0
2015-02,37,43,0,0,27.375,-87.125,2,0,2
2015-02,37,44,0,0,27.375,-86.875,1,0,1
2015-02,38,17,2,1,27.625,-93.625,0,0,0
2015-02,38,18,5,1,27.625,-93.375,0,0,0
2015-02,38,19,1,1,27.625,-93.125,0,0,0
2015-02,38,25,1,1,27.625,-91.625,0,0,0
2015-02,38,27,1,1,27.625,-91.125,0,0,0
2015-02,38,28,1,1,27.625,-90.875,0,0,0
2015-02,38,32,3,2,27.625,-89.875,0,0,0
2015-02,38,33,2,2,27.625,-89.625,0,0,0
2015-02,38,34,4,3,27.625,-89.375,0,0,0
2015-02,38,35,6,2,27.625,-89.125,0,0,0
2015-02,38,36,2,2,27.625,-88.875,0,0,0
2015-02,38,37,1,1,27.625,-88.625,0,0,0
2015-02,38,40,2,1,27.625,-87.875,0,0,0
2015-02,38,43,0,0,27.625,-87.125,2,0,2
2015-02,39,13,1,1,27.875,-94.625,0,0,0
2015-02,39,20,1,1,27.875,-92.875,0,0,0
2015-02,39,21,1,1,27.875,-92.625,0,0,0
2015-02,39,23,1,1,27.875,-92.125,0,0,0
2015-02,39,24,1,1,27.875,-91.875,0,0,0
2015-02,39,29,1,1,27.875,-90.625,0,0,0
2015-02,39,30,1,1,27.875,-90.375,0,0,0
2015-02,39,34,1,1,27.875,-89.375,0,0,0
2015-02,39,35,2,2,27.875,-89.125,0,0,0
2015-02,39,36,2,2,27.875,-88.875,0,0,0
2015-02,39,37,1,1,27.875,-88.625,0,0,0
2015-02,39,43,0,0,27.875,-87.125,2,0,2
2015-02,40,14,3,1,28.125,-94.375,0,0,0
2015-02,40,30,2,1,28.125,-90.375,0,0,0
2015-02,40,36,1,1,28.125,-88.875,0,0,0
2015-02,40,37,1,1,28.125,-88.625,0,0,0
2015-02,40,38,1,1,28.125,-88.375,0,0,0
2015-02,41,32,2,1,28.375,-89.875,0,0,0
2015-02,41,37,2,1,28.375,-88.625,0,0,0
2015-02,41,38,1,1,28.375,-88.375,0,0,0
2015-02,41,44,0,0,28.375,-86.875,2,0,2
2015-02,42,36,0,0,28.625,-88.875,1,0,1
2015-02,43,36,0,0,28.875,-88.875,5,0,5
2015-02,43,37,0,0,28.875,-88.625,1,0,1
2015-03,0,47,0,0,18.125,-86.125,1,0,1
2015-03,1,46,0,0,18.375,-86.375,3,0,3
2015-03,1,52,0,0,18.375,-84.875,0,1,1
2015-03,1,67,0,0,18.375,-81.125,0,3,3
2015-03,2,46,0,0,18.625,-86.375,2,0,2
2015-03,2,51,0,0,18.625,-85.125,0,3,3
2015-03,2,52,0,0,18.625,-84.875,0,8,8
2015-03,2,53,0,0,18.625,-84.625,0,6,6
2015-03,2,54,0,0,18.625,-84.375,0,4,4
2015-03,2,55,0,0,18.625,-84.125,0,4,4
2015-03,2,65,0,0,18.625,-81.625,0,1,1
2015-03,2,66,0,0,18.625,-81.375,0,1,1
2015-03,2,67,0,0,18.625,-81.125,0,2,2
2015-03,3,46,0,0,18.875,-86.375,4,0,4
2015-03,3,51,0,0,18.875,-85.125,0,2,2
2015-03,3,56,0,0,18.875,-83.875,0,3,3
2015-03,3,65,0,0,18.875,-81.625,0,3,3
2015-03,3,66,0,0,18.875,-81.375,0,6,6
2015-03,3,67,0,0,18.875,-81.125,0,3,3
2015-03,4,45,0,0,19.125,-86.625,1,0,1
2015-03,4,46,0,0,19.125,-86.375,1,0,1
2015-03,4,59,0,0,19.125,-83.125,1,0,1
2015-03,4,66,0,0,19.125,-81.375,0,3,3
2015-03,5,45,0,0,19.375,-86.625,2,0,2
2015-03,5,46,0,0,19.375,-86.375,2,0,2
2015-03,5,61,0,0,19.375,-82.625,4,0,4
2015-03,6,45,0,0,19.625,-86.625,1,0,1
2015-03,6,46,0,0,19.625,-86.375,3,0,3
2015-03,6,62,0,0,19.625,-82.375,4,0,4
2015-03,6,63,0,0,19.625,-82.125,3,0,3
2015-03,7,45,0,0,19.875,-86.625,4,0,4
2015-03,7,46,0,0,19.875,-86.375,1,0,1
2015-03,8,16,0,0,20.125,-93.875,0,1,1
2015-03,9,16,0,0,20.375,-93.875,0,4,4
2015-03,9,17,0,0,20.375,-93.625,0,1,1
2015-03,10,16,0,0,20.625,-93.875,0,3,3
2015-03,12,57,0,0,21.125,-83.625,2,0,2
2015-03,12,58,0,0,21.125,-83.375,5,0,5
2015-03,16,11,0,0,22.125,-95.125,0,6,6
2015-03,16,12,0,0,22.125,-94.875,0,6,6
2015-03,16,13,0,0,22.125,-94.625,0,2,2
2015-03,16,14,0,0,22.125,-94.375,0,1,1
2015-03,17,12,0,0,22.375,-94.875,0,3,3
2015-03,17,13,0,0,22.375,-94.625,0,4,4
2015-03,18,42,0,0,22.625,-87.375,3,0,3
2015-03,19,13,0,0,22.875,-94.625,0,4,4
2015-03,19,14,0,0,22.875,-94.375,0,5,5
2015-03,19,41,0,0,22.875,-87.625,3,0,3
2015-03,19,42,0,0,22.875,-87.375,2,0,2
2015-03,20,41,0,0,23.125,-87.625,8,0,8
2015-03,20,42,0,0,23.125,-87.375,9,0,9
2015-03,22,25,0,0,23.625,-91.625,0,2,2
2015-03,22,26,0,0,23.625,-91.375,0,1,1
2015-03,22,56,0,0,23.625,-83.875,17,0,17
2015-03,22,57,0,0,23.625,-83.625,7,0,7
2015-03,22,58,0,0,23.625,-83.375,7,0,7
2015-03,23,26,0,0,23.875,-91.375,0,4,4
2015-03,23,27,0,0,23.875,-91.125,0,8,8
2015-03,23,42,1,1,23.875,-87.375,0,0,0
2015-03,23,44,1,1,23.875,-86.875,0,0,0
2015-03,23,45,3,1,23.875,-86.625,0,0,0
2015-03,23,46,1,1,23.875,-86.375,0,0,0
2015-03,24,10,2,1,24.125,-95.375,0,0,0
2015-03,24,11,1,1,24.125,-95.125,0,0,0
2015-03,24,41,1,1,24.125,-87.625,0,0,0
2015-03,25,6,0,0,24.375,-96.375,2,0,2
2015-03,25,7,0,0,24.375,-96.125,20,0,20
2015-03,25,8,0,0,24.375,-95.875,9,0,9
2015-03,25,9,1,1,24.375,-95.625,0,0,0
2015-03,25,10,1,1,24.375,-95.375,0,0,0
2015-03,25,40,1,1,24.375,-87.875,0,0,0
2015-03,25,46,0,0,24.375,-86.375,0,2,2
2015-03,25,47,0,0,24.375,-86.125,0,7,7
2015-03,25,48,0,0,24.375,-85.875,0,16,16
2015-03,26,13,1,1,24.625,-94.625,0,0,0
2015-03,26,38,1,1,24.625,-88.375,0,0,0
2015-03,26,40,0,0,24.625,-87.875,1,0,1
2015-03,26,41,0,0,24.625,-87.625,2,0,2
2015-03,26,45,0,0,24.625,-86.625,0,2,2
2015-03,26,47,0,0,24.625,-86.125,0,1,1
2015-03,26,48,0,0,24.625,-85.875,0,1,1
2015-03,27,30,0,0,24.875,-90.375,3,0,3
2015-03,27,32,0,0,24.875,-89.875,3,0,3
2015-03,27,33,0,0,24.875,-89.625,2,0,2
2015-03,27,36,0,0,24.875,-88.875,3,0,3
2015-03,27,37,0,0,24.875,-88.625,5,0,5
2015-03,28,15,1,1,25.125,-94.125,0,0,0
2015-03,28,18,0,0,25.125,-93.375,2,0,2
2015-03,28,19,0,0,25.125,-93.125,8,0,8
2015-03,28,20,0,0,25.125,-92.875,3,0,3
2015-03,28,28,0,0,25.125,-90.875,2,0,2
2015-03,28,30,0,0,25.125,-90.375,6,0,6
2015-03,28,31,0,0,25.125,-90.125,3,0,3
2015-03,28,32,0,0,25.125,-89.875,2,0,2
2015-03,28,35,1,1,25.125,-89.125,0,0,0
2015-03,28,36,1,1,25.125,-88.875,0,0,0
2015-03,29,17,0,0,25.375,-93.625,3,0,3
2015-03,29,18,0,0,25.375,-93.375,6,0,6
2015-03,29,35,1,1,25.375,-89.125,0,0,0
2015-03,29,36,1,1,25.375,-88.875,0,0,0
2015-03,30,12,0,0,25.625,-94.875,0,5,5
2015-03,30,13,0,0,25.625,-94.625,0,6,6
2015-03,30,16,0,0,25.625,-93.875,4,0,4
2015-03,30,17,1,1,25.625,-93.625,4,0,4
2015-03,30,36,1,1,25.625,-88.875,0,0,0
2015-03,31,37,1,1,25.875,-88.625,0,0,0
2015-03,31,49,0,0,25.875,-85.625,3,0,3
2015-03,31,50,0,0,25.875,-85.375,3,0,3
2015-03,32,19,1,1,26.125,-93.125,0,0,0
2015-03,32,47,0,0,26.125,-86.125,1,0,1
2015-03,32,48,0,0,26.125,-85.875,4,0,4
2015-03,32,49,0,0,26.125,-85.625,1,0,1
2015-03,33,21,1,1,26.375,-92.625,0,0,0
2015-03,33,45,0,0,26.375,-86.625,12,0,12
2015-03,33,46,0,0,26.375,-86.375,4,0,4
2015-03,33,47,0,0,26.375,-86.125,1,0,1
2015-03,34,34,0,0,26.625,-89.375,0,5,5
2015-03,34,35,0,0,26.625,-89.125,0,5,5
2015-03,34,36,0,0,26.625,-88.875,0,9,9
2015-03,35,22,0,0,26.875,-92.375,0,1,1
2015-03,35,23,1,1,26.875,-92.125,0,3,3
2015-03,35,24,0,0,26.875,-91.875,0,2,2
2015-03,35,25,0,0,26.875,-91.625,0,2,2
2015-03,35,26,1,1,26.875,-91.375,0,7,7
2015-03,35,27,0,0,26.875,-91.125,0,1,1
2015-03,35,28,1,1,26.875,-90.875,0,0,0
2015-03,35,30,1,1,26.875,-90.375,0,0,0
2015-03,35,31,1,1,26.875,-90.125,0,0,0
2015-03,35,32,1,1,26.875,-89.875,0,0,0
2015-03,35,34,1,1,26.875,-89.375,0,10,10
2015-03,35,35,1,1,26.875,-89.125,0,0,0
2015-03,35,36,0,0,26.875,-88.875,0,2,2
2015-03,35,45,0,0,26.875,-86.625,2,0,2
2015-03,36,20,0,0,27.125,-92.875,0,4,4
2015-03,36,21,0,0,27.125,-92.625,0,7,7
2015-03,36,22,0,0,27.125,-92.375,0,2,2
2015-03,36,28,1,1,27.125,-90.875,0,0,0
2015-03,36,29,2,1,27.125,-90.625,0,0,0
2015-03,36,30,2,1,27.125,-90.375,0,0,0
2015-03,36,32,1,1,27.125,-89.875,0,0,0
2015-03,36,33,4,1,27.125,-89.625,0,0,0
2015-03,36,34,1,1,27.125,-89.375,0,0,0
2015-03,36,35,1,1,27.125,-89.125,0,0,0
2015-03,36,40,1,1,27.125,-87.875,0,0,0
2015-03,36,41,0,0,27.125,-87.625,1,0,1
2015-03,37,26,1,1,27.375,-91.375,0,0,0
2015-03,37,27,2,1,27.375,-91.125,0,0,0
2015-03,37,28,1,1,27.375,-90.875,0,0,0
2015-03,37,29,1,1,27.375,-90.625,0,0,0
2015-03,37,34,4,1,27.375,-89.375,0,0,0
2015-03,37,35,1,1,27.375,-89.125,0,0,0
2015-03,37,36,1,1,27.375,-88.875,0,0,0
2015-03,37,40,1,1,27.375,-87.875,1,0,1
2015-03,37,41,0,0,27.375,-87.625,4,0,4
2015-03,37,47,0,0,27.375,-86.125,0,2,2
2015-03,38,24,2,1,27.625,-91.875,0,0,0
2015-03,38,27,1,1,27.625,-91.125,0,0,0
2015-03,38,30,1,1,27.625,-90.375,0,0,0
2015-03,38,33,1,1,27.625,-89.625,0,0,0
2015-03,38,37,1,1,27.625,-88.625,0,0,0
2015-03,38,38,2,2,27.625,-88.375,0,0,0
2015-03,38,39,0,0,27.625,-88.125,2,0,2
2015-03,38,40,2,1,27.625,-87.875,2,0,2
2015-03,38,41,1,1,27.625,-87.625,0,0,0
2015-03,38,42,1,1,27.625,-87.375,0,0,0
2015-03,38,43,1,1,27.625,-87.125,0,0,0
2015-03,38,48,0,0,27.625,-85.875,0,13,13
2015-03,39,25,1,1,27.875,-91.625,0,0,0
2015-03,39,28,1,1,27.875,-90.875,0,0,0
2015-03,39,30,1,1,27.875,-90.375,0,0,0
2015-03,39,33,1,1,27.875,-89.625,0,0,0
2015-03,39,36,1,1,27.875,-88.875,0,0,0
2015-03,39,38,0,0,27.875,-88.375,1,0,1
2015-03,39,39,1,1,27.875,-88.125,2,0,2
2015-03,39,41,1,1,27.875,-87.625,0,0,0
2015-03,39,42,1,1,27.875,-87.375,0,0,0
2015-03,39,43,1,1,27.875,-87.125,0,0,0
2015-03,40,32,3,1,28.125,-89.875,0,0,0
2015-03,40,34,1,1,28.125,-89.375,0,0,0
2015-03,40,35,1,1,28.125,-89.125,0,0,0
2015-03,40,36,1,1,28.125,-88.875,0,0,0
2015-03,40,38,0,0,28.125,-88.375,5,0,5
2015-03,41,33,7,1,28.375,-89.625,0,0,0
2015-03,41,34,5,2,28.375,-89.375,0,0,0
2015-03,41,35,1,1,28.375,-89.125,1,0,1
2015-03,41,36,1,1,28.375,-88.875,1,0,1
2015-03,41,37,1,1,28.375,-88.625,2,0,2
2015-03,41,39,1,1,28.375,-88.125,0,0,0
2015-03,42,33,2,1,28.625,-89.625,0,0,0
2015-03,42,34,2,1,28.625,-89.375,5,0,5
2015-03,42,35,1,1,28.625,-89.125,0,0,0
2015-03,42,36,2,1,28.625,-88.875,0,0,0
2015-03,43,34,2,1,28.875,-89.375,0,0,0
2015-03,43,36,1,1,28.875,-88.875,4,0,4
2015-03,43,37,1,1,28.875,-88.625,0,0,0
2015-03,43,38,2,1,28.875,-88.375,0,0,0
2015-03,44,39,2,1,29.125,-88.125,0,0,0
2015-04,0,58,0,0,18.125,-83.375,1,0,1
2015-04,0,59,0,0,18.125,-83.125,3,0,3
2015-04,0,60,0,0,18.125,-82.875,4,0,4
2015-04,0,61,0,0,18.125,-82.625,3,0,3
2015-04,0,62,0,0,18.125,-82.375,3,0,3
2015-04,0,71,0,0,18.125,-80.125,0,2,2
2015-04,1,56,0,0,18.375,-83.875,4,0,4
2015-04,1,57,0,0,18.375,-83.625,4,0,4
2015-04,1,58,0,0,18.375,-83.375,2,0,2
2015-04,1,70,0,0,18.375,-80.375,0,2,2
2015-04,2,45,0,0,18.625,-86.625,0,3,3
2015-04,2,46,0,0,18.625,-86.375,0,3,3
2015-04,2,47,0,0,18.625,-86.125,0,7,7
2015-04,2,63,0,0,18.625,-82.125,2,0,2
2015-04,2,64,0,0,18.625,-81.875,2,0,2
2015-04,2,69,0,0,18.625,-80.625,0,4,4
2015-04,3,48,0,0,18.875,-85.875,0,5,5
2015-04,3,49,0,0,18.875,-85.625,0,6,6
2015-04,3,50,0,0,18.875,-85.375,0,5,5
2015-04,3,51,0,0,18.875,-85.125,0,1,1
2015-04,3,66,0,0,18.875,-81.375,0,4,4
2015-04,3,67,0,0,18.875,-81.125,0,2,2
2015-04,3,68,0,0,18.875,-80.875,0,2,2
2015-04,4,65,0,0,19.125,-81.625,0,3,3
2015-04,4,66,0,0,19.125,-81.375,0,2,2
2015-04,4,67,0,0,19.125,-81.125,0,2,2
2015-04,5,64,0,0,19.375,-81.875,0,1,1
2015-04,11,55,0,0,20.875,-84.125,7,0,7
2015-04,12,55,0,0,21.125,-84.125,5,0,5
2015-04,12,56,0,0,21.125,-83.875,9,0,9
2015-04,12,57,0,0,21.125,-83.625,6,0,6
2015-04,16,11,0,0,22.125,-95.125,0,3,3
2015-04,16,12,0,0,22.125,-94.875,0,7,7
2015-04,17,10,0,0,22.375,-95.375,0,3,3
2015-04,17,11,0,0,22.375,-95.125,0,11,11
2015-04,17,12,0,0,22.375,-94.875,0,6,6
2015-04,18,6,1,1,22.625,-96.375,0,0,0
2015-04,19,4,1,1,22.875,-96.875,0,0,0
2015-04,19,6,1,1,22.875,-96.375,0,0,0
2015-04,19,7,1,1,22.875,-96.125,0,0,0
2015-04,19,8,6,1,22.875,-95.875,0,0,0
2015-04,19,9,2,1,22.875,-95.625,0,0,0
2015-04,20,8,8,1,23.125,-95.875,0,0,0
2015-04,21,9,3,1,23.375,-95.625,0,0,0
2015-04,22,8,2,1,23.625,-95.875,0,0,0
2015-04,22,9,2,1,23.625,-95.625,0,0,0
2015-04,22,59,0,0,23.625,-83.125,1,0,1
2015-04,23,9,1,1,23.875,-95.625,0,0,0
2015-04,24,6,0,0,24.125,-96.375,8,0,8
2015-04,24,9,1,1,24.125,-95.625,0,0,0
2015-04,24,49,0,0,24.125,-85.625,0,3,3
2015-04,24,50,0,0,24.125,-85.375,0,14,14
2015-04,25,6,0,0,24.375,-96.375,9,0,9
2015-04,25,7,0,0,24.375,-96.125,8,0,8
2015-04,25,9,1,1,24.375,-95.625,0,0,0
2015-04,25,33,0,0,24.375,-89.625,3,0,3
2015-04,25,34,0,0,24.375,-89.375,4,0,4
2015-04,25,36,0,0,24.375,-88.875,2,0,2
2015-04,25,49,0,0,24.375,-85.625,0,1,1
2015-04,27,34,0,0,24.875,-89.375,2,0,2
2015-04,27,35,0,0,24.875,-89.125,1,0,1
2015-04,27,36,0,0,24.875,-88.875,1,0,1
2015-04,28,33,0,0,25.125,-89.625,4,0,4
2015-04,28,34,0,0,25.125,-89.375,3,0,3
2015-04,28,35,0,0,25.125,-89.125,1,0,1
2015-04,29,9,0,0,25.375,-95.625,2,0,2
2015-04,29,10,0,0,25.375,-95.375,2,0,2
2015-04,30,15,0,0,25.625,-94.125,2,0,2
2015-04,30,16,0,0,25.625,-93.875,2,0,2
2015-04,31,14,0,0,25.875,-94.375,1,0,1
2015-04,31,15,0,0,25.875,-94.125,3,0,3
2015-04,31,43,0,0,25.875,-87.125,1,0,1
2015-04,31,44,0,0,25.875,-86.875,2,0,2
2015-04,31,50,0,0,25.875,-85.375,4,0,4
2015-04,32,13,0,0,26.125,-94.625,4,0,4
2015-04,32,14,0,0,26.125,-94.375,1,0,1
2015-04,32,44,0,0,26.125,-86.875,2,0,2
2015-04,32,45,0,0,26.125,-86.625,2,0,2
2015-04,32,46,0,0,26.125,-86.375,7,0,7
2015-04,32,47,0,0,26.125,-86.125,8,0,8
2015-04,32,48,0,0,26.125,-85.875,3,0,3
2015-04,33,12,0,0,26.375,-94.875,3,0,3
2015-04,33,13,0,0,26.375,-94.625,9,0,9
2015-04,33,34,0,0,26.375,-89.375,0,1,1
2015-04,34,18,0,0,26.625,-93.375,0,5,5
2015-04,34,19,0,0,26.625,-93.125,0,2,2
2015-04,34,34,0,0,26.625,-89.375,0,2,2
2015-04,34,35,0,0,26.625,-89.125,0,10,10
2015-04,34,36,0,0,26.625,-88.875,0,11,11
2015-04,35,19,0,0,26.875,-93.125,0,11,11
2015-04,35,20,0,0,26.875,-92.875,0,1,1
2015-04,35,34,0,0,26.875,-89.375,0,3,3
2015-04,35,35,0,0,26.875,-89.125,0,3,3
2015-04,36,19,0,0,27.125,-93.125,0,1,1
2015-04,36,20,0,0,27.125,-92.875,0,10,10
2015-04,36,29,1,1,27.125,-90.625,0,0,0
2015-04,36,30,6,1,27.125,-90.375,0,0,0
2015-04,36,31,2,1,27.125,-90.125,0,0,0
2015-04,36,41,0,0,27.125,-87.625,2,0,2
2015-04,37,29,2,1,27.375,-90.625,0,0,0
2015-04,37,30,4,1,27.375,-90.375,0,0,0
2015-04,37,34,1,1,27.375,-89.375,0,0,0
2015-04,37,40,0,0,27.375,-87.875,2,0,2
2015-04,38,25,0,0,27.625,-91.625,1,0,1
2015-04,38,26,0,0,27.625,-91.375,1,0,1
2015-04,38,30,1,1,27.625,-90.375,0,0,0
2015-04,38,31,1,1,27.625,-90.125,0,0,0
2015-04,38,32,1,1,27.625,-89.875,0,0,0
2015-04,38,46,0,0,27.625,-86.375,0,4,4
2015-04,38,47,0,0,27.625,-86.125,0,15,15
2015-04,38,48,0,0,27.625,-85.875,0,4,4
2015-04,39,26,0,0,27.875,-91.375,1,0,1
2015-04,39,30,1,1,27.875,-90.375,0,0,0
2015-04,39,31,3,1,27.875,-90.125,0,0,0
2015-04,39,32,4,1,27.875,-89.875,0,0,0
2015-04,39,33,2,2,27.875,-89.625,0,0,0
2015-04,40,32,1,1,28.125,-89.875,0,0,0
2015-04,40,34,2,1,28.125,-89.375,0,0,0
2015-04,40,35,1,1,28.125,-89.125,0,0,0
2015-04,41,30,1,1,28.375,-90.375,0,0,0
2015-04,41,31,1,1,28.375,-90.125,0,0,0
2015-04,41,32,1,1,28.375,-89.875,0,0,0
2015-04,41,35,1,1,28.375,-89.125,0,0,0
2015-04,42,32,1,1,28.625,-89.875,0,0,0
2015-04,42,34,1,1,28.625,-89.375,0,0,0
2015-04,42,36,1,1,28.625,-88.875,0,0,0
2015-04,43,39,1,1,28.875,-88.125,0,0,0
2015-04,43,42,2,1,28.875,-87.375,0,0,0
2015-04,43,43,1,1,28.875,-87.125,0,0,0
2015-04,44,40,2,1,29.125,-87.875,0,0,0
2015-04,44,41,4,1,29.125,-87.625,0,0,0
2015-04,44,42,1,1,29.125,-87.375,0,0,0
2015-04,44,43,1,1,29.125,-87.125,0,0,0
2015-04,45,43,2,1,29.375,-87.125,0,0,0
2015-04,45,44,1,1,29.375,-86.875,0,0,0
2015-04,46,43,1,1,29.625,-87.125,0,0,0
2015-04,46,44,4,1,29.625,-86.875,0,0,0
2015-05,0,56,0,0,18.125,-83.875,1,0,1
2015-05,1,44,0,0,18.375,-86.875,0,5,5
2015-05,1,45,0,0,18.375,-86.625,0,1,1
2015-05,2,54,0,0,18.625,-84.375,3,0,3
2015-05,2,55,0,0,18.625,-84.125,4,0,4
2015-05,3,52,0,0,18.875,-84.875,1,0,1
2015-05,3,53,0,0,18.875,-84.625,2,0,2
2015-05,3,54,0,0,18.875,-84.375,1,0,1
2015-05,4,51,0,0,19.125,-85.125,2,0,2
2015-05,4,52,0,0,19.125,-84.875,2,0,2
2015-05,5,50,0,0,19.375,-85.375,2,0,2
2015-05,5,51,0,0,19.375,-85.125,2,0,2
2015-05,5,63,0,0,19.375,-82.125,0,1,1
2015-05,5,64,0,0,19.375,-81.875,0,1,1
2015-05,6,47,0,0,19.625,-86.125,1,0,1
2015-05,6,48,0,0,19.625,-85.875,4,0,4
2015-05,6,49,0,0,19.625,-85.625,5,0,5
2015-05,6,50,0,0,19.625,-85.375,1,0,1
2015-05,6,62,0,0,19.625,-82.375,0,1,1
2015-05,6,63,0,0,19.625,-82.125,0,2,2
2015-05,7,57,0,0,19.875,-83.625,0,1,1
2015-05,7,61,0,0,19.875,-82.625,0,1,1
2015-05,7,62,0,0,19.875,-82.375,0,1,1
2015-05,8,57,0,0,20.125,-83.625,0,5,5
2015-05,8,58,0,0,20.125,-83.375,0,2,2
2015-05,8,60,0,0,20.125,-82.875,0,1,1
2015-05,8,61,0,0,20.125,-82.625,0,3,3
2015-05,8,69,0,0,20.125,-80.625,3,0,3
2015-05,8,70,0,0,20.125,-80.375,3,0,3
2015-05,8,71,0,0,20.125,-80.125,6,0,6
2015-05,9,58,0,0,20.375,-83.375,0,2,2
2015-05,9,59,0,0,20.375,-83.125,0,4,4
2015-05,9,60,0,0,20.375,-82.875,0,6,6
2015-05,9,67,0,0,20.375,-81.125,1,0,1
2015-05,9,68,0,0,20.375,-80.875,4,0,4
2015-05,11,55,0,0,20.875,-84.125,1,0,1
2015-05,13,16,0,0,21.375,-93.875,4,0,4
2015-05,13,17,0,0,21.375,-93.625,7,0,7
2015-05,13,18,0,0,21.375,-93.375,9,0,9
2015-05,16,7,0,0,22.125,-96.125,0,2,2
2015-05,16,8,0,0,22.125,-95.875,0,12,12
2015-05,16,9,0,0,22.125,-95.625,0,1,1
2015-05,17,9,0,0,22.375,-95.625,0,8,8
2015-05,17,10,0,0,22.375,-95.375,0,8,8
2015-05,20,8,1,1,23.125,-95.875,0,0,0
2015-05,21,8,1,1,23.375,-95.875,0,0,0
2015-05,21,9,2,1,23.375,-95.625,0,0,0
2015-05,22,10,2,1,23.625,-95.375,0,0,0
2015-05,22,28,0,0,23.625,-90.875,0,5,5
2015-05,22,49,0,0,23.625,-85.625,0,2,2
2015-05,22,51,0,0,23.625,-85.125,0,4,4
2015-05,23,50,0,0,23.875,-85.375,0,1,1
2015-05,25,11,1,1,24.375,-95.125,0,0,0
2015-05,25,48,0,0,24.375,-85.875,0,10,10
2015-05,25,49,0,0,24.375,-85.625,0,5,5
2015-05,26,39,0,0,24.625,-88.125,3,0,3
2015-05,26,40,0,0,24.625,-87.875,2,0,2
2015-05,26,48,0,0,24.625,-85.875,0,1,1
2015-05,27,12,1,1,24.875,-94.875,0,0,0
2015-05,27,36,0,0,24.875,-88.875,2,0,2
2015-05,27,37,0,0,24.875,-88.625,5,0,5
2015-05,27,38,0,0,24.875,-88.375,3,0,3
2015-05,27,39,0,0,24.875,-88.125,1,0,1
2015-05,27,40,0,0,24.875,-87.875,3,0,3
2015-05,28,35,0,0,25.125,-89.125,7,0,7
2015-05,28,36,0,0,25.125,-88.875,3,0,3
2015-05,29,10,0,0,25.375,-95.375,24,0,24
2015-05,29,11,0,0,25.375,-95.125,1,0,1
2015-05,29,13,1,1,25.375,-94.625,0,0,0
2015-05,30,10,0,0,25.625,-95.375,4,0,4
2015-05,30,11,0,0,25.625,-95.125,2,0,2
2015-05,30,23,1,1,25.625,-92.125,0,0,0
2015-05,30,43,0,0,25.625,-87.125,1,0,1
2015-05,30,51,0,0,25.625,-85.125,7,0,7
2015-05,31,14,1,1,25.875,-94.375,0,0,0
2015-05,31,24,2,1,25.875,-91.875,0,0,0
2015-05,31,29,0,0,25.875,-90.625,0,2,2
2015-05,31,43,0,0,25.875,-87.125,1,0,1
2015-05,31,51,0,0,25.875,-85.125,3,0,3
2015-05,32,21,1,1,26.125,-92.625,0,0,0
2015-05,32,28,0,0,26.125,-90.875,0,3,3
2015-05,32,29,0,0,26.125,-90.625,0,5,5
2015-05,32,30,0,0,26.125,-90.375,0,6,6
2015-05,32,51,0,0,26.125,-85.125,3,0,3
2015-05,32,52,0,0,26.125,-84.875,1,0,1
2015-05,33,15,1,1,26.375,-94.125,0,0,0
2015-05,33,16,0,0,26.375,-93.875,0,3,3
2015-05,33,17,0,0,26.375,-93.625,0,4,4
2015-05,33,21,1,1,26.375,-92.625,0,0,0
2015-05,33,30,0,0,26.375,-90.375,0,1,1
2015-05,33,31,0,0,26.375,-90.125,0,3,3
2015-05,33,33,0,0,26.375,-89.625,0,3,3
2015-05,33,34,0,0,26.375,-89.375,0,2,2
2015-05,33,43,0,0,26.375,-87.125,0,1,1
2015-05,33,48,0,0,26.375,-85.875,2,0,2
2015-05,33,50,0,0,26.375,-85.375,2,0,2
2015-05,33,51,0,0,26.375,-85.125,2,0,2
2015-05,33,52,0,0,26.375,-84.875,6,0,6
2015-05,34,16,2,1,26.625,-93.875,0,0,0
2015-05,34,17,0,0,26.625,-93.625,0,13,13
2015-05,34,18,0,0,26.625,-93.375,0,4,4
2015-05,34,19,1,1,26.625,-93.125,0,0,0
2015-05,34,21,1,1,26.625,-92.625,0,0,0
2015-05,34,32,0,0,26.625,-89.875,0,1,1
2015-05,34,33,0,0,26.625,-89.625,0,4,4
2015-05,34,34,0,0,26.625,-89.375,0,1,1
2015-05,34,43,0,0,26.625,-87.125,0,8,8
2015-05,34,44,0,0,26.625,-86.875,0,2,2
2015-05,35,17,1,1,26.875,-93.625,0,7,7
2015-05,35,18,1,1,26.875,-93.375,0,0,0
2015-05,35,19,1,1,26.875,-93.125,0,0,0
2015-05,35,20,1,1,26.875,-92.875,0,0,0
2015-05,35,21,1,1,26.875,-92.625,0,0,0
2015-05,35,22,1,1,26.875,-92.375,0,0,0
2015-05,35,24,1,1,26.875,-91.875,0,0,0
2015-05,35,33,3,1,26.875,-89.625,0,0,0
2015-05,35,44,0,0,26.875,-86.875,0,4,4
2015-05,36,20,1,1,27.125,-92.875,0,0,0
2015-05,36,26,1,1,27.125,-91.375,0,0,0
2015-05,36,32,1,1,27.125,-89.875,0,0,0
2015-05,36,34,1,1,27.125,-89.375,0,0,0
2015-05,37,22,1,1,27.375,-92.375,0,0,0
2015-05,37,35,1,1,27.375,-89.125,0,0,0
2015-05,37,36,0,0,27.375,-88.875,2,0,2
2015-05,38,23,1,1,27.625,-92.125,0,0,0
2015-05,38,25,1,1,27.625,-91.625,0,0,0
2015-05,38,26,1,1,27.625,-91.375,0,0,0
2015-05,38,29,1,1,27.625,-90.625,0,0,0
2015-05,38,30,1,1,27.625,-90.375,0,0,0
2015-05,38,31,1,1,27.625,-90.125,0,0,0
2015-05,38,36,0,0,27.625,-88.875,2,0,2
2015-05,39,26,0,0,27.875,-91.375,2,0,2
2015-05,39,27,1,1,27.875,-91.125,2,0,2
2015-05,39,28,0,0,27.875,-90.875,1,0,1
2015-05,39,29,1,1,27.875,-90.625,0,0,0
2015-05,39,30,2,2,27.875,-90.375,0,0,0
2015-05,39,32,1,1,27.875,-89.875,0,0,0
2015-05,39,33,2,1,27.875,-89.625,0,0,0
2015-05,39,36,0,0,27.875,-88.875,1,0,1
2015-05,39,37,1,1,27.875,-88.625,0,0,0
2015-05,40,28,0,0,28.125,-90.875,1,0,1
2015-05,40,29,0,0,28.125,-90.625,1,0,1
2015-05,40,30,0,0,28.125,-90.375,1,0,1
2015-05,40,31,0,0,28.125,-90.125,1,0,1
2015-05,40,32,0,0,28.125,-89.875,1,0,1
2015-05,40,33,0,0,28.125,-89.625,3,0,3
2015-05,40,34,1,1,28.125,-89.375,0,0,0
2015-05,40,35,0,0,28.125,-89.125,11,0,11
2015-05,40,36,0,0,28.125,-88.875,2,0,2
2015-05,40,40,1,1,28.125,-87.875,0,0,0
2015-05,40,42,1,1,28.125,-87.375,0,0,0
2015-05,40,43,1,1,28.125,-87.125,0,0,0
2015-05,41,35,1,1,28.375,-89.125,0,0,0
2015-05,41,36,1,1,28.375,-88.875,0,0,0
2015-05,41,43,1,1,28.375,-87.125,0,0,0
2015-05,42,37,1,1,28.625,-88.625,0,0,0
2015-05,42,39,1,1,28.625,-88.125,0,0,0
2015-05,42,40,1,1,28.625,-87.875,0,0,0
2015-05,42,42,2,1,28.625,-87.375,0,0,0
2015-05,43,35,3,1,28.875,-89.125,0,0,0
2015-05,43,37,1,1,28.875,-88.625,0,0,0
2015-05,43,39,1,1,28.875,-88.125,0,0,0
2015-05,43,42,1,1,28.875,-87.375,0,0,0
2015-05,43,43,2,1,28.875,-87.125,0,0,0
2015-05,44,37,2,1,29.125,-88.625,0,0,0
2015-05,44,39,3,1,29.125,-88.125,0,0,0
2015-05,44,40,1,1,29.125,-87.875,0,0,0
2015-05,44,42,2,1,29.125,-87.375,0,0,0
2015-05,45,41,2,1,29.375,-87.625,0,0,0
2015-05,45,42,5,1,29.375,-87.375,0,0,0
2015-05,46,41,1,1,29.625,-87.625,0,0,0
2015-05,46,42,2,1,29.625,-87.375,0,0,0
2015-05,46,43,5,1,29.625,-87.125,0,0,0
2015-06,0,60,0,0,18.125,-82.875,2,0,2
2015-06,2,70,0,0,18.625,-80.375,0,2,2
2015-06,2,71,0,0,18.625,-80.125,0,3,3
2015-06,3,68,0,0,18.875,-80.875,0,1,1
2015-06,3,69,0,0,18.875,-80.625,0,4,4
2015-06,3,70,0,0,18.875,-80.375,0,2,2
2015-06,4,67,0,0,19.125,-81.125,0,3,3
2015-06,4,68,0,0,19.125,-80.875,0,3,3
2015-06,5,45,0,0,19.375,-86.625,8,0,8
2015-06,6,45,0,0,19.625,-86.625,2,0,2
2015-06,6,46,0,0,19.625,-86.375,4,0,4
2015-06,6,47,0,0,19.625,-86.125,3,0,3
2015-06,6,50,0,0,19.625,-85.375,0,3,3
2015-06,6,51,0,0,19.625,-85.125,0,6,6
2015-06,6,52,0,0,19.625,-84.875,0,5,5
2015-06,6,53,0,0,19.625,-84.625,0,4,4
2015-06,6,54,0,0,19.625,-84.375,0,4,4
2015-06,6,55,0,0,19.625,-84.125,0,1,1
2015-06,7,55,0,0,19.875,-84.125,0,3,3
2015-06,7,56,0,0,19.875,-83.875,0,4,4
2015-06,8,59,0,0,20.125,-83.125,1,0,1
2015-06,8,64,0,0,20.125,-81.875,1,0,1
2015-06,8,65,0,0,20.125,-81.625,2,0,2
2015-06,9,62,0,0,20.375,-82.375,2,0,2
2015-06,9,63,0,0,20.375,-82.125,2,0,2
2015-06,9,64,0,0,20.375,-81.875,10,0,10
2015-06,9,65,0,0,20.375,-81.625,7,0,7
2015-06,9,67,0,0,20.375,-81.125,2,0,2
2015-06,10,21,0,0,20.625,-92.625,0,1,1
2015-06,10,22,0,0,20.625,-92.375,0,3,3
2015-06,10,69,0,0,20.625,-80.625,1,0,1
2015-06,10,70,0,0,20.625,-80.375,1,0,1
2015-06,10,71,0,0,20.625,-80.125,2,0,2
2015-06,11,19,0,0,20.875,-93.125,0,4,4
2015-06,11,20,0,0,20.875,-92.875,0,1,1
2015-06,11,21,0,0,20.875,-92.625,0,3,3
2015-06,11,22,0,0,20.875,-92.375,0,1,1
2015-06,12,15,0,0,21.125,-94.125,4,0,4
2015-06,12,19,0,0,21.125,-93.125,0,1,1
2015-06,13,15,0,0,21.375,-94.125,2,0,2
2015-06,16,6,0,0,22.125,-96.375,0,6,6
2015-06,16,7,0,0,22.125,-96.125,0,13,13
2015-06,17,6,0,0,22.375,-96.375,0,8,8
2015-06,18,6,0,0,22.625,-96.375,0,3,3
2015-06,21,16,0,0,23.375,-93.875,1,0,1
2015-06,21,23,0,0,23.375,-92.125,0,3,3
2015-06,21,24,0,0,23.375,-91.875,0,4,4
2015-06,22,15,0,0,23.625,-94.125,10,0,10
2015-06,22,16,0,0,23.625,-93.875,4,0,4
2015-06,22,24,0,0,23.625,-91.875,0,4,4
2015-06,22,25,0,0,23.625,-91.625,0,5,5
2015-06,22,26,0,0,23.625,-91.375,0,6,6
2015-06,22,27,0,0,23.625,-91.125,0,7,7
2015-06,22,28,0,0,23.625,-90.875,0,1,1
2015-06,22,56,0,0,23.625,-83.875,0,14,14
2015-06,22,57,0,0,23.625,-83.625,0,4,4
2015-06,24,47,0,0,24.125,-86.125,1,0,1
2015-06,25,13,1,1,24.375,-94.625,0,0,0
2015-06,25,47,0,0,24.375,-86.125,1,0,1
2015-06,25,48,0,0,24.375,-85.875,1,0,1
2015-06,26,14,1,1,24.625,-94.375,0,0,0
2015-06,26,48,0,0,24.625,-85.875,2,0,2
2015-06,27,14,1,1,24.875,-94.375,0,0,0
2015-06,27,48,0,0,24.875,-85.875,1,0,1
2015-06,27,49,0,0,24.875,-85.625,2,0,2
2015-06,28,10,0,0,25.125,-95.375,10,0,10
2015-06,28,35,0,0,25.125,-89.125,1,0,1
2015-06,28,49,0,0,25.125,-85.625,2,0,2
2015-06,28,50,0,0,25.125,-85.375,5,0,5
2015-06,28,51,0,0,25.125,-85.125,2,0,2
2015-06,29,9,0,0,25.375,-95.625,1,0,1
2015-06,29,10,0,0,25.375,-95.375,6,0,6
2015-06,29,11,0,0,25.375,-95.125,2,0,2
2015-06,29,14,1,1,25.375,-94.375,0,0,0
2015-06,29,51,0,0,25.375,-85.125,13,0,13
2015-06,30,9,0,0,25.625,-95.625,10,0,10
2015-06,30,22,2,1,25.625,-92.375,0,0,0
2015-06,30,25,1,1,25.625,-91.625,0,0,0
2015-06,31,9,0,0,25.875,-95.625,1,0,1
2015-06,31,13,1,1,25.875,-94.625,0,0,0
2015-06,31,20,1,1,25.875,-92.875,0,0,0
2015-06,31,25,2,1,25.875,-91.625,0,0,0
2015-06,31,26,2,1,25.875,-91.375,0,7,7
2015-06,31,27,2,1,25.875,-91.125,0,7,7
2015-06,31,28,1,1,25.875,-90.875,0,0,0
2015-06,31,29,2,1,25.875,-90.625,0,0,0
2015-06,31,34,0,0,25.875,-89.375,1,0,1
2015-06,31,35,0,0,25.875,-89.125,3,0,3
2015-06,32,11,1,1,26.125,-95.125,0,0,0
2015-06,32,16,0,0,26.125,-93.875,0,8,8
2015-06,32,17,1,1,26.125,-93.625,0,0,0
2015-06,32,27,0,0,26.125,-91.125,0,10,10
2015-06,32,28,0,0,26.125,-90.875,0,6,6
2015-06,33,13,2,1,26.375,-94.625,0,0,0
2015-06,33,14,1,1,26.375,-94.375,0,0,0
2015-06,33,16,0,0,26.375,-93.875,0,22,22
2015-06,34,43,0,0,26.625,-87.125,0,13,13
2015-06,34,44,0,0,26.625,-86.875,0,6,6
2015-06,35,44,0,0,26.875,-86.875,0,11,11
2015-06,37,36,4,1,27.375,-88.875,1,0,1
2015-06,37,37,1,1,27.375,-88.625,0,0,0
2015-06,37,38,1,1,27.375,-88.375,0,0,0
2015-06,37,42,1,1,27.375,-87.375,0,0,0
2015-06,37,43,1,1,27.375,-87.125,0,0,0
2015-06,38,32,1,1,27.625,-89.875,0,0,0
2015-06,38,40,1,1,27.625,-87.875,0,0,0
2015-06,38,41,1,1,27.625,-87.625,0,0,0
2015-06,38,42,1,1,27.625,-87.375,0,0,0
2015-06,38,44,1,1,27.625,-86.875,0,0,0
2015-06,38,45,2,1,27.625,-86.625,0,0,0
2015-06,38,48,1,1,27.625,-85.875,0,0,0
2015-06,39,30,1,1,27.875,-90.375,0,0,0
2015-06,39,31,2,1,27.875,-90.125,0,0,0
2015-06,39,44,4,1,27.875,-86.875,0,0,0
2015-06,39,46,3,1,27.875,-86.375,0,0,0
2015-06,39,47,2,1,27.875,-86.125,0,0,0
2015-06,40,31,5,1,28.125,-90.125,0,0,0
2015-06,40,45,1,1,28.125,-86.625,0,0,0
2015-06,40,46,4,1,28.125,-86.375,0,0,0
2015-06,40,47,1,1,28.125,-86.125,0,0,0
2015-06,41,29,1,1,28.375,-90.625,0,0,0
2015-06,41,30,2,1,28.375,-90.375,0,0,0
2015-06,41,31,2,1,28.375,-90.125,0,0,0
2015-06,41,32,3,1,28.375,-89.875,0,0,0
2015-06,41,33,1,1,28.375,-89.625,0,0,0
2015-06,41,34,1,1,28.375,-89.375,0,0,0
2015-06,42,31,1,1,28.625,-90.125,0,0,0
2015-06,42,32,2,1,28.625,-89.875,0,0,0
2015-06,42,33,2,1,28.625,-89.625,0,0,0
2015-06,42,34,4,1,28.625,-89.375,0,0,0
2015-06,43,35,2,1,28.875,-89.125,0,0,0
2015-07,0,54,0,0,18.125,-84.375,1,0,1
2015-07,0,56,0,0,18.125,-83.875,2,0,2
2015-07,0,59,0,0,18.125,-83.125,5,0,5
2015-07,0,60,0,0,18.125,-82.875,1,0,1
2015-07,3,64,0,0,18.875,-81.875,0,1,1
2015-07,3,65,0,0,18.875,-81.625,0,3,3
2015-07,3,66,0,0,18.875,-81.375,0,6,6
2015-07,4,62,0,0,19.125,-82.375,0,2,2
2015-07,4,63,0,0,19.125,-82.125,0,2,2
2015-07,4,64,0,0,19.125,-81.875,0,1,1
2015-07,4,66,0,0,19.125,-81.375,0,1,1
2015-07,4,67,0,0,19.125,-81.125,0,5,5
2015-07,4,71,0,0,19.125,-80.125,1,0,1
2015-07,5,59,0,0,19.375,-83.125,0,1,1
2015-07,5,60,0,0,19.375,-82.875,0,2,2
2015-07,5,61,0,0,19.375,-82.625,0,1,1
2015-07,5,71,0,0,19.375,-80.125,1,0,1
2015-07,6,48,0,0,19.625,-85.875,0,2,2
2015-07,6,49,0,0,19.625,-85.625,0,6,6
2015-07,6,50,0,0,19.625,-85.375,0,2,2
2015-07,6,56,0,0,19.625,-83.875,0,1,1
2015-07,6,57,0,0,19.625,-83.625,0,2,2
2015-07,6,58,0,0,19.625,-83.375,0,2,2
2015-07,6,59,0,0,19.625,-83.125,0,1,1
2015-07,6,71,0,0,19.625,-80.125,1,0,1
2015-07,8,15,0,0,20.125,-94.125,0,9,9
2015-07,8,16,0,0,20.125,-93.875,0,2,2
2015-07,8,49,0,0,20.125,-85.625,0,5,5
2015-07,9,18,0,0,20.375,-93.375,0,4,4
2015-07,9,19,0,0,20.375,-93.125,0,6,6
2015-07,9,49,0,0,20.375,-85.625,0,2,2
2015-07,9,54,0,0,20.375,-84.375,3,0,3
2015-07,9,71,0,0,20.375,-80.125,2,0,2
2015-07,10,19,0,0,20.625,-93.125,0,4,4
2015-07,10,49,0,0,20.625,-85.625,0,2,2
2015-07,10,54,0,0,20.625,-84.375,3,0,3
2015-07,10,71,0,0,20.625,-80.125,1,0,1
2015-07,11,19,0,0,20.875,-93.125,0,6,6
2015-07,11,49,0,0,20.875,-85.625,0,6,6
2015-07,11,54,0,0,20.875,-84.375,6,0,6
2015-07,12,49,0,0,21.125,-85.625,0,1,1
2015-07,12,54,0,0,21.125,-84.375,1,0,1
2015-07,17,6,0,0,22.375,-96.375,0,5,5
2015-07,18,6,0,0,22.625,-96.375,0,2,2
2015-07,18,11,0,0,22.625,-95.125,2,0,2
2015-07,18,12,0,0,22.625,-94.875,6,0,6
2015-07,18,13,0,0,22.625,-94.625,4,0,4
2015-07,18,14,0,0,22.625,-94.375,1,0,1
2015-07,19,6,0,0,22.875,-96.375,0,4,4
2015-07,19,13,0,0,22.875,-94.625,1,0,1
2015-07,19,14,0,0,22.875,-94.375,8,0,8
2015-07,20,6,0,0,23.125,-96.375,0,3,3
2015-07,20,14,0,0,23.125,-94.375,2,0,2
2015-07,20,44,0,0,23.125,-86.875,1,0,1
2015-07,21,6,0,0,23.375,-96.375,0,1,1
2015-07,21,14,0,0,23.375,-94.375,2,0,2
2015-07,21,19,0,0,23.375,-93.125,0,4,4
2015-07,21,20,0,0,23.375,-92.875,0,7,7
2015-07,21,21,0,0,23.375,-92.625,0,6,6
2015-07,21,22,0,0,23.375,-92.375,0,6,6
2015-07,21,23,0,0,23.375,-92.125,0,8,8
2015-07,21,42,0,0,23.375,-87.375,1,0,1
2015-07,21,43,0,0,23.375,-87.125,4,0,4
2015-07,21,44,0,0,23.375,-86.875,3,0,3
2015-07,22,6,0,0,23.625,-96.375,0,3,3
2015-07,22,15,0,0,23.625,-94.125,2,0,2
2015-07,22,41,0,0,23.625,-87.625,1,0,1
2015-07,22,42,0,0,23.625,-87.375,2,0,2
2015-07,22,43,0,0,23.625,-87.125,3,0,3
2015-07,22,57,0,0,23.625,-83.625,0,7,7
2015-07,22,58,0,0,23.625,-83.375,0,1,1
2015-07,23,45,0,0,23.875,-86.625,1,0,1
2015-07,23,46,0,0,23.875,-86.375,1,0,1
2015-07,24,6,0,0,24.125,-96.375,0,2,2
2015-07,24,7,0,0,24.125,-96.125,0,2,2
2015-07,24,46,0,0,24.125,-86.375,3,0,3
2015-07,25,7,0,0,24.375,-96.125,0,2,2
2015-07,25,8,0,0,24.375,-95.875,0,1,1
2015-07,25,37,0,0,24.375,-88.625,1,0,1
2015-07,26,8,0,0,24.625,-95.875,0,1,1
2015-07,26,9,0,0,24.625,-95.625,0,2,2
2015-07,26,36,0,0,24.625,-88.875,2,0,2
2015-07,26,54,0,0,24.625,-84.375,1,0,1
2015-07,27,10,0,0,24.875,-95.375,0,1,1
2015-07,27,36,0,0,24.875,-88.875,2,0,2
2015-07,27,54,0,0,24.875,-84.375,7,0,7
2015-07,28,54,0,0,25.125,-84.375,3,0,3
2015-07,29,34,0,0,25.375,-89.375,2,0,2
2015-07,29,35,0,0,25.375,-89.125,2,0,2
2015-07,29,53,0,0,25.375,-84.625,1,0,1
2015-07,29,54,0,0,25.375,-84.375,1,0,1
2015-07,30,8,0,0,25.625,-95.875,1,0,1
2015-07,30,33,0,0,25.625,-89.625,1,0,1
2015-07,30,34,0,0,25.625,-89.375,3,0,3
2015-07,30,53,0,0,25.625,-84.625,2,0,2
2015-07,30,54,0,0,25.625,-84.375,9,0,9
2015-07,31,9,0,0,25.875,-95.625,3,0,3
2015-07,32,9,0,0,26.125,-95.625,12,0,12
2015-07,32,19,0,0,26.125,-93.125,0,3,3
2015-07,32,20,0,0,26.125,-92.875,0,3,3
2015-07,32,21,0,0,26.125,-92.625,0,5,5
2015-07,32,22,0,0,26.125,-92.375,0,4,4
2015-07,32,23,0,0,26.125,-92.125,0,6,6
2015-07,32,24,0,0,26.125,-91.875,0,6,6
2015-07,33,9,0,0,26.375,-95.625,15,0,15
2015-07,33,19,0,0,26.375,-93.125,0,3,3
2015-07,33,20,0,0,26.375,-92.875,0,1,1
2015-07,33,41,0,0,26.375,-87.625,0,5,5
2015-07,33,42,0,0,26.375,-87.375,0,5,5
2015-07,33,43,0,0,26.375,-87.125,0,10,10
2015-07,34,43,0,0,26.625,-87.125,0,11,11
2015-07,36,26,2,1,27.125,-91.375,0,0,0
2015-07,37,27,2,1,27.375,-91.125,0,0,0
2015-07,37,44,1,1,27.375,-86.875,0,0,0
2015-07,38,28,1,1,27.625,-90.875,0,0,0
2015-07,38,29,1,1,27.625,-90.625,0,0,0
2015-07,38,44,1,1,27.625,-86.875,0,0,0
2015-07,39,25,1,1,27.875,-91.625,0,0,0
2015-07,39,30,1,1,27.875,-90.375,0,0,0
2015-07,39,43,1,1,27.875,-87.125,0,0,0
2015-07,39,44,2,1,27.875,-86.875,0,0,0
2015-07,41,22,0,0,28.375,-92.375,0,1,1
2015-07,41,32,2,1,28.375,-89.875,0,0,0
2015-07,41,44,1,1,28.375,-86.875,0,0,0
2015-07,42,40,1,1,28.625,-87.875,0,0,0
2015-07,42,41,1,1,28.625,-87.625,0,0,0
2015-07,42,42,1,1,28.625,-87.375,0,0,0
2015-07,42,43,1,1,28.625,-87.125,0,0,0
2015-07,43,42,1,1,28.875,-87.375,0,0,0
