month,ii,jj,lat,lon,eddy_count_cyclonic,eddy_count_anticyclonic,eddy_count_total
2009-06,0,46,18.125,-86.375,0,3,3
2009-06,0,47,18.125,-86.125,0,1,1
2009-06,0,52,18.125,-84.875,1,0,1
2009-06,0,53,18.125,-84.625,4,0,4
2009-06,0,54,18.125,-84.375,1,0,1
2009-06,1,47,18.375,-86.125,0,3,3
2009-06,1,48,18.375,-85.875,0,2,2
2009-06,1,50,18.375,-85.375,1,0,1
2009-06,1,51,18.375,-85.125,2,0,2
2009-06,1,52,18.375,-84.875,3,0,3
2009-06,1,54,18.375,-84.375,6,0,6
2009-06,1,55,18.375,-84.125,2,0,2
2009-06,2,54,18.625,-84.375,1,0,1
2009-06,2,55,18.625,-84.125,2,0,2
2009-06,2,56,18.625,-83.875,6,0,6
2009-06,2,57,18.625,-83.625,1,0,1
2009-06,10,53,20.625,-84.625,0,1,1
2009-06,10,54,20.625,-84.375,0,4,4
2009-06,10,55,20.625,-84.125,0,3,3
2009-06,10,56,20.625,-83.875,0,1,1
2009-06,10,57,20.625,-83.625,0,3,3
2009-06,10,58,20.625,-83.375,0,4,4
2009-06,10,59,20.625,-83.125,0,2,2
2009-06,10,60,20.625,-82.875,0,1,1
2009-06,10,61,20.625,-82.625,0,3,3
2009-06,10,62,20.625,-82.375,0,1,1
2009-06,10,66,20.625,-81.375,1,0,1
2009-06,10,67,20.625,-81.125,5,0,5
2009-06,10,68,20.625,-80.875,1,0,1
2009-06,10,69,20.625,-80.625,1,0,1
2009-06,11,52,20.875,-84.875,0,5,5
2009-06,11,56,20.875,-83.875,0,2,2
2009-06,11,67,20.875,-81.125,3,0,3
2009-06,11,68,20.875,-80.875,5,0,5
2009-06,13,9,21.375,-95.625,0,7,7
2009-06,13,10,21.375,-95.375,0,7,7
2009-06,13,11,21.375,-95.125,0,10,10
2009-06,13,16,21.375,-93.875,6,0,6
2009-06,14,11,21.625,-95.125,0,3,3
2009-06,14,12,21.625,-94.875,0,3,3
2009-06,14,16,21.625,-93.875,6,0,6
2009-06,18,17,22.625,-93.625,1,0,1
2009-06,18,18,22.625,-93.375,2,0,2
2009-06,19,14,22.875,-94.375,1,0,1
2009-06,19,15,22.875,-94.125,2,0,2
2009-06,19,16,22.875,-93.875,3,0,3
2009-06,19,18,22.875,-93.375,3,0,3
2009-06,19,19,22.875,-93.125,5,0,5
2009-06,20,6,23.125,-96.375,5,0,5
2009-06,20,7,23.125,-96.125,4,0,4
2009-06,20,19,23.125,-93.125,1,0,1
2009-06,22,12,23.625,-94.875,1,0,1
2009-06,22,13,23.625,-94.625,1,0,1
2009-06,23,10,23.875,-95.375,1,0,1
2009-06,23,11,23.875,-95.125,2,0,2
2009-06,23,12,23.875,-94.875,1,0,1
2009-06,23,52,23.875,-84.875,9,0,9
2009-06,23,53,23.875,-84.625,8,0,8
2009-06,24,26,24.125,-91.375,1,0,1
2009-06,24,27,24.125,-91.125,1,0,1
2009-06,24,54,24.125,-84.375,12,0,12
2009-06,25,27,24.375,-91.125,1,0,1
2009-06,25,54,24.375,-84.375,1,0,1
2009-06,26,8,24.625,-95.875,0,4,4
2009-06,26,9,24.625,-95.625,0,7,7
2009-06,27,9,24.875,-95.625,0,6,6
2009-06,28,20,25.125,-92.875,0,7,7
2009-06,29,21,25.375,-92.625,0,8,8
2009-06,30,21,25.625,-92.625,0,2,2
2009-06,30,22,25.625,-92.375,0,13,13
2009-06,30,46,25.625,-86.375,0,20,20
2009-06,31,8,25.875,-95.875,10,0,10
2009-06,31,46,25.875,-86.375,0,3,3
2009-06,31,47,25.875,-86.125,0,7,7
2009-06,33,14,26.375,-94.375,1,0,1
2009-06,33,15,26.375,-94.125,12,0,12
2009-06,33,34,26.375,-89.375,3,0,3
2009-06,33,35,26.375,-89.125,3,0,3
2009-06,33,36,26.375,-88.875,1,0,1
2009-06,33,37,26.375,-88.625,8,0,8
2009-06,34,35,26.625,-89.125,10,0,10
2009-06,34,36,26.625,-88.875,3,0,3
2009-06,34,37,26.625,-88.625,2,0,2
2009-06,38,45,27.625,-86.625,2,0,2
2009-06,38,46,27.625,-86.375,4,0,4
2009-06,42,38,28.625,-88.375,0,2,2
2009-06,42,39,28.625,-88.125,0,1,1
2009-06,43,37,28.875,-88.625,0,1,1
2009-06,43,38,28.875,-88.375,0,2,2
2009-06,43,39,28.875,-88.125,0,2,2
2009-06,44,40,29.125,-87.875,0,3,3
2009-06,44,41,29.125,-87.625,0,17,17
2009-07,0,46,18.125,-86.375,4,0,4
2009-07,0,47,18.125,-86.125,4,0,4
2009-07,0,52,18.125,-84.875,0,1,1
2009-07,0,53,18.125,-84.625,0,1,1
2009-07,1,47,18.375,-86.125,1,0,1
2009-07,1,48,18.375,-85.875,4,0,4
2009-07,1,49,18.375,-85.625,5,0,5
2009-07,1,50,18.375,-85.375,2,0,2
2009-07,1,71,18.375,-80.125,0,3,3
2009-07,2,54,18.625,-84.375,0,2,2
2009-07,2,56,18.625,-83.875,0,1,1
2009-07,2,71,18.625,-80.125,0,3,3
2009-07,3,53,18.875,-84.625,0,1,1
2009-07,3,54,18.875,-84.375,0,2,2
2009-07,3,56,18.875,-83.875,0,2,2
2009-07,3,57,18.875,-83.625,0,4,4
2009-07,3,70,18.875,-80.375,0,5,5
2009-07,3,71,18.875,-80.125,0,1,1
2009-07,5,63,19.375,-82.125,3,0,3
2009-07,5,64,19.375,-81.875,2,0,2
2009-07,6,62,19.625,-82.375,3,0,3
2009-07,6,63,19.625,-82.125,1,0,1
2009-07,6,65,19.625,-81.625,3,0,3
2009-07,6,66,19.625,-81.375,4,0,4
2009-07,7,62,19.875,-82.375,1,0,1
2009-07,7,66,19.875,-81.375,2,0,2
2009-07,7,67,19.875,-81.125,1,0,1
2009-07,8,66,20.125,-81.375,1,0,1
2009-07,9,55,20.375,-84.125,0,1,1
2009-07,10,54,20.625,-84.375,0,1,1
2009-07,10,62,20.625,-82.375,2,0,2
2009-07,10,66,20.625,-81.375,6,0,6
2009-07,11,7,20.875,-96.125,0,4,4
2009-07,11,8,20.875,-95.875,0,7,7
2009-07,11,13,20.875,-94.625,1,0,1
2009-07,11,52,20.875,-84.875,0,1,1
2009-07,11,53,20.875,-84.625,0,3,3
2009-07,11,54,20.875,-84.375,0,1,1
2009-07,12,6,21.125,-96.375,0,2,2
2009-07,12,7,21.125,-96.125,0,4,4
2009-07,12,8,21.125,-95.875,0,9,9
2009-07,12,9,21.125,-95.625,0,2,2
2009-07,12,53,21.125,-84.625,0,1,1
2009-07,13,9,21.375,-95.625,0,2,2
2009-07,13,14,21.375,-94.375,1,0,1
2009-07,13,15,21.375,-94.125,2,0,2
2009-07,13,16,21.375,-93.875,1,0,1
2009-07,14,15,21.625,-94.125,6,0,6
2009-07,14,16,21.625,-93.875,2,0,2
2009-07,18,13,22.625,-94.625,0,3,3
2009-07,19,13,22.875,-94.625,0,4,4
2009-07,19,14,22.875,-94.375,0,2,2
2009-07,20,14,23.125,-94.375,0,5,5
2009-07,21,47,23.375,-86.125,1,0,1
2009-07,21,48,23.375,-85.875,6,0,6
2009-07,21,49,23.375,-85.625,5,0,5
2009-07,21,50,23.375,-85.375,2,0,2
2009-07,22,48,23.625,-85.875,1,0,1
2009-07,22,50,23.625,-85.375,5,0,5
2009-07,22,51,23.625,-85.125,4,0,4
2009-07,23,8,23.875,-95.875,4,0,4
2009-07,23,9,23.875,-95.625,4,0,4
2009-07,23,10,23.875,-95.375,1,0,1
2009-07,23,19,23.875,-93.125,1,0,1
2009-07,23,20,23.875,-92.875,3,0,3
2009-07,23,21,23.875,-92.625,3,0,3
2009-07,23,22,23.875,-92.375,2,0,2
2009-07,23,23,23.875,-92.125,5,0,5
2009-07,23,24,23.875,-91.875,5,0,5
2009-07,23,25,23.875,-91.625,6,0,6
2009-07,23,26,23.875,-91.375,4,0,4
2009-07,23,48,23.875,-85.875,1,0,1
2009-07,23,51,23.875,-85.125,2,0,2
2009-07,23,52,23.875,-84.875,4,0,4
2009-07,23,56,23.875,-83.875,0,2,2
2009-07,24,9,24.125,-95.625,3,0,3
2009-07,24,10,24.125,-95.375,3,0,3
2009-07,24,17,24.125,-93.625,0,2,2
2009-07,24,26,24.125,-91.375,2,0,2
2009-07,25,17,24.375,-93.625,0,3,3
2009-07,25,18,24.375,-93.375,0,1,1
2009-07,26,18,24.625,-93.375,0,4,4
2009-07,26,60,24.625,-82.875,1,0,1
2009-07,26,61,24.625,-82.625,3,0,3
2009-07,27,19,24.875,-93.125,0,5,5
2009-07,27,61,24.875,-82.625,1,0,1
2009-07,28,20,25.125,-92.875,0,2,2
2009-07,30,20,25.625,-92.875,0,5,5
2009-07,30,42,25.625,-87.375,0,4,4
2009-07,30,43,25.625,-87.125,0,9,9
2009-07,30,44,25.625,-86.875,0,4,4
2009-07,30,45,25.625,-86.625,0,6,6
2009-07,30,46,25.625,-86.375,0,8,8
2009-07,30,51,25.625,-85.125,1,0,1
2009-07,31,20,25.875,-92.875,0,5,5
2009-07,31,21,25.875,-92.625,0,2,2
2009-07,31,52,25.875,-84.875,1,0,1
2009-07,31,53,25.875,-84.625,1,0,1
2009-07,32,10,26.125,-95.375,0,1,1
2009-07,32,21,26.125,-92.625,0,2,2
2009-07,32,30,26.125,-90.375,5,0,5
2009-07,32,31,26.125,-90.125,1,0,1
2009-07,32,52,26.125,-84.875,2,0,2
2009-07,33,10,26.375,-95.375,0,10,10
2009-07,33,11,26.375,-95.125,0,9,9
2009-07,33,15,26.375,-94.125,10,0,10
2009-07,33,17,26.375,-93.625,3,0,3
2009-07,33,30,26.375,-90.375,1,0,1
2009-07,33,34,26.375,-89.375,11,0,11
2009-07,33,35,26.375,-89.125,1,0,1
2009-07,34,10,26.625,-95.375,0,3,3
2009-07,34,16,26.625,-93.875,15,0,15
2009-07,34,17,26.625,-93.625,3,0,3
2009-07,34,35,26.625,-89.125,7,0,7
2009-07,34,51,26.625,-85.125,1,0,1
2009-07,34,52,26.625,-84.875,2,0,2
2009-07,35,35,26.875,-89.125,5,0,5
2009-07,35,51,26.875,-85.125,3,0,3
2009-07,36,49,27.125,-85.625,1,0,1
2009-07,36,50,27.125,-85.375,4,0,4
2009-07,37,38,27.375,-88.375,2,0,2
2009-07,37,39,27.375,-88.125,2,0,2
2009-07,37,40,27.375,-87.875,2,0,2
2009-07,37,48,27.375,-85.875,1,0,1
2009-07,37,49,27.375,-85.625,3,0,3
2009-07,38,40,27.625,-87.875,1,0,1
2009-07,38,46,27.625,-86.375,4,0,4
2009-07,38,47,27.625,-86.125,4,0,4
2009-07,38,48,27.625,-85.875,1,0,1
2009-07,40,30,28.125,-90.375,0,3,3
2009-07,40,31,28.125,-90.125,0,4,4
2009-07,40,32,28.125,-89.875,0,3,3
2009-07,43,37,28.875,-88.625,0,2,2
2009-08,0,50,18.125,-85.375,0,3,3
2009-08,0,51,18.125,-85.125,0,8,8
2009-08,0,67,18.125,-81.125,3,0,3
2009-08,0,69,18.125,-80.625,1,0,1
2009-08,0,70,18.125,-80.375,2,0,2
2009-08,0,71,18.125,-80.125,4,0,4
2009-08,1,47,18.375,-86.125,0,1,1
2009-08,1,48,18.375,-85.875,0,4,4
2009-08,1,49,18.375,-85.625,0,4,4
2009-08,1,50,18.375,-85.375,0,1,1
2009-08,1,51,18.375,-85.125,0,1,1
2009-08,1,53,18.375,-84.625,0,1,1
2009-08,1,54,18.375,-84.375,0,1,1
2009-08,1,67,18.375,-81.125,1,0,1
2009-08,2,53,18.625,-84.625,0,3,3
2009-08,2,54,18.625,-84.375,0,2,2
2009-08,2,67,18.625,-81.125,1,0,1
2009-08,3,67,18.875,-81.125,2,0,2
2009-08,4,66,19.125,-81.375,5,0,5
2009-08,4,69,19.125,-80.625,0,1,1
2009-08,4,70,19.125,-80.375,0,7,7
2009-08,4,71,19.125,-80.125,0,5,5
2009-08,5,51,19.375,-85.125,1,0,1
2009-08,5,65,19.375,-81.625,3,0,3
2009-08,6,51,19.625,-85.125,6,0,6
2009-08,6,52,19.625,-84.875,2,0,2
2009-08,7,50,19.875,-85.375,2,0,2
2009-08,7,51,19.875,-85.125,6,0,6
2009-08,8,50,20.125,-85.375,10,0,10
2009-08,8,51,20.125,-85.125,1,0,1
2009-08,10,53,20.625,-84.625,0,2,2
2009-08,10,61,20.625,-82.625,1,0,1
2009-08,10,63,20.625,-82.125,0,1,1
2009-08,10,64,20.625,-81.875,0,1,1
2009-08,11,52,20.875,-84.875,0,2,2
2009-08,11,53,20.875,-84.625,0,7,7
2009-08,11,58,20.875,-83.375,7,0,7
2009-08,11,59,20.875,-83.125,10,0,10
2009-08,11,60,20.875,-82.875,11,0,11
2009-08,11,61,20.875,-82.625,1,0,1
2009-08,11,64,20.875,-81.875,0,1,1
2009-08,12,53,21.125,-84.625,0,11,11
2009-08,13,52,21.375,-84.875,0,4,4
2009-08,13,53,21.375,-84.625,0,4,4
2009-08,14,10,21.625,-95.375,0,6,6
2009-08,15,11,21.875,-95.125,0,8,8
2009-08,15,12,21.875,-94.875,0,2,2
2009-08,16,12,22.125,-94.875,0,4,4
2009-08,16,13,22.125,-94.625,0,1,1
2009-08,17,13,22.375,-94.625,0,6,6
2009-08,18,13,22.625,-94.625,0,4,4
2009-08,21,15,23.375,-94.125,2,0,2
2009-08,21,16,23.375,-93.875,1,0,1
2009-08,22,15,23.625,-94.125,4,0,4
2009-08,22,16,23.625,-93.875,3,0,3
2009-08,23,16,23.875,-93.875,4,0,4
2009-08,23,17,23.875,-93.625,4,0,4
2009-08,23,18,23.875,-93.375,5,0,5
2009-08,23,19,23.875,-93.125,2,0,2
2009-08,23,28,23.875,-90.875,0,1,1
2009-08,23,29,23.875,-90.625,0,14,14
2009-08,23,46,23.875,-86.375,4,0,4
2009-08,23,47,23.875,-86.125,10,0,10
2009-08,23,48,23.875,-85.875,4,0,4
2009-08,23,56,23.875,-83.875,0,27,27
2009-08,23,63,23.875,-82.125,4,0,4
2009-08,23,64,23.875,-81.875,11,0,11
2009-08,24,48,24.125,-85.875,11,0,11
2009-08,24,55,24.125,-84.125,0,1,1
2009-08,24,64,24.125,-81.875,8,0,8
2009-08,25,62,24.375,-82.375,1,0,1
2009-08,25,63,24.375,-82.125,1,0,1
2009-08,26,54,24.625,-84.375,0,1,1
2009-08,26,62,24.625,-82.375,1,0,1
2009-08,27,54,24.875,-84.375,0,2,2
2009-08,27,61,24.875,-82.625,4,0,4
2009-08,27,62,24.875,-82.375,1,0,1
2009-08,29,36,25.375,-88.875,0,2,2
2009-08,29,37,25.375,-88.625,0,10,10
2009-08,29,38,25.375,-88.375,0,6,6
2009-08,29,39,25.375,-88.125,0,2,2
2009-08,29,40,25.375,-87.875,0,2,2
2009-08,29,41,25.375,-87.625,0,2,2
2009-08,30,30,25.625,-90.375,8,0,8
2009-08,30,41,25.625,-87.625,0,3,3
2009-08,30,42,25.625,-87.375,0,4,4
2009-08,31,21,25.875,-92.625,0,1,1
2009-08,31,29,25.875,-90.625,4,0,4
2009-08,31,30,25.875,-90.375,3,0,3
2009-08,32,21,26.125,-92.625,0,22,22
2009-08,32,28,26.125,-90.875,11,0,11
2009-08,32,29,26.125,-90.625,5,0,5
2009-08,32,44,26.125,-86.875,3,0,3
2009-08,33,11,26.375,-95.125,0,24,24
2009-08,33,12,26.375,-94.875,0,2,2
2009-08,33,13,26.375,-94.625,0,5,5
2009-08,33,17,26.375,-93.625,3,0,3
2009-08,33,21,26.375,-92.625,0,3,3
2009-08,33,44,26.375,-86.875,5,0,5
2009-08,34,45,26.625,-86.625,2,0,2
2009-08,35,44,26.875,-86.875,2,0,2
2009-08,36,43,27.125,-87.125,1,0,1
2009-08,36,44,27.125,-86.875,1,0,1
2009-08,37,42,27.375,-87.375,2,0,2
2009-08,37,43,27.375,-87.125,1,0,1
2009-08,38,39,27.625,-88.125,1,0,1
2009-08,38,40,27.625,-87.875,7,0,7
2009-08,38,41,27.625,-87.625,3,0,3
2009-08,38,42,27.625,-87.375,1,0,1
2009-08,40,29,28.125,-90.625,0,3,3
2009-08,40,30,28.125,-90.375,0,1,1
2009-08,41,21,28.375,-92.625,0,1,1
2009-08,41,22,28.375,-92.375,0,3,3
2009-08,41,23,28.375,-92.125,0,3,3
2009-08,41,27,28.375,-91.125,0,2,2
2009-08,41,28,28.375,-90.875,0,2,2
2009-08,41,29,28.375,-90.625,0,1,1
2009-09,2,44,18.625,-86.875,0,4,4
2009-09,2,45,18.625,-86.625,0,4,4
2009-09,2,46,18.625,-86.375,0,7,7
2009-09,2,47,18.625,-86.125,0,1,1
2009-09,5,46,19.375,-86.375,0,1,1
2009-09,5,51,19.375,-85.125,1,0,1
2009-09,5,65,19.375,-81.625,2,0,2
2009-09,5,71,19.375,-80.125,6,0,6
2009-09,6,17,19.625,-93.625,1,0,1
2009-09,6,51,19.625,-85.125,3,0,3
2009-09,6,65,19.625,-81.625,7,0,7
2009-09,7,18,19.875,-93.375,8,0,8
2009-09,7,19,19.875,-93.125,1,0,1
2009-09,7,50,19.875,-85.375,1,0,1
2009-09,7,51,19.875,-85.125,1,0,1
2009-09,8,18,20.125,-93.375,9,0,9
2009-09,9,61,20.375,-82.625,0,3,3
2009-09,9,64,20.375,-81.875,0,3,3
2009-09,9,68,20.375,-80.875,0,1,1
2009-09,10,51,20.625,-85.125,0,1,1
2009-09,10,55,20.625,-84.125,4,0,4
2009-09,10,56,20.625,-83.875,4,0,4
2009-09,10,57,20.625,-83.625,13,0,13
2009-09,10,64,20.625,-81.875,0,2,2
2009-09,10,65,20.625,-81.625,0,3,3
2009-09,10,66,20.625,-81.375,0,5,5
2009-09,10,67,20.625,-81.125,0,1,1
2009-09,11,48,20.875,-85.875,0,4,4
2009-09,11,49,20.875,-85.625,0,1,1
2009-09,11,50,20.875,-85.375,0,2,2
2009-09,11,51,20.875,-85.125,0,1,1
2009-09,11,52,20.875,-84.875,0,1,1
2009-09,11,57,20.875,-83.625,7,0,7
2009-09,11,58,20.875,-83.375,2,0,2
2009-09,11,64,20.875,-81.875,0,1,1
2009-09,11,65,20.875,-81.625,0,6,6
2009-09,12,48,21.125,-85.875,0,3,3
2009-09,14,7,21.625,-96.125,0,7,7
2009-09,14,8,21.625,-95.875,0,10,10
2009-09,14,9,21.625,-95.625,0,7,7
2009-09,14,10,21.625,-95.375,0,6,6
2009-09,18,41,22.625,-87.625,0,1,1
2009-09,18,42,22.625,-87.375,0,1,1
2009-09,19,29,22.875,-90.625,1,0,1
2009-09,19,30,22.875,-90.375,1,0,1
2009-09,19,41,22.875,-87.625,0,4,4
2009-09,19,42,22.875,-87.375,0,5,5
2009-09,20,30,23.125,-90.375,15,0,15
2009-09,20,41,23.125,-87.625,0,4,4
2009-09,21,12,23.375,-94.875,2,0,2
2009-09,21,13,23.375,-94.625,5,0,5
2009-09,21,14,23.375,-94.375,6,0,6
2009-09,21,15,23.375,-94.125,7,0,7
2009-09,21,30,23.375,-90.375,6,0,6
2009-09,21,41,23.375,-87.625,0,5,5
2009-09,22,30,23.625,-90.375,2,0,2
2009-09,23,27,23.875,-91.125,0,2,2
2009-09,23,28,23.875,-90.875,0,10,10
2009-09,23,39,23.875,-88.125,0,1,1
2009-09,23,65,23.875,-81.625,4,0,4
2009-09,23,66,23.875,-81.375,2,0,2
2009-09,23,67,23.875,-81.125,1,0,1
2009-09,23,68,23.875,-80.875,2,0,2
2009-09,24,27,24.125,-91.125,0,2,2
2009-09,24,28,24.125,-90.875,0,1,1
2009-09,24,70,24.125,-80.375,4,0,4
2009-09,24,71,24.125,-80.125,5,0,5
2009-09,25,71,24.375,-80.125,1,0,1
2009-09,26,46,24.625,-86.375,10,0,10
2009-09,26,54,24.625,-84.375,0,3,3
2009-09,26,55,24.625,-84.125,0,7,7
2009-09,27,45,24.875,-86.625,1,0,1
2009-09,27,46,24.875,-86.375,4,0,4
2009-09,27,54,24.875,-84.375,0,20,20
2009-09,28,45,25.125,-86.625,14,0,14
2009-09,29,36,25.375,-88.875,0,9,9
2009-09,30,34,25.625,-89.375,0,11,11
2009-09,30,35,25.625,-89.125,0,10,10
2009-09,31,12,25.875,-94.875,0,1,1
2009-09,32,12,26.125,-94.875,0,11,11
2009-09,32,26,26.125,-91.375,6,0,6
2009-09,32,27,26.125,-91.125,7,0,7
2009-09,32,28,26.125,-90.875,2,0,2
2009-09,33,12,26.375,-94.875,0,17,17
2009-09,33,13,26.375,-94.625,0,1,1
2009-09,33,25,26.375,-91.625,4,0,4
2009-09,33,26,26.375,-91.375,6,0,6
2009-09,34,26,26.625,-91.375,5,0,5
2009-09,36,16,27.125,-93.875,7,0,7
2009-09,37,16,27.375,-93.875,7,0,7
2009-09,37,17,27.375,-93.625,1,0,1
2009-09,38,17,27.625,-93.625,4,0,4
2009-09,39,16,27.875,-93.875,2,0,2
2009-09,39,41,27.875,-87.625,1,0,1
2009-09,40,16,28.125,-93.875,5,0,5
2009-09,41,16,28.375,-93.875,1,0,1
2009-10,0,60,18.125,-82.875,0,6,6
2009-10,0,61,18.125,-82.625,0,3,3
2009-10,0,63,18.125,-82.125,0,1,1
2009-10,0,64,18.125,-81.875,0,2,2
2009-10,1,48,18.375,-85.875,4,0,4
2009-10,1,49,18.375,-85.625,3,0,3
2009-10,2,49,18.625,-85.625,2,0,2
2009-10,2,50,18.625,-85.375,2,0,2
2009-10,3,68,18.875,-80.875,3,0,3
2009-10,3,69,18.875,-80.625,3,0,3
2009-10,3,70,18.875,-80.375,3,0,3
2009-10,3,71,18.875,-80.125,2,0,2
2009-10,4,62,19.125,-82.375,1,0,1
2009-10,4,63,19.125,-82.125,2,0,2
2009-10,4,64,19.125,-81.875,3,0,3
2009-10,4,65,19.125,-81.625,2,0,2
2009-10,4,66,19.125,-81.375,3,0,3
2009-10,4,67,19.125,-81.125,2,0,2
2009-10,6,60,19.625,-82.875,2,0,2
2009-10,8,18,20.125,-93.375,1,0,1
2009-10,9,18,20.375,-93.375,7,0,7
2009-10,9,63,20.375,-82.125,0,2,2
2009-10,10,18,20.625,-93.375,8,0,8
2009-10,10,54,20.625,-84.375,3,0,3
2009-10,10,55,20.625,-84.125,11,0,11
2009-10,10,63,20.625,-82.125,0,11,11
2009-10,10,64,20.625,-81.875,0,17,17
2009-10,10,69,20.625,-80.625,1,0,1
2009-10,11,18,20.875,-93.375,1,0,1
2009-10,11,55,20.875,-84.125,4,0,4
2009-10,11,69,20.875,-80.625,1,0,1
2009-10,12,56,21.125,-83.875,4,0,4
2009-10,12,57,21.125,-83.625,3,0,3
2009-10,13,58,21.375,-83.375,1,0,1
2009-10,14,6,21.625,-96.375,0,9,9
2009-10,14,7,21.625,-96.125,0,9,9
2009-10,15,6,21.875,-96.375,0,8,8
2009-10,15,7,21.875,-96.125,0,5,5
2009-10,19,10,22.875,-95.375,2,0,2
2009-10,19,11,22.875,-95.125,8,0,8
2009-10,19,42,22.875,-87.375,0,4,4
2009-10,20,9,23.125,-95.625,3,0,3
2009-10,20,10,23.125,-95.375,1,0,1
2009-10,20,30,23.125,-90.375,4,0,4
2009-10,20,41,23.125,-87.625,0,2,2
2009-10,20,42,23.125,-87.375,0,1,1
2009-10,21,9,23.375,-95.625,2,0,2
2009-10,21,10,23.375,-95.375,5,0,5
2009-10,21,11,23.375,-95.125,6,0,6
2009-10,21,12,23.375,-94.875,4,0,4
2009-10,21,30,23.375,-90.375,3,0,3
2009-10,22,30,23.625,-90.375,4,0,4
2009-10,22,31,23.625,-90.125,2,0,2
2009-10,23,30,23.875,-90.375,4,0,4
2009-10,23,55,23.875,-84.125,0,1,1
2009-10,24,55,24.125,-84.125,0,4,4
2009-10,24,56,24.125,-83.875,0,8,8
2009-10,25,55,24.375,-84.125,0,8,8
2009-10,25,56,24.375,-83.875,0,3,3
2009-10,26,55,24.625,-84.125,0,6,6
2009-10,26,56,24.625,-83.875,0,1,1
2009-10,27,32,24.875,-89.875,0,8,8
2009-10,27,33,24.875,-89.625,0,3,3
2009-10,27,45,24.875,-86.625,11,0,11
2009-10,28,33,25.125,-89.625,0,5,5
2009-10,28,34,25.125,-89.375,0,6,6
2009-10,28,45,25.125,-86.625,20,0,20
2009-10,29,34,25.375,-89.375,0,8,8
2009-10,30,8,25.625,-95.875,0,11,11
2009-10,30,9,25.625,-95.625,0,5,5
2009-10,30,16,25.625,-93.875,4,0,4
2009-10,30,17,25.625,-93.625,4,0,4
2009-10,30,34,25.625,-89.375,0,1,1
2009-10,31,8,25.875,-95.875,0,13,13
2009-10,31,18,25.875,-93.375,1,0,1
2009-10,32,9,26.125,-95.625,0,2,2
2009-10,34,25,26.625,-91.625,9,0,9
2009-10,34,26,26.625,-91.375,17,0,17
2009-10,35,13,26.875,-94.625,2,0,2
2009-10,35,26,26.875,-91.375,1,0,1
2009-10,35,27,26.875,-91.125,4,0,4
2009-10,36,13,27.125,-94.625,4,0,4
2009-10,36,14,27.125,-94.375,1,0,1
2009-10,36,15,27.125,-94.125,1,0,1
2009-10,36,16,27.125,-93.875,3,0,3
2009-10,36,53,27.125,-84.625,0,1,1
2009-10,36,54,27.125,-84.375,0,2,2
2009-10,37,12,27.375,-94.875,1,0,1
2009-10,37,13,27.375,-94.625,2,0,2
2009-10,37,14,27.375,-94.375,3,0,3
2009-10,40,41,28.125,-87.625,1,0,1
2009-10,40,42,28.125,-87.375,3,0,3
2009-10,40,43,28.125,-87.125,6,0,6
2009-10,40,44,28.125,-86.875,13,0,13
2009-10,40,45,28.125,-86.625,4,0,4
2009-10,40,46,28.125,-86.375,4,0,4
2009-11,0,43,18.125,-87.125,2,0,2
2009-11,0,44,18.125,-86.875,7,0,7
2009-11,0,45,18.125,-86.625,1,0,1
2009-11,1,45,18.375,-86.625,1,0,1
2009-11,1,46,18.375,-86.375,9,0,9
2009-11,1,47,18.375,-86.125,8,0,8
2009-11,1,70,18.375,-80.375,4,0,4
2009-11,1,71,18.375,-80.125,5,0,5
2009-11,6,59,19.625,-83.125,1,0,1
2009-11,6,60,19.625,-82.875,1,0,1
2009-11,7,56,19.875,-83.875,1,0,1
2009-11,7,57,19.875,-83.625,2,0,2
2009-11,7,58,19.875,-83.375,3,0,3
2009-11,7,59,19.875,-83.125,1,0,1
2009-11,8,55,20.125,-84.125,1,0,1
2009-11,8,56,20.125,-83.875,3,0,3
2009-11,8,65,20.125,-81.625,1,0,1
2009-11,9,51,20.375,-85.125,4,0,4
2009-11,9,52,20.375,-84.875,4,0,4
2009-11,9,53,20.375,-84.625,3,0,3
2009-11,9,54,20.375,-84.375,1,0,1
2009-11,9,55,20.375,-84.125,3,0,3
2009-11,9,60,20.375,-82.875,0,2,2
2009-11,9,62,20.375,-82.375,0,1,1
2009-11,9,65,20.375,-81.625,2,0,2
2009-11,9,66,20.375,-81.375,8,0,8
2009-11,9,67,20.375,-81.125,1,0,1
2009-11,10,60,20.625,-82.875,0,3,3
2009-11,10,61,20.625,-82.625,0,7,7
2009-11,10,62,20.625,-82.375,0,9,9
2009-11,10,63,20.625,-82.125,0,5,5
2009-11,10,64,20.625,-81.875,0,2,2
2009-11,10,67,20.625,-81.125,3,0,3
2009-11,10,68,20.625,-80.875,6,0,6
2009-11,10,69,20.625,-80.625,7,0,7
2009-11,11,68,20.875,-80.875,1,0,1
2009-11,14,5,21.625,-96.625,0,2,2
2009-11,14,6,21.625,-96.375,0,3,3
2009-11,15,45,21.875,-86.625,0,7,7
2009-11,15,46,21.875,-86.375,0,1,1
2009-11,16,10,22.125,-95.375,3,0,3
2009-11,16,11,22.125,-95.125,7,0,7
2009-11,16,44,22.125,-86.875,0,3,3
2009-11,17,10,22.375,-95.375,6,0,6
2009-11,17,11,22.375,-95.125,1,0,1
2009-11,17,43,22.375,-87.125,0,4,4
2009-11,17,44,22.375,-86.875,0,3,3
2009-11,18,10,22.625,-95.375,3,0,3
2009-11,18,11,22.625,-95.125,7,0,7
2009-11,18,42,22.625,-87.375,0,3,3
2009-11,19,11,22.875,-95.125,3,0,3
2009-11,23,55,23.875,-84.125,0,9,9
2009-11,23,56,23.875,-83.875,0,3,3
2009-11,24,55,24.125,-84.125,0,4,4
2009-11,24,56,24.125,-83.875,0,12,12
2009-11,25,56,24.375,-83.875,0,2,2
2009-11,27,17,24.875,-93.625,5,0,5
2009-11,27,30,24.875,-90.375,0,3,3
2009-11,27,31,24.875,-90.125,0,21,21
2009-11,27,32,24.875,-89.875,0,6,6
2009-11,27,45,24.875,-86.625,2,0,2
2009-11,28,45,25.125,-86.625,25,0,25
2009-11,29,10,25.375,-95.375,0,1,1
2009-11,29,11,25.375,-95.125,0,5,5
2009-11,29,17,25.375,-93.625,2,0,2
2009-11,29,45,25.375,-86.625,3,0,3
2009-11,30,9,25.625,-95.625,0,1,1
2009-11,30,10,25.625,-95.375,0,7,7
2009-11,30,11,25.625,-95.125,0,6,6
2009-11,30,16,25.625,-93.875,4,0,4
2009-11,30,17,25.625,-93.625,9,0,9
2009-11,30,18,25.625,-93.375,1,0,1
2009-11,31,9,25.875,-95.625,0,2,2
2009-11,31,10,25.875,-95.375,0,7,7
2009-11,31,11,25.875,-95.125,0,1,1
2009-11,31,16,25.875,-93.875,7,0,7
2009-11,31,17,25.875,-93.625,1,0,1
2009-11,34,50,26.625,-85.375,0,2,2
2009-11,35,31,26.875,-90.125,2,0,2
2009-11,35,32,26.875,-89.875,2,0,2
2009-11,35,34,26.875,-89.375,4,0,4
2009-11,35,53,26.875,-84.625,0,1,1
2009-11,36,28,27.125,-90.875,4,0,4
2009-11,36,29,27.125,-90.625,8,0,8
2009-11,36,30,27.125,-90.375,2,0,2
2009-11,36,31,27.125,-90.125,3,0,3
2009-11,36,34,27.125,-89.375,1,0,1
2009-11,36,50,27.125,-85.375,0,4,4
2009-11,37,50,27.375,-85.375,0,1,1
2009-11,37,51,27.375,-85.125,0,1,1
2009-11,38,47,27.625,-86.125,0,2,2
2009-11,38,51,27.625,-85.125,0,3,3
2009-11,38,52,27.625,-84.875,0,6,6
2009-11,40,44,28.125,-86.875,2,0,2
2009-11,40,46,28.125,-86.375,1,0,1
2009-11,41,44,28.375,-86.875,1,0,1
2009-11,41,45,28.375,-86.625,1,0,1
2009-12,0,43,18.125,-87.125,3,0,3
2009-12,1,43,18.375,-87.125,1,0,1
2009-12,1,68,18.375,-80.875,2,0,2
2009-12,1,69,18.375,-80.625,2,0,2
2009-12,1,70,18.375,-80.375,1,0,1
2009-12,2,67,18.625,-81.125,2,0,2
2009-12,3,65,18.875,-81.625,3,0,3
2009-12,3,66,18.875,-81.375,3,0,3
2009-12,4,63,19.125,-82.125,3,0,3
2009-12,4,64,19.125,-81.875,2,0,2
2009-12,5,60,19.375,-82.875,2,0,2
2009-12,5,61,19.375,-82.625,5,0,5
2009-12,5,62,19.375,-82.375,6,0,6
2009-12,7,70,19.875,-80.375,0,5,5
2009-12,7,71,19.875,-80.125,0,9,9
2009-12,8,65,20.125,-81.625,5,0,5
2009-12,8,68,20.125,-80.875,0,2,2
2009-12,8,69,20.125,-80.625,0,1,1
2009-12,8,70,20.125,-80.375,0,1,1
2009-12,9,51,20.375,-85.125,4,0,4
2009-12,9,52,20.375,-84.875,11,0,11
2009-12,9,58,20.375,-83.375,0,3,3
2009-12,9,59,20.375,-83.125,0,2,2
2009-12,9,60,20.375,-82.875,0,1,1
2009-12,10,51,20.625,-85.125,6,0,6
2009-12,10,52,20.625,-84.875,2,0,2
2009-12,10,59,20.625,-83.125,0,2,2
2009-12,10,60,20.625,-82.875,0,4,4
2009-12,11,51,20.875,-85.125,6,0,6
2009-12,11,52,20.875,-84.875,2,0,2
2009-12,14,10,21.625,-95.375,7,0,7
2009-12,14,11,21.625,-95.125,2,0,2
2009-12,15,9,21.875,-95.625,3,0,3
2009-12,15,10,21.875,-95.375,1,0,1
2009-12,16,8,22.125,-95.875,9,0,9
2009-12,16,9,22.125,-95.625,7,0,7
2009-12,16,10,22.125,-95.375,2,0,2
2009-12,16,20,22.125,-92.875,0,1,1
2009-12,17,20,22.375,-92.875,0,2,2
2009-12,18,16,22.625,-93.875,0,4,4
2009-12,18,17,22.625,-93.625,0,1,1
2009-12,18,19,22.625,-93.125,0,3,3
2009-12,18,42,22.625,-87.375,0,1,1
2009-12,19,17,22.875,-93.625,0,3,3
2009-12,19,18,22.875,-93.375,0,5,5
2009-12,19,19,22.875,-93.125,0,6,6
2009-12,19,41,22.875,-87.625,0,6,6
2009-12,19,42,22.875,-87.375,0,1,1
2009-12,20,41,23.125,-87.625,0,9,9
2009-12,21,41,23.375,-87.625,0,1,1
2009-12,23,55,23.875,-84.125,0,2,2
2009-12,23,56,23.875,-83.875,0,17,17
2009-12,24,50,24.125,-85.375,0,3,3
2009-12,24,51,24.125,-85.125,0,2,2
2009-12,24,52,24.125,-84.875,0,1,1
2009-12,24,53,24.125,-84.625,0,1,1
2009-12,24,54,24.125,-84.375,0,2,2
2009-12,24,55,24.125,-84.125,0,1,1
2009-12,25,27,24.375,-91.125,0,7,7
2009-12,25,28,24.375,-90.875,0,3,3
2009-12,25,51,24.375,-85.125,0,2,2
2009-12,26,8,24.625,-95.875,0,3,3
2009-12,26,9,24.625,-95.625,0,7,7
2009-12,26,28,24.625,-90.875,0,5,5
2009-12,26,29,24.625,-90.625,0,10,10
2009-12,27,8,24.875,-95.875,0,7,7
2009-12,27,9,24.875,-95.625,0,6,6
2009-12,27,17,24.875,-93.625,7,0,7
2009-12,27,30,24.875,-90.375,0,6,6
2009-12,28,9,25.125,-95.625,0,2,2
2009-12,28,10,25.125,-95.375,0,3,3
2009-12,29,10,25.375,-95.375,0,2,2
2009-12,29,15,25.375,-94.125,12,0,12
2009-12,29,44,25.375,-86.875,4,0,4
2009-12,29,45,25.375,-86.625,4,0,4
2009-12,30,14,25.625,-94.375,1,0,1
2009-12,30,15,25.625,-94.125,6,0,6
2009-12,30,42,25.625,-87.375,5,0,5
2009-12,30,43,25.625,-87.125,6,0,6
2009-12,30,44,25.625,-86.875,1,0,1
2009-12,31,42,25.875,-87.375,11,0,11
2009-12,32,21,26.125,-92.625,0,1,1
2009-12,32,22,26.125,-92.375,0,1,1
2009-12,33,20,26.375,-92.875,0,1,1
2009-12,33,21,26.375,-92.625,0,8,8
2009-12,33,31,26.375,-90.125,3,0,3
2009-12,34,20,26.625,-92.875,0,10,10
2009-12,36,56,27.125,-83.875,0,1,1
2009-12,37,45,27.375,-86.625,0,1,1
2009-12,37,46,27.375,-86.375,0,1,1
2009-12,38,43,27.625,-87.125,0,1,1
2009-12,38,44,27.625,-86.875,0,6,6
2009-12,38,45,27.625,-86.625,0,5,5
2009-12,38,46,27.625,-86.375,0,2,2
2009-12,39,41,27.875,-87.625,0,2,2
2009-12,40,39,28.125,-88.125,0,6,6
2009-12,40,41,28.125,-87.625,0,2,2
2009-12,41,39,28.375,-88.125,0,4,4
2010-01,4,56,19.125,-83.875,1,0,1
2010-01,4,57,19.125,-83.625,1,0,1
2010-01,5,58,19.375,-83.375,2,0,2
2010-01,5,59,19.375,-83.125,4,0,4
2010-01,5,60,19.375,-82.875,2,0,2
2010-01,6,49,19.625,-85.625,1,0,1
2010-01,6,50,19.625,-85.375,3,0,3
2010-01,7,49,19.875,-85.625,3,0,3
2010-01,8,8,20.125,-95.875,10,0,10
2010-01,8,9,20.125,-95.625,6,0,6
2010-01,8,50,20.125,-85.375,3,0,3
2010-01,8,66,20.125,-81.375,0,2,2
2010-01,8,67,20.125,-81.125,0,6,6
2010-01,8,68,20.125,-80.875,0,1,1
2010-01,9,8,20.375,-95.875,8,0,8
2010-01,9,50,20.375,-85.375,5,0,5
2010-01,9,51,20.375,-85.125,6,0,6
2010-01,9,52,20.375,-84.875,3,0,3
2010-01,9,53,20.375,-84.625,1,0,1
2010-01,9,65,20.375,-81.625,0,5,5
2010-01,9,67,20.375,-81.125,0,2,2
2010-01,9,68,20.375,-80.875,0,1,1
2010-01,10,51,20.625,-85.125,4,0,4
2010-01,10,59,20.625,-83.125,0,4,4
2010-01,10,60,20.625,-82.875,0,3,3
2010-01,10,61,20.625,-82.625,0,1,1
2010-01,11,51,20.875,-85.125,2,0,2
2010-01,11,57,20.875,-83.625,0,3,3
2010-01,15,11,21.875,-95.125,0,1,1
2010-01,15,12,21.875,-94.875,0,3,3
2010-01,15,13,21.875,-94.625,0,6,6
2010-01,15,22,21.875,-92.375,1,0,1
2010-01,16,7,22.125,-96.125,7,0,7
2010-01,16,10,22.125,-95.375,0,5,5
2010-01,16,11,22.125,-95.125,0,4,4
2010-01,16,13,22.125,-94.625,0,1,1
2010-01,16,14,22.125,-94.375,0,2,2
2010-01,17,14,22.375,-94.375,0,4,4
2010-01,17,15,22.375,-94.125,0,3,3
2010-01,18,15,22.625,-94.125,0,1,1
2010-01,18,16,22.625,-93.875,0,1,1
2010-01,20,7,23.125,-96.125,3,0,3
2010-01,21,6,23.375,-96.375,5,0,5
2010-01,22,6,23.625,-96.375,4,0,4
2010-01,23,6,23.875,-96.375,4,0,4
2010-01,23,48,23.875,-85.875,0,1,1
2010-01,23,49,23.875,-85.625,0,8,8
2010-01,23,50,23.875,-85.375,0,3,3
2010-01,24,6,24.125,-96.375,3,0,3
2010-01,24,7,24.125,-96.125,2,0,2
2010-01,24,21,24.125,-92.625,0,5,5
2010-01,24,22,24.125,-92.375,0,5,5
2010-01,24,23,24.125,-92.125,0,5,5
2010-01,24,24,24.125,-91.875,0,4,4
2010-01,24,47,24.125,-86.125,0,3,3
2010-01,24,48,24.125,-85.875,0,1,1
2010-01,24,49,24.125,-85.625,0,3,3
2010-01,24,50,24.125,-85.375,0,7,7
2010-01,25,24,24.375,-91.875,0,1,1
2010-01,25,25,24.375,-91.625,0,6,6
2010-01,25,26,24.375,-91.375,0,5,5
2010-01,25,47,24.375,-86.125,0,2,2
2010-01,25,55,24.375,-84.125,1,0,1
2010-01,26,33,24.625,-89.625,0,6,6
2010-01,26,47,24.625,-86.125,0,2,2
2010-01,26,54,24.625,-84.375,1,0,1
2010-01,26,55,24.625,-84.125,1,0,1
2010-01,27,9,24.875,-95.625,0,3,3
2010-01,27,33,24.875,-89.625,0,4,4
2010-01,27,34,24.875,-89.375,0,2,2
2010-01,27,47,24.875,-86.125,0,1,1
2010-01,28,9,25.125,-95.625,0,8,8
2010-01,29,8,25.375,-95.875,0,1,1
2010-01,29,9,25.375,-95.625,0,1,1
2010-01,29,15,25.375,-94.125,3,0,3
2010-01,30,14,25.625,-94.375,2,0,2
2010-01,30,15,25.625,-94.125,9,0,9
2010-01,31,14,25.875,-94.375,1,0,1
2010-01,31,15,25.875,-94.125,10,0,10
2010-01,31,16,25.875,-93.875,6,0,6
2010-01,31,38,25.875,-88.375,2,0,2
2010-01,31,40,25.875,-87.875,8,0,8
2010-01,31,41,25.875,-87.625,4,0,4
2010-01,31,42,25.875,-87.375,8,0,8
2010-01,31,43,25.875,-87.125,1,0,1
2010-01,32,37,26.125,-88.625,2,0,2
2010-01,32,38,26.125,-88.375,1,0,1
2010-01,32,42,26.125,-87.375,2,0,2
2010-01,32,43,26.125,-87.125,3,0,3
2010-01,32,56,26.125,-83.875,0,3,3
2010-01,33,30,26.375,-90.375,3,0,3
2010-01,33,31,26.375,-90.125,22,0,22
2010-01,33,56,26.375,-83.875,0,5,5
2010-01,34,18,26.625,-93.375,0,2,2
2010-01,34,19,26.625,-93.125,0,8,8
2010-01,34,20,26.625,-92.875,0,2,2
2010-01,34,31,26.625,-90.125,1,0,1
2010-01,34,56,26.625,-83.875,0,10,10
2010-01,35,15,26.875,-94.125,0,2,2
2010-01,35,16,26.875,-93.875,0,8,8
2010-01,35,17,26.875,-93.625,0,6,6
2010-01,35,18,26.875,-93.375,0,3,3
2010-01,35,56,26.875,-83.875,0,5,5
2010-01,36,56,27.125,-83.875,0,6,6
2010-01,37,56,27.375,-83.875,0,1,1
2010-01,39,37,27.875,-88.625,0,1,1
2010-01,39,40,27.875,-87.875,0,5,5
2010-01,40,37,28.125,-88.625,0,1,1
2010-01,40,38,28.125,-88.375,0,1,1
2010-01,40,39,28.125,-88.125,0,4,4
2010-01,40,40,28.125,-87.875,0,3,3
2010-01,41,39,28.375,-88.125,0,10,10
2010-01,41,40,28.375,-87.875,0,1,1
2010-01,42,39,28.625,-88.125,0,3,3
2010-02,0,47,18.125,-86.125,0,1,1
2010-02,0,48,18.125,-85.875,0,4,4
2010-02,0,49,18.125,-85.625,0,4,4
2010-02,0,57,18.125,-83.625,1,0,1
2010-02,1,46,18.375,-86.375,0,3,3
2010-02,1,47,18.375,-86.125,0,2,2
2010-02,1,55,18.375,-84.125,1,0,1
2010-02,1,56,18.375,-83.875,1,0,1
2010-02,1,57,18.375,-83.625,1,0,1
2010-02,1,69,18.375,-80.625,2,0,2
2010-02,1,70,18.375,-80.375,1,0,1
2010-02,2,56,18.625,-83.875,2,0,2
2010-02,2,57,18.625,-83.625,1,0,1
2010-02,2,69,18.625,-80.625,2,0,2
2010-02,3,62,18.875,-82.375,2,0,2
2010-02,3,63,18.875,-82.125,2,0,2
2010-02,3,64,18.875,-81.875,3,0,3
2010-02,3,65,18.875,-81.625,3,0,3
2010-02,3,66,18.875,-81.375,4,0,4
2010-02,3,67,18.875,-81.125,1,0,1
2010-02,4,52,19.125,-84.875,5,0,5
2010-02,4,63,19.125,-82.125,1,0,1
2010-02,5,52,19.375,-84.875,1,0,1
2010-02,5,53,19.375,-84.625,5,0,5
2010-02,5,54,19.375,-84.375,4,0,4
2010-02,5,55,19.375,-84.125,4,0,4
2010-02,6,12,19.625,-94.875,2,0,2
2010-02,7,10,19.875,-95.375,2,0,2
2010-02,7,11,19.875,-95.125,5,0,5
2010-02,7,12,19.875,-94.875,3,0,3
2010-02,7,13,19.875,-94.625,2,0,2
2010-02,7,14,19.875,-94.375,1,0,1
2010-02,7,48,19.875,-85.875,3,0,3
2010-02,7,49,19.875,-85.625,2,0,2
2010-02,7,55,19.875,-84.125,0,2,2
2010-02,7,56,19.875,-83.875,0,6,6
2010-02,7,57,19.875,-83.625,0,2,2
2010-02,7,58,19.875,-83.375,0,1,1
2010-02,7,71,19.875,-80.125,0,1,1
2010-02,8,9,20.125,-95.625,9,0,9
2010-02,8,10,20.125,-95.375,4,0,4
2010-02,8,48,20.125,-85.875,1,0,1
2010-02,8,71,20.125,-80.125,0,16,16
2010-02,9,56,20.375,-83.875,0,3,3
2010-02,10,55,20.625,-84.125,0,4,4
2010-02,10,56,20.625,-83.875,0,3,3
2010-02,10,58,20.625,-83.375,0,3,3
2010-02,11,54,20.875,-84.375,0,1,1
2010-02,11,55,20.875,-84.125,0,1,1
2010-02,14,20,21.625,-92.875,4,0,4
2010-02,14,21,21.625,-92.625,4,0,4
2010-02,14,22,21.625,-92.375,1,0,1
2010-02,15,9,21.875,-95.625,0,5,5
2010-02,15,18,21.875,-93.375,1,0,1
2010-02,15,19,21.875,-93.125,2,0,2
2010-02,15,22,21.875,-92.375,2,0,2
2010-02,16,7,22.125,-96.125,0,10,10
2010-02,16,8,22.125,-95.875,0,4,4
2010-02,16,9,22.125,-95.625,0,3,3
2010-02,16,10,22.125,-95.375,0,2,2
2010-02,16,15,22.125,-94.125,4,0,4
2010-02,16,16,22.125,-93.875,5,0,5
2010-02,16,17,22.125,-93.625,4,0,4
2010-02,16,18,22.125,-93.375,1,0,1
2010-02,17,6,22.375,-96.375,0,4,4
2010-02,21,29,23.375,-90.625,3,0,3
2010-02,21,30,23.375,-90.375,1,0,1
2010-02,21,31,23.375,-90.125,2,0,2
2010-02,22,54,23.625,-84.375,10,0,10
2010-02,22,55,23.625,-84.125,4,0,4
2010-02,23,14,23.875,-94.375,0,1,1
2010-02,23,15,23.875,-94.125,0,3,3
2010-02,23,53,23.875,-84.625,2,0,2
2010-02,23,54,23.875,-84.375,8,0,8
2010-02,23,61,23.875,-82.625,0,1,1
2010-02,23,62,23.875,-82.375,0,5,5
2010-02,23,63,23.875,-82.125,0,4,4
2010-02,23,64,23.875,-81.875,0,8,8
2010-02,24,16,24.125,-93.875,0,2,2
2010-02,24,17,24.125,-93.625,0,5,5
2010-02,24,18,24.125,-93.375,0,6,6
2010-02,24,19,24.125,-93.125,0,6,6
2010-02,24,20,24.125,-92.875,0,5,5
2010-02,24,29,24.125,-90.625,0,7,7
2010-02,24,30,24.125,-90.375,0,5,5
2010-02,24,54,24.125,-84.375,2,0,2
2010-02,25,7,24.375,-96.125,7,0,7
2010-02,25,30,24.375,-90.375,0,3,3
2010-02,25,31,24.375,-90.125,0,3,3
2010-02,25,32,24.375,-89.875,0,2,2
2010-02,25,54,24.375,-84.375,2,0,2
2010-02,26,7,24.625,-96.125,2,0,2
2010-02,27,7,24.875,-96.125,2,0,2
2010-02,27,8,24.875,-95.875,2,0,2
2010-02,27,47,24.875,-86.125,0,1,1
2010-02,28,8,25.125,-95.875,7,0,7
2010-02,28,47,25.125,-86.125,0,4,4
2010-02,28,48,25.125,-85.875,0,1,1
2010-02,29,8,25.375,-95.875,1,0,1
2010-02,29,47,25.375,-86.125,0,2,2
2010-02,29,48,25.375,-85.875,0,10,10
2010-02,30,48,25.625,-85.875,0,10,10
2010-02,31,16,25.875,-93.875,16,0,16
2010-02,32,16,26.125,-93.875,8,0,8
2010-02,32,17,26.125,-93.625,1,0,1
2010-02,32,37,26.125,-88.625,12,0,12
2010-02,32,38,26.125,-88.375,15,0,15
2010-02,32,39,26.125,-88.125,1,0,1
2010-02,33,16,26.375,-93.875,1,0,1
2010-02,35,10,26.875,-95.375,0,6,6
2010-02,35,11,26.875,-95.125,0,3,3
2010-02,35,15,26.875,-94.125,0,1,1
2010-02,36,9,27.125,-95.625,0,2,2
2010-02,36,10,27.125,-95.375,0,10,10
2010-02,36,56,27.125,-83.875,0,2,2
2010-02,40,35,28.125,-89.125,0,2,2
2010-02,40,36,28.125,-88.875,0,1,1
2010-02,40,38,28.125,-88.375,0,4,4
2010-02,40,39,28.125,-88.125,0,7,7
2010-02,41,36,28.375,-88.875,0,2,2
2010-02,41,37,28.375,-88.625,0,3,3
2010-03,0,44,18.125,-86.875,0,2,2
2010-03,0,69,18.125,-80.625,1,0,1
2010-03,1,43,18.375,-87.125,0,2,2
2010-03,1,44,18.375,-86.875,0,4,4
2010-03,1,45,18.375,-86.625,0,3,3
2010-03,1,46,18.375,-86.375,0,1,1
2010-03,1,69,18.375,-80.625,1,0,1
2010-03,2,57,18.625,-83.625,1,0,1
2010-03,2,67,18.625,-81.125,2,0,2
2010-03,2,68,18.625,-80.875,4,0,4
2010-03,3,51,18.875,-85.125,3,0,3
2010-03,3,65,18.875,-81.625,3,0,3
2010-03,3,66,18.875,-81.375,3,0,3
2010-03,3,67,18.875,-81.125,1,0,1
2010-03,4,50,19.125,-85.375,1,0,1
2010-03,4,51,19.125,-85.125,1,0,1
2010-03,4,52,19.125,-84.875,1,0,1
2010-03,4,53,19.125,-84.625,1,0,1
2010-03,4,58,19.125,-83.375,1,0,1
2010-03,4,60,19.125,-82.875,2,0,2
2010-03,5,53,19.375,-84.625,2,0,2
2010-03,5,54,19.375,-84.375,2,0,2
2010-03,5,58,19.375,-83.375,5,0,5
2010-03,6,19,19.625,-93.125,0,3,3
2010-03,6,54,19.625,-84.375,1,0,1
2010-03,6,55,19.625,-84.125,3,0,3
2010-03,6,56,19.625,-83.875,2,0,2
2010-03,6,57,19.625,-83.625,4,0,4
2010-03,6,58,19.625,-83.375,1,0,1
2010-03,7,14,19.875,-94.375,1,0,1
2010-03,7,19,19.875,-93.125,0,5,5
2010-03,7,55,19.875,-84.125,0,1,1
2010-03,7,57,19.875,-83.625,2,0,2
2010-03,7,71,19.875,-80.125,0,1,1
2010-03,8,18,20.125,-93.375,0,1,1
2010-03,8,19,20.125,-93.125,0,5,5
2010-03,9,18,20.375,-93.375,0,2,2
2010-03,9,19,20.375,-93.125,0,2,2
2010-03,9,68,20.375,-80.875,0,3,3
2010-03,12,13,21.125,-94.625,5,0,5
2010-03,12,14,21.125,-94.375,11,0,11
2010-03,13,12,21.375,-94.875,3,0,3
2010-03,13,13,21.375,-94.625,3,0,3
2010-03,13,14,21.375,-94.375,3,0,3
2010-03,15,14,21.875,-94.375,1,0,1
2010-03,18,6,22.625,-96.375,0,1,1
2010-03,21,8,23.375,-95.875,0,3,3
2010-03,21,9,23.375,-95.625,0,6,6
2010-03,21,26,23.375,-91.375,1,0,1
2010-03,21,27,23.375,-91.125,2,0,2
2010-03,21,28,23.375,-90.875,4,0,4
2010-03,21,29,23.375,-90.625,2,0,2
2010-03,22,8,23.625,-95.875,0,8,8
2010-03,22,10,23.625,-95.375,0,4,4
2010-03,22,11,23.625,-95.125,0,6,6
2010-03,22,12,23.625,-94.875,0,3,3
2010-03,22,26,23.625,-91.375,5,0,5
2010-03,22,54,23.625,-84.375,4,0,4
2010-03,22,55,23.625,-84.125,27,0,27
2010-03,23,14,23.875,-94.375,0,1,1
2010-03,23,24,23.875,-91.875,4,0,4
2010-03,23,25,23.875,-91.625,5,0,5
2010-03,23,26,23.875,-91.375,4,0,4
2010-03,23,64,23.875,-81.875,0,16,16
2010-03,23,65,23.875,-81.625,0,7,7
2010-03,24,23,24.125,-92.125,4,0,4
2010-03,24,28,24.125,-90.875,0,1,1
2010-03,24,66,24.125,-81.375,0,3,3
2010-03,25,28,24.375,-90.875,0,1,1
2010-03,25,65,24.375,-81.625,0,5,5
2010-03,27,19,24.875,-93.125,0,1,1
2010-03,28,19,25.125,-93.125,0,1,1
2010-03,28,20,25.125,-92.875,0,7,7
2010-03,28,21,25.125,-92.625,0,3,3
2010-03,29,8,25.375,-95.875,7,0,7
2010-03,29,9,25.375,-95.625,10,0,10
2010-03,29,15,25.375,-94.125,3,0,3
2010-03,29,21,25.375,-92.625,0,4,4
2010-03,29,47,25.375,-86.125,0,10,10
2010-03,29,48,25.375,-85.875,0,4,4
2010-03,30,15,25.625,-94.125,4,0,4
2010-03,30,47,25.625,-86.125,0,17,17
2010-03,31,15,25.875,-94.125,7,0,7
2010-03,31,38,25.875,-88.375,5,0,5
2010-03,32,16,26.125,-93.875,12,0,12
2010-03,32,17,26.125,-93.625,2,0,2
2010-03,32,28,26.125,-90.875,1,0,1
2010-03,32,29,26.125,-90.625,10,0,10
2010-03,32,36,26.125,-88.875,2,0,2
2010-03,32,37,26.125,-88.625,2,0,2
2010-03,32,38,26.125,-88.375,12,0,12
2010-03,32,39,26.125,-88.125,9,0,9
2010-03,33,16,26.375,-93.875,3,0,3
2010-03,33,28,26.375,-90.875,2,0,2
2010-03,33,29,26.375,-90.625,6,0,6
2010-03,33,37,26.375,-88.625,1,0,1
2010-03,34,9,26.625,-95.625,0,5,5
2010-03,34,26,26.625,-91.375,6,0,6
2010-03,34,27,26.625,-91.125,2,0,2
2010-03,35,9,26.875,-95.625,0,18,18
2010-03,35,10,26.875,-95.375,0,1,1
2010-03,35,11,26.875,-95.125,0,4,4
2010-03,36,11,27.125,-95.125,0,2,2
2010-03,37,48,27.375,-85.875,3,0,3
2010-03,37,49,27.375,-85.625,5,0,5
2010-03,38,48,27.625,-85.875,7,0,7
2010-03,40,32,28.125,-89.875,0,3,3
2010-03,40,33,28.125,-89.625,0,7,7
2010-03,40,34,28.125,-89.375,0,3,3
2010-03,41,33,28.375,-89.625,0,1,1
2010-04,1,44,18.375,-86.875,5,0,5
2010-04,1,67,18.375,-81.125,1,0,1
2010-04,2,45,18.625,-86.625,3,0,3
2010-04,2,46,18.625,-86.375,6,0,6
2010-04,2,47,18.625,-86.125,5,0,5
2010-04,2,48,18.625,-85.875,2,0,2
2010-04,2,63,18.625,-82.125,1,0,1
2010-04,2,64,18.625,-81.875,7,0,7
2010-04,2,65,18.625,-81.625,3,0,3
2010-04,2,66,18.625,-81.375,4,0,4
2010-04,3,51,18.875,-85.125,1,0,1
2010-04,3,62,18.875,-82.375,3,0,3
2010-04,3,63,18.875,-82.125,9,0,9
2010-04,4,49,19.125,-85.625,3,0,3
2010-04,4,50,19.125,-85.375,5,0,5
2010-04,6,66,19.625,-81.375,0,8,8
2010-04,6,67,19.625,-81.125,0,9,9
2010-04,7,66,19.875,-81.375,0,5,5
2010-04,8,67,20.125,-81.125,0,1,1
2010-04,8,68,20.125,-80.875,0,5,5
2010-04,9,17,20.375,-93.625,0,12,12
2010-04,9,18,20.375,-93.375,0,2,2
2010-04,9,68,20.375,-80.875,0,1,1
2010-04,10,16,20.625,-93.875,0,3,3
2010-04,10,17,20.625,-93.625,0,2,2
2010-04,10,18,20.625,-93.375,0,1,1
2010-04,11,16,20.875,-93.875,0,2,2
2010-04,11,17,20.875,-93.625,0,7,7
2010-04,12,17,21.125,-93.625,0,1,1
2010-04,13,11,21.375,-95.125,5,0,5
2010-04,13,12,21.375,-94.875,7,0,7
2010-04,14,10,21.625,-95.375,4,0,4
2010-04,14,11,21.625,-95.125,7,0,7
2010-04,16,10,22.125,-95.375,3,0,3
2010-04,16,11,22.125,-95.125,2,0,2
2010-04,17,11,22.375,-95.125,2,0,2
2010-04,20,21,23.125,-92.625,0,10,10
2010-04,20,22,23.125,-92.375,0,14,14
2010-04,20,23,23.125,-92.125,0,2,2
2010-04,22,7,23.625,-96.125,0,1,1
2010-04,22,8,23.625,-95.875,0,2,2
2010-04,22,55,23.625,-84.125,22,0,22
2010-04,22,56,23.625,-83.875,5,0,5
2010-04,22,57,23.625,-83.625,3,0,3
2010-04,23,7,23.875,-96.125,0,13,13
2010-04,24,7,24.125,-96.125,0,10,10
2010-04,24,8,24.125,-95.875,0,1,1
2010-04,24,22,24.125,-92.375,2,0,2
2010-04,24,23,24.125,-92.125,3,0,3
2010-04,24,66,24.125,-81.375,0,3,3
2010-04,24,67,24.125,-81.125,0,1,1
2010-04,25,8,24.375,-95.875,0,3,3
2010-04,28,15,25.125,-94.125,8,0,8
2010-04,28,21,25.125,-92.625,0,8,8
2010-04,28,22,25.125,-92.375,0,20,20
2010-04,29,15,25.375,-94.125,3,0,3
2010-04,29,21,25.375,-92.625,0,2,2
2010-04,29,46,25.375,-86.375,0,5,5
2010-04,29,47,25.375,-86.125,0,11,11
2010-04,30,45,25.625,-86.625,0,5,5
2010-04,30,46,25.625,-86.375,0,3,3
2010-04,30,47,25.625,-86.125,0,3,3
2010-04,31,34,25.875,-89.375,7,0,7
2010-04,31,35,25.875,-89.125,4,0,4
2010-04,31,44,25.875,-86.875,0,3,3
2010-04,32,7,26.125,-96.125,7,0,7
2010-04,32,17,26.125,-93.625,3,0,3
2010-04,32,34,26.125,-89.375,7,0,7
2010-04,32,35,26.125,-89.125,4,0,4
2010-04,32,36,26.125,-88.875,2,0,2
2010-04,33,7,26.375,-96.125,14,0,14
2010-04,33,16,26.375,-93.875,2,0,2
2010-04,33,17,26.375,-93.625,13,0,13
2010-04,33,36,26.375,-88.875,3,0,3
2010-04,33,37,26.375,-88.625,3,0,3
2010-04,34,11,26.625,-95.125,0,12,12
2010-04,34,25,26.625,-91.625,5,0,5
2010-04,34,26,26.625,-91.375,12,0,12
2010-04,34,51,26.625,-85.125,1,0,1
2010-04,35,11,26.875,-95.125,0,18,18
2010-04,35,51,26.875,-85.125,2,0,2
2010-04,36,51,27.125,-85.125,5,0,5
2010-04,37,49,27.375,-85.625,4,0,4
2010-04,37,50,27.375,-85.375,5,0,5
2010-04,37,51,27.375,-85.125,3,0,3
2010-04,38,33,27.625,-89.625,0,2,2
2010-04,38,34,27.625,-89.375,0,1,1
2010-04,38,49,27.625,-85.625,1,0,1
2010-04,38,50,27.625,-85.375,7,0,7
2010-04,38,51,27.625,-85.125,2,0,2
2010-04,39,33,27.875,-89.625,0,9,9
2010-04,39,34,27.875,-89.375,0,8,8
2010-04,39,35,27.875,-89.125,0,4,4
2010-04,40,34,28.125,-89.375,0,5,5
2010-05,0,47,18.125,-86.125,0,5,5
2010-05,0,48,18.125,-85.875,0,3,3
2010-05,0,49,18.125,-85.625,0,4,4
2010-05,0,50,18.125,-85.375,0,4,4
2010-05,0,51,18.125,-85.125,0,3,3
2010-05,1,47,18.375,-86.125,0,2,2
2010-05,1,48,18.375,-85.875,0,3,3
2010-05,1,68,18.375,-80.875,0,1,1
2010-05,2,46,18.625,-86.375,0,3,3
2010-05,2,47,18.625,-86.125,0,2,2
2010-05,3,62,18.875,-82.375,3,0,3
2010-05,3,63,18.875,-82.125,1,0,1
2010-05,4,59,19.125,-83.125,3,0,3
2010-05,4,65,19.125,-81.625,0,3,3
2010-05,5,65,19.375,-81.625,0,1,1
2010-05,6,14,19.625,-94.375,0,6,6
2010-05,6,15,19.625,-94.125,0,1,1
2010-05,6,65,19.625,-81.625,0,3,3
2010-05,6,66,19.625,-81.375,0,1,1
2010-05,7,14,19.875,-94.375,0,3,3
2010-05,7,15,19.875,-94.125,0,19,19
2010-05,11,17,20.875,-93.625,0,1,1
2010-05,12,7,21.125,-96.125,1,0,1
2010-05,12,8,21.125,-95.875,1,0,1
2010-05,14,18,21.625,-93.375,0,3,3
2010-05,15,7,21.875,-96.125,5,0,5
2010-05,15,8,21.875,-95.875,8,0,8
2010-05,15,9,21.875,-95.625,8,0,8
2010-05,15,10,21.875,-95.375,3,0,3
2010-05,15,15,21.875,-94.125,0,1,1
2010-05,15,16,21.875,-93.875,0,4,4
2010-05,16,10,22.125,-95.375,1,0,1
2010-05,16,15,22.125,-94.125,0,3,3
2010-05,16,17,22.125,-93.625,0,3,3
2010-05,20,21,23.125,-92.625,0,5,5
2010-05,22,15,23.625,-94.125,0,2,2
2010-05,22,57,23.625,-83.625,3,0,3
2010-05,22,58,23.625,-83.375,1,0,1
2010-05,23,14,23.875,-94.375,0,1,1
2010-05,23,15,23.875,-94.125,0,3,3
2010-05,23,49,23.875,-85.625,2,0,2
2010-05,23,54,23.875,-84.375,0,1,1
2010-05,23,55,23.875,-84.125,0,4,4
2010-05,23,56,23.875,-83.875,0,5,5
2010-05,23,57,23.875,-83.625,0,11,11
2010-05,23,63,23.875,-82.125,1,0,1
2010-05,23,64,23.875,-81.875,4,0,4
2010-05,23,65,23.875,-81.625,3,0,3
2010-05,24,13,24.125,-94.625,0,1,1
2010-05,24,14,24.125,-94.375,0,4,4
2010-05,24,26,24.125,-91.375,4,0,4
2010-05,24,50,24.125,-85.375,2,0,2
2010-05,24,65,24.125,-81.625,2,0,2
2010-05,25,8,24.375,-95.875,0,2,2
2010-05,25,13,24.375,-94.625,0,1,1
2010-05,25,27,24.375,-91.125,2,0,2
2010-05,25,50,24.375,-85.375,2,0,2
2010-05,26,9,24.625,-95.625,0,2,2
2010-05,26,10,24.625,-95.375,0,3,3
2010-05,26,11,24.625,-95.125,0,5,5
2010-05,26,12,24.625,-94.875,0,5,5
2010-05,26,13,24.625,-94.625,0,2,2
2010-05,26,50,24.625,-85.375,6,0,6
2010-05,27,50,24.875,-85.375,5,0,5
2010-05,27,51,24.875,-85.125,1,0,1
2010-05,28,22,25.125,-92.375,0,7,7
2010-05,28,51,25.125,-85.125,3,0,3
2010-05,29,22,25.375,-92.375,0,9,9
2010-05,29,51,25.375,-85.125,1,0,1
2010-05,30,23,25.625,-92.125,0,13,13
2010-05,30,24,25.625,-91.875,0,2,2
2010-05,30,51,25.625,-85.125,3,0,3
2010-05,31,16,25.875,-93.875,4,0,4
2010-05,31,17,25.875,-93.625,2,0,2
2010-05,31,31,25.875,-90.125,1,0,1
2010-05,31,32,25.875,-89.875,2,0,2
2010-05,31,33,25.875,-89.625,1,0,1
2010-05,31,34,25.875,-89.375,1,0,1
2010-05,31,44,25.875,-86.875,0,25,25
2010-05,31,51,25.875,-85.125,2,0,2
2010-05,32,7,26.125,-96.125,9,0,9
2010-05,32,8,26.125,-95.875,3,0,3
2010-05,32,16,26.125,-93.875,19,0,19
2010-05,32,17,26.125,-93.625,6,0,6
2010-05,32,30,26.125,-90.375,1,0,1
2010-05,32,31,26.125,-90.125,3,0,3
2010-05,32,36,26.125,-88.875,3,0,3
2010-05,32,44,26.125,-86.875,0,6,6
2010-05,32,51,26.125,-85.125,1,0,1
2010-05,33,31,26.375,-90.125,1,0,1
2010-05,33,32,26.375,-89.875,6,0,6
2010-05,33,33,26.375,-89.625,3,0,3
2010-05,33,51,26.375,-85.125,2,0,2
2010-05,34,51,26.625,-85.125,1,0,1
2010-05,35,9,26.875,-95.625,0,3,3
2010-05,35,10,26.875,-95.375,0,11,11
2010-05,35,11,26.875,-95.125,0,8,8
2010-05,36,9,27.125,-95.625,0,2,2
2010-05,36,10,27.125,-95.375,0,4,4
2010-05,37,10,27.375,-95.375,0,3,3
2010-05,38,40,27.625,-87.875,1,0,1
2010-05,38,41,27.625,-87.625,5,0,5
2010-05,38,45,27.625,-86.625,1,0,1
2010-05,38,46,27.625,-86.375,5,0,5
2010-05,38,47,27.625,-86.125,1,0,1
2010-05,39,34,27.875,-89.375,0,19,19
2010-05,39,42,27.875,-87.375,2,0,2
2010-05,39,43,27.875,-87.125,1,0,1
2010-05,39,44,27.875,-86.875,1,0,1
2010-05,39,45,27.875,-86.625,1,0,1
2010-05,40,43,28.125,-87.125,6,0,6
2010-05,40,44,28.125,-86.875,1,0,1
2010-05,41,43,28.375,-87.125,2,0,2
2010-06,0,63,18.125,-82.125,0,2,2
2010-06,1,63,18.375,-82.125,0,1,1
2010-06,2,44,18.625,-86.875,0,4,4
2010-06,2,45,18.625,-86.625,0,3,3
2010-06,3,46,18.875,-86.375,0,4,4
2010-06,6,49,19.625,-85.625,0,5,5
2010-06,7,10,19.875,-95.375,1,0,1
2010-06,7,11,19.875,-95.125,4,0,4
2010-06,7,12,19.875,-94.875,1,0,1
2010-06,7,15,19.875,-94.125,0,4,4
2010-06,7,16,19.875,-93.875,0,2,2
2010-06,7,47,19.875,-86.125,0,1,1
2010-06,7,48,19.875,-85.875,0,1,1
2010-06,7,49,19.875,-85.625,0,1,1
2010-06,7,69,19.875,-80.625,6,0,6
2010-06,7,70,19.875,-80.375,4,0,4
2010-06,8,9,20.125,-95.625,3,0,3
2010-06,8,15,20.125,-94.125,0,4,4
2010-06,8,16,20.125,-93.875,0,5,5
2010-06,8,17,20.125,-93.625,0,4,4
2010-06,8,47,20.125,-86.125,0,6,6
2010-06,8,48,20.125,-85.875,0,3,3
2010-06,8,49,20.125,-85.625,0,2,2
2010-06,8,70,20.125,-80.375,4,0,4
2010-06,9,8,20.375,-95.875,6,0,6
2010-06,9,50,20.375,-85.375,0,1,1
2010-06,10,7,20.625,-96.125,6,0,6
2010-06,11,7,20.875,-96.125,3,0,3
2010-06,11,8,20.875,-95.875,2,0,2
2010-06,11,55,20.875,-84.125,1,0,1
2010-06,12,7,21.125,-96.125,4,0,4
2010-06,12,56,21.125,-83.875,4,0,4
2010-06,13,56,21.375,-83.875,1,0,1
2010-06,13,57,21.375,-83.625,10,0,10
2010-06,17,10,22.375,-95.375,0,2,2
2010-06,18,10,22.625,-95.375,0,1,1
2010-06,18,11,22.625,-95.125,0,3,3
2010-06,18,12,22.625,-94.875,0,2,2
2010-06,19,12,22.875,-94.875,0,2,2
2010-06,19,13,22.875,-94.625,0,4,4
2010-06,20,13,23.125,-94.625,0,1,1
2010-06,20,14,23.125,-94.375,0,5,5
2010-06,21,14,23.375,-94.375,0,2,2
2010-06,21,15,23.375,-94.125,0,3,3
2010-06,21,30,23.375,-90.375,0,5,5
2010-06,21,31,23.375,-90.125,0,11,11
2010-06,21,49,23.375,-85.625,22,0,22
2010-06,22,15,23.625,-94.125,0,5,5
2010-06,22,33,23.625,-89.625,0,2,2
2010-06,22,49,23.625,-85.625,6,0,6
2010-06,23,22,23.875,-92.375,2,0,2
2010-06,23,23,23.875,-92.125,9,0,9
2010-06,23,24,23.875,-91.875,6,0,6
2010-06,23,33,23.875,-89.625,0,9,9
2010-06,23,49,23.875,-85.625,2,0,2
2010-06,23,57,23.875,-83.625,0,24,24
2010-06,24,24,24.125,-91.875,4,0,4
2010-06,24,25,24.125,-91.625,8,0,8
2010-06,24,26,24.125,-91.375,1,0,1
2010-06,24,33,24.125,-89.625,0,3,3
2010-06,24,57,24.125,-83.625,0,1,1
2010-06,24,66,24.125,-81.375,5,0,5
2010-06,24,67,24.125,-81.125,5,0,5
2010-06,25,56,24.375,-83.875,0,3,3
2010-06,25,67,24.375,-81.125,1,0,1
2010-06,25,68,24.375,-80.875,4,0,4
2010-06,25,69,24.375,-80.625,2,0,2
2010-06,26,56,24.625,-83.875,0,2,2
2010-06,26,69,24.625,-80.625,2,0,2
2010-06,26,71,24.625,-80.125,1,0,1
2010-06,27,8,24.875,-95.875,4,0,4
2010-06,27,9,24.875,-95.625,7,0,7
2010-06,28,9,25.125,-95.625,5,0,5
2010-06,28,10,25.125,-95.375,5,0,5
2010-06,28,40,25.125,-87.875,0,7,7
2010-06,28,41,25.125,-87.625,0,9,9
2010-06,28,42,25.125,-87.375,0,1,1
2010-06,29,25,25.375,-91.625,0,4,4
2010-06,29,26,25.375,-91.375,0,5,5
2010-06,29,42,25.375,-87.375,0,4,4
2010-06,29,43,25.375,-87.125,0,3,3
2010-06,30,18,25.625,-93.375,13,0,13
2010-06,30,24,25.625,-91.875,0,20,20
2010-06,30,43,25.625,-87.125,0,4,4
2010-06,30,44,25.625,-86.875,0,2,2
2010-06,31,17,25.875,-93.625,7,0,7
2010-06,31,18,25.875,-93.375,6,0,6
2010-06,31,24,25.875,-91.875,0,1,1
2010-06,32,17,26.125,-93.625,2,0,2
2010-06,32,47,26.125,-86.125,1,0,1
2010-06,33,33,26.375,-89.625,2,0,2
2010-06,33,34,26.375,-89.375,15,0,15
2010-06,33,47,26.375,-86.125,2,0,2
2010-06,34,6,26.625,-96.375,0,2,2
2010-06,34,7,26.625,-96.125,0,3,3
2010-06,34,34,26.625,-89.375,10,0,10
2010-06,34,35,26.625,-89.125,3,0,3
2010-06,34,46,26.625,-86.375,2,0,2
2010-06,34,47,26.625,-86.125,4,0,4
2010-06,35,7,26.875,-96.125,0,2,2
2010-06,35,8,26.875,-95.875,0,14,14
2010-06,35,9,26.875,-95.625,0,3,3
2010-06,35,46,26.875,-86.375,7,0,7
2010-06,36,46,27.125,-86.375,6,0,6
2010-06,37,46,27.375,-86.375,7,0,7
2010-06,38,46,27.625,-86.375,1,0,1
2010-07,0,45,18.125,-86.625,5,0,5
2010-07,0,46,18.125,-86.375,6,0,6
2010-07,0,47,18.125,-86.125,5,0,5
2010-07,0,48,18.125,-85.875,1,0,1
2010-07,0,62,18.125,-82.375,0,1,1
2010-07,1,61,18.375,-82.625,0,1,1
2010-07,1,62,18.375,-82.375,0,1,1
2010-07,2,54,18.625,-84.375,0,3,3
2010-07,2,55,18.625,-84.125,0,3,3
2010-07,2,56,18.625,-83.875,0,4,4
2010-07,2,57,18.625,-83.625,0,3,3
2010-07,2,58,18.625,-83.375,0,2,2
2010-07,3,53,18.875,-84.625,0,4,4
2010-07,3,54,18.875,-84.375,0,1,1
2010-07,4,52,19.125,-84.875,0,1,1
2010-07,5,66,19.375,-81.375,2,0,2
2010-07,5,67,19.375,-81.125,4,0,4
2010-07,6,63,19.625,-82.125,3,0,3
2010-07,6,67,19.625,-81.125,1,0,1
2010-07,6,68,19.625,-80.875,4,0,4
2010-07,6,69,19.625,-80.625,4,0,4
2010-07,7,13,19.875,-94.625,3,0,3
2010-07,7,49,19.875,-85.625,0,3,3
2010-07,7,59,19.875,-83.125,4,0,4
2010-07,7,60,19.875,-82.875,2,0,2
2010-07,7,61,19.875,-82.625,2,0,2
2010-07,7,62,19.875,-82.375,3,0,3
2010-07,7,63,19.875,-82.125,1,0,1
2010-07,8,12,20.125,-94.875,9,0,9
2010-07,8,13,20.125,-94.625,12,0,12
2010-07,8,56,20.125,-83.875,1,0,1
2010-07,9,13,20.375,-94.625,7,0,7
2010-07,9,56,20.375,-83.875,10,0,10
2010-07,10,55,20.625,-84.125,1,0,1
2010-07,10,56,20.625,-83.875,2,0,2
2010-07,11,55,20.875,-84.125,2,0,2
2010-07,17,6,22.375,-96.375,0,9,9
2010-07,17,7,22.375,-96.125,0,11,11
2010-07,17,8,22.375,-95.875,0,6,6
2010-07,17,9,22.375,-95.625,0,4,4
2010-07,17,10,22.375,-95.375,0,1,1
2010-07,18,42,22.625,-87.375,0,4,4
2010-07,18,43,22.625,-87.125,0,1,1
2010-07,19,43,22.875,-87.125,0,8,8
2010-07,20,43,23.125,-87.125,0,1,1
2010-07,21,14,23.375,-94.375,2,0,2
2010-07,21,18,23.375,-93.375,2,0,2
2010-07,21,19,23.375,-93.125,5,0,5
2010-07,22,14,23.625,-94.375,1,0,1
2010-07,22,22,23.625,-92.375,3,0,3
2010-07,22,32,23.625,-89.875,0,9,9
2010-07,22,49,23.625,-85.625,1,0,1
2010-07,22,58,23.625,-83.375,0,1,1
2010-07,23,22,23.875,-92.375,4,0,4
2010-07,23,32,23.875,-89.875,0,10,10
2010-07,23,46,23.875,-86.375,2,0,2
2010-07,23,49,23.875,-85.625,4,0,4
2010-07,23,58,23.875,-83.375,0,5,5
2010-07,23,59,23.875,-83.125,0,2,2
2010-07,24,47,24.125,-86.125,5,0,5
2010-07,24,48,24.125,-85.875,8,0,8
2010-07,24,49,24.125,-85.625,11,0,11
2010-07,25,12,24.375,-94.875,2,0,2
2010-07,25,56,24.375,-83.875,0,6,6
2010-07,26,12,24.625,-94.875,2,0,2
2010-07,26,56,24.625,-83.875,0,1,1
2010-07,27,40,24.875,-87.875,0,8,8
2010-07,28,10,25.125,-95.375,11,0,11
2010-07,28,37,25.125,-88.625,0,2,2
2010-07,28,38,25.125,-88.375,0,5,5
2010-07,28,39,25.125,-88.125,0,7,7
2010-07,28,40,25.125,-87.875,0,9,9
2010-07,29,10,25.375,-95.375,2,0,2
2010-07,29,11,25.375,-95.125,6,0,6
2010-07,29,19,25.375,-93.125,7,0,7
2010-07,29,20,25.375,-92.875,3,0,3
2010-07,29,26,25.375,-91.375,0,2,2
2010-07,29,27,25.375,-91.125,0,1,1
2010-07,30,19,25.625,-93.125,2,0,2
2010-07,30,27,25.625,-91.125,0,4,4
2010-07,30,51,25.625,-85.125,0,2,2
2010-07,31,27,25.875,-91.125,0,1,1
2010-07,31,28,25.875,-90.875,0,5,5
2010-07,31,51,25.875,-85.125,0,3,3
2010-07,31,52,25.875,-84.875,0,2,2
2010-07,31,53,25.875,-84.625,0,4,4
2010-07,32,27,26.125,-91.125,0,1,1
2010-07,32,28,26.125,-90.875,0,14,14
2010-07,32,52,26.125,-84.875,0,3,3
2010-07,32,53,26.125,-84.625,0,5,5
2010-07,32,54,26.125,-84.375,0,5,5
2010-07,33,6,26.375,-96.375,0,7,7
2010-07,33,28,26.375,-90.875,0,3,3
2010-07,34,6,26.625,-96.375,0,3,3
2010-07,34,35,26.625,-89.125,2,0,2
2010-07,35,6,26.875,-96.375,0,2,2
2010-07,35,21,26.875,-92.625,0,6,6
2010-07,35,35,26.875,-89.125,11,0,11
2010-07,35,38,26.875,-88.375,1,0,1
2010-07,35,41,26.875,-87.625,2,0,2
2010-07,35,42,26.875,-87.375,3,0,3
2010-07,36,21,27.125,-92.625,0,1,1
2010-07,36,39,27.125,-88.125,4,0,4
2010-07,36,40,27.125,-87.875,6,0,6
2010-07,36,41,27.125,-87.625,1,0,1
2010-07,37,8,27.375,-95.875,0,2,2
2010-07,37,21,27.375,-92.625,0,2,2
2010-07,37,25,27.375,-91.625,2,0,2
2010-07,37,26,27.375,-91.375,2,0,2
2010-07,38,8,27.625,-95.875,0,3,3
2010-07,38,9,27.625,-95.625,0,2,2
2010-07,38,10,27.625,-95.375,0,1,1
2010-07,38,21,27.625,-92.625,0,3,3
2010-07,38,22,27.625,-92.375,0,3,3
2010-07,38,23,27.625,-92.125,0,1,1
2010-07,38,25,27.625,-91.625,2,0,2
2010-07,38,26,27.625,-91.375,1,0,1
2010-07,38,27,27.625,-91.125,3,0,3
2010-07,39,10,27.875,-95.375,0,1,1
2010-07,39,11,27.875,-95.125,0,6,6
2010-07,39,22,27.875,-92.375,0,2,2
2010-07,39,23,27.875,-92.125,0,1,1
2010-07,40,11,28.125,-95.125,0,1,1
2010-08,0,42,18.125,-87.375,2,0,2
2010-08,0,56,18.125,-83.875,0,6,6
2010-08,0,57,18.125,-83.625,0,2,2
2010-08,1,52,18.375,-84.875,0,1,1
2010-08,1,53,18.375,-84.625,0,3,3
2010-08,1,54,18.375,-84.375,0,4,4
2010-08,1,55,18.375,-84.125,0,3,3
2010-08,1,57,18.375,-83.625,0,3,3
2010-08,7,58,19.875,-83.375,1,0,1
2010-08,8,10,20.125,-95.375,6,0,6
2010-08,8,11,20.125,-95.125,10,0,10
2010-08,8,17,20.125,-93.625,0,3,3
2010-08,8,51,20.125,-85.125,2,0,2
2010-08,8,52,20.125,-84.875,4,0,4
2010-08,8,53,20.125,-84.625,3,0,3
2010-08,8,54,20.125,-84.375,1,0,1
2010-08,8,55,20.125,-84.125,2,0,2
2010-08,8,56,20.125,-83.875,3,0,3
2010-08,8,58,20.125,-83.375,1,0,1
2010-08,8,67,20.125,-81.125,6,0,6
2010-08,8,69,20.125,-80.625,1,0,1
2010-08,9,10,20.375,-95.375,7,0,7
2010-08,9,11,20.375,-95.125,8,0,8
2010-08,9,17,20.375,-93.625,0,4,4
2010-08,9,51,20.375,-85.125,6,0,6
2010-08,9,66,20.375,-81.375,1,0,1
2010-08,9,67,20.375,-81.125,2,0,2
2010-08,9,68,20.375,-80.875,1,0,1
2010-08,10,17,20.625,-93.625,0,1,1
2010-08,10,19,20.625,-93.125,0,1,1
2010-08,10,50,20.625,-85.375,5,0,5
2010-08,10,51,20.625,-85.125,1,0,1
2010-08,10,69,20.625,-80.625,2,0,2
2010-08,11,17,20.875,-93.625,0,1,1
2010-08,11,19,20.875,-93.125,0,2,2
2010-08,11,20,20.875,-92.875,0,6,6
2010-08,11,50,20.875,-85.375,2,0,2
2010-08,11,68,20.875,-80.875,3,0,3
2010-08,11,69,20.875,-80.625,6,0,6
2010-08,12,17,21.125,-93.625,0,4,4
2010-08,16,44,22.125,-86.875,0,5,5
2010-08,17,42,22.375,-87.375,0,2,2
2010-08,17,43,22.375,-87.125,0,4,4
2010-08,17,44,22.375,-86.875,0,9,9
2010-08,18,5,22.625,-96.625,0,5,5
2010-08,18,6,22.625,-96.375,0,2,2
2010-08,18,9,22.625,-95.625,5,0,5
2010-08,18,10,22.625,-95.375,5,0,5
2010-08,18,11,22.625,-95.125,4,0,4
2010-08,18,42,22.625,-87.375,0,7,7
2010-08,18,43,22.625,-87.125,0,4,4
2010-08,19,4,22.875,-96.875,0,3,3
2010-08,19,5,22.875,-96.625,0,9,9
2010-08,19,11,22.875,-95.125,1,0,1
2010-08,19,12,22.875,-94.875,4,0,4
2010-08,20,4,23.125,-96.875,0,5,5
2010-08,20,5,23.125,-96.625,0,1,1
2010-08,20,12,23.125,-94.875,3,0,3
2010-08,20,13,23.125,-94.625,3,0,3
2010-08,21,13,23.375,-94.625,4,0,4
2010-08,21,55,23.375,-84.125,0,7,7
2010-08,22,5,23.625,-96.625,0,2,2
2010-08,22,55,23.625,-84.125,0,2,2
2010-08,23,29,23.875,-90.625,0,1,1
2010-08,23,30,23.875,-90.375,0,6,6
2010-08,23,31,23.875,-90.125,0,3,3
2010-08,23,46,23.875,-86.375,5,0,5
2010-08,23,60,23.875,-82.875,6,0,6
2010-08,23,61,23.875,-82.625,3,0,3
2010-08,23,62,23.875,-82.375,6,0,6
2010-08,23,63,23.875,-82.125,2,0,2
2010-08,24,31,24.125,-90.125,0,6,6
2010-08,24,32,24.125,-89.875,0,2,2
2010-08,24,46,24.125,-86.375,8,0,8
2010-08,24,53,24.125,-84.625,0,2,2
2010-08,24,60,24.125,-82.875,1,0,1
2010-08,25,54,24.375,-84.375,0,6,6
2010-08,25,60,24.375,-82.875,2,0,2
2010-08,26,54,24.625,-84.375,0,14,14
2010-08,26,59,24.625,-83.125,1,0,1
2010-08,27,16,24.875,-93.875,3,0,3
2010-08,27,34,24.875,-89.375,0,2,2
2010-08,27,35,24.875,-89.125,0,5,5
2010-08,27,36,24.875,-88.875,0,1,1
2010-08,27,39,24.875,-88.125,0,3,3
2010-08,27,46,24.875,-86.375,4,0,4
2010-08,27,52,24.875,-84.875,0,2,2
2010-08,27,60,24.875,-82.875,1,0,1
2010-08,28,10,25.125,-95.375,1,0,1
2010-08,28,12,25.125,-94.875,2,0,2
2010-08,28,13,25.125,-94.625,5,0,5
2010-08,28,14,25.125,-94.375,6,0,6
2010-08,28,15,25.125,-94.125,2,0,2
2010-08,28,16,25.125,-93.875,3,0,3
2010-08,28,36,25.125,-88.875,0,3,3
2010-08,28,37,25.125,-88.625,0,2,2
2010-08,28,39,25.125,-88.125,0,2,2
2010-08,28,46,25.125,-86.375,14,0,14
2010-08,28,52,25.125,-84.875,0,1,1
2010-08,28,59,25.125,-83.125,1,0,1
2010-08,29,39,25.375,-88.125,0,4,4
2010-08,29,52,25.375,-84.875,0,3,3
2010-08,29,60,25.375,-82.875,1,0,1
2010-08,30,39,25.625,-88.125,0,9,9
2010-08,30,51,25.625,-85.125,0,3,3
2010-08,32,28,26.125,-90.875,0,1,1
2010-08,32,29,26.125,-90.625,0,13,13
2010-08,32,30,26.125,-90.375,0,12,12
2010-08,33,28,26.375,-90.875,0,4,4
2010-08,33,45,26.375,-86.625,1,0,1
2010-08,33,46,26.375,-86.375,1,0,1
2010-08,34,6,26.625,-96.375,0,7,7
2010-08,34,43,26.625,-87.125,6,0,6
2010-08,34,44,26.625,-86.875,1,0,1
2010-08,35,6,26.875,-96.375,0,6,6
2010-08,35,19,26.875,-93.125,0,7,7
2010-08,35,20,26.875,-92.875,0,2,2
2010-08,35,26,26.875,-91.375,3,0,3
2010-08,35,42,26.875,-87.375,2,0,2
2010-08,35,43,26.875,-87.125,2,0,2
2010-08,36,18,27.125,-93.375,0,4,4
2010-08,36,19,27.125,-93.125,0,4,4
2010-08,36,25,27.125,-91.625,6,0,6
2010-08,36,26,27.125,-91.375,18,0,18
2010-08,37,7,27.375,-96.125,0,3,3
2010-08,37,8,27.375,-95.875,0,4,4
2010-08,37,18,27.375,-93.375,0,8,8
2010-08,37,19,27.375,-93.125,0,6,6
2010-08,37,25,27.375,-91.625,4,0,4
2010-08,38,9,27.625,-95.625,0,3,3
2010-08,38,10,27.625,-95.375,0,2,2
2010-09,1,52,18.375,-84.875,0,1,1
2010-09,2,49,18.625,-85.625,0,3,3
2010-09,2,50,18.625,-85.375,0,4,4
2010-09,2,51,18.625,-85.125,0,3,3
2010-09,2,52,18.625,-84.875,0,2,2
2010-09,3,49,18.875,-85.625,0,4,4
2010-09,4,49,19.125,-85.625,0,6,6
2010-09,5,47,19.375,-86.125,0,3,3
2010-09,5,48,19.375,-85.875,0,3,3
2010-09,5,49,19.375,-85.625,0,1,1
2010-09,7,11,19.875,-95.125,16,0,16
2010-09,7,12,19.875,-94.875,1,0,1
2010-09,8,13,20.125,-94.625,2,0,2
2010-09,8,14,20.125,-94.375,2,0,2
2010-09,8,15,20.125,-94.125,2,0,2
2010-09,8,16,20.125,-93.875,7,0,7
2010-09,8,62,20.125,-82.375,2,0,2
2010-09,8,63,20.125,-82.125,2,0,2
2010-09,8,65,20.125,-81.625,2,0,2
2010-09,9,63,20.375,-82.125,3,0,3
2010-09,9,64,20.375,-81.875,11,0,11
2010-09,9,65,20.375,-81.625,4,0,4
2010-09,9,66,20.375,-81.375,6,0,6
2010-09,11,49,20.875,-85.625,3,0,3
2010-09,11,50,20.875,-85.375,2,0,2
2010-09,11,57,20.875,-83.625,0,1,1
2010-09,12,9,21.125,-95.625,0,6,6
2010-09,12,10,21.125,-95.375,0,3,3
2010-09,12,14,21.125,-94.375,0,1,1
2010-09,12,15,21.125,-94.125,0,3,3
2010-09,12,16,21.125,-93.875,0,5,5
2010-09,12,17,21.125,-93.625,0,5,5
2010-09,12,50,21.125,-85.375,2,0,2
2010-09,12,58,21.125,-83.375,0,2,2
2010-09,13,10,21.375,-95.375,0,2,2
2010-09,13,11,21.375,-95.125,0,1,1
2010-09,13,14,21.375,-94.375,0,3,3
2010-09,18,9,22.625,-95.625,2,0,2
2010-09,18,25,22.625,-91.625,1,0,1
2010-09,18,42,22.625,-87.375,0,1,1
2010-09,19,11,22.875,-95.125,1,0,1
2010-09,19,25,22.875,-91.625,4,0,4
2010-09,19,42,22.875,-87.375,0,1,1
2010-09,21,22,23.375,-92.375,0,1,1
2010-09,22,21,23.625,-92.625,0,1,1
2010-09,22,26,23.625,-91.375,0,2,2
2010-09,22,27,23.625,-91.125,0,3,3
2010-09,22,28,23.625,-90.875,0,3,3
2010-09,22,30,23.625,-90.375,0,1,1
2010-09,23,20,23.875,-92.875,0,2,2
2010-09,23,21,23.875,-92.625,0,1,1
2010-09,23,28,23.875,-90.875,0,4,4
2010-09,23,29,23.875,-90.625,0,5,5
2010-09,23,55,23.875,-84.125,0,2,2
2010-09,23,56,23.875,-83.875,0,5,5
2010-09,23,62,23.875,-82.375,2,0,2
2010-09,23,63,23.875,-82.125,5,0,5
2010-09,23,64,23.875,-81.875,2,0,2
2010-09,23,65,23.875,-81.625,5,0,5
2010-09,23,66,23.875,-81.375,3,0,3
2010-09,24,20,24.125,-92.875,0,8,8
2010-09,24,39,24.125,-88.125,0,6,6
2010-09,24,55,24.125,-84.125,0,1,1
2010-09,24,62,24.125,-82.375,2,0,2
2010-09,25,39,24.375,-88.125,0,16,16
2010-09,25,55,24.375,-84.125,0,9,9
2010-09,26,38,24.625,-88.375,0,3,3
2010-09,26,39,24.625,-88.125,0,4,4
2010-09,26,55,24.625,-84.125,0,13,13
2010-09,27,12,24.875,-94.875,20,0,20
2010-09,27,39,24.875,-88.125,0,1,1
2010-09,27,46,24.875,-86.375,1,0,1
2010-09,28,12,25.125,-94.875,10,0,10
2010-09,28,46,25.125,-86.375,5,0,5
2010-09,29,46,25.375,-86.375,24,0,24
2010-09,32,5,26.125,-96.625,0,4,4
2010-09,32,6,26.125,-96.375,0,3,3
2010-09,33,24,26.375,-91.875,10,0,10
2010-09,34,6,26.625,-96.375,0,3,3
2010-09,34,7,26.625,-96.125,0,1,1
2010-09,34,22,26.625,-92.375,3,0,3
2010-09,35,6,26.875,-96.375,0,1,1
2010-09,35,22,26.875,-92.375,5,0,5
2010-09,35,23,26.875,-92.125,5,0,5
2010-09,35,24,26.875,-91.875,3,0,3
2010-09,36,7,27.125,-96.125,0,1,1
2010-09,36,8,27.125,-95.875,0,3,3
2010-09,36,17,27.125,-93.625,0,1,1
2010-09,36,18,27.125,-93.375,0,5,5
2010-09,36,24,27.125,-91.875,3,0,3
2010-09,36,25,27.125,-91.625,1,0,1
2010-09,37,17,27.375,-93.625,0,1,1
2010-09,38,17,27.625,-93.625,0,6,6
2010-09,38,18,27.625,-93.375,0,10,10
2010-10,0,52,18.125,-84.875,2,0,2
2010-10,1,49,18.375,-85.625,3,0,3
2010-10,1,50,18.375,-85.375,1,0,1
2010-10,1,51,18.375,-85.125,2,0,2
2010-10,1,52,18.375,-84.875,4,0,4
2010-10,2,50,18.625,-85.375,3,0,3
2010-10,2,51,18.625,-85.125,3,0,3
2010-10,2,70,18.625,-80.375,4,0,4
2010-10,2,71,18.625,-80.125,3,0,3
2010-10,3,50,18.875,-85.375,1,0,1
2010-10,3,51,18.875,-85.125,4,0,4
2010-10,3,52,18.875,-84.875,1,0,1
2010-10,5,46,19.375,-86.375,0,1,1
2010-10,5,47,19.375,-86.125,0,3,3
2010-10,7,62,19.875,-82.375,1,0,1
2010-10,7,63,19.875,-82.125,1,0,1
2010-10,8,13,20.125,-94.625,4,0,4
2010-10,8,62,20.125,-82.375,4,0,4
2010-10,8,63,20.125,-82.125,1,0,1
2010-10,9,11,20.375,-95.125,7,0,7
2010-10,9,12,20.375,-94.875,7,0,7
2010-10,9,13,20.375,-94.625,3,0,3
2010-10,9,47,20.375,-86.125,0,1,1
2010-10,9,48,20.375,-85.875,0,1,1
2010-10,10,6,20.625,-96.375,0,3,3
2010-10,10,12,20.625,-94.875,2,0,2
2010-10,11,6,20.875,-96.375,0,2,2
2010-10,11,7,20.875,-96.125,0,9,9
2010-10,11,8,20.875,-95.875,0,3,3
2010-10,11,55,20.875,-84.125,0,1,1
2010-10,11,57,20.875,-83.625,0,3,3
2010-10,11,58,20.875,-83.375,0,7,7
2010-10,12,8,21.125,-95.875,0,5,5
2010-10,12,9,21.125,-95.625,0,3,3
2010-10,12,55,21.125,-84.125,0,5,5
2010-10,12,56,21.125,-83.875,0,3,3
2010-10,12,57,21.125,-83.625,0,2,2
2010-10,12,58,21.125,-83.375,0,6,6
2010-10,16,9,22.125,-95.625,13,0,13
2010-10,18,24,22.625,-91.875,2,0,2
2010-10,19,23,22.875,-92.125,4,0,4
2010-10,19,24,22.875,-91.875,10,0,10
2010-10,20,23,23.125,-92.125,11,0,11
2010-10,21,22,23.375,-92.375,1,0,1
2010-10,23,55,23.875,-84.125,0,2,2
2010-10,23,56,23.875,-83.875,0,4,4
2010-10,23,64,23.875,-81.875,2,0,2
2010-10,23,66,23.875,-81.375,6,0,6
2010-10,23,67,23.875,-81.125,6,0,6
2010-10,23,68,23.875,-80.875,2,0,2
2010-10,24,19,24.125,-93.125,0,12,12
2010-10,24,20,24.125,-92.875,0,2,2
2010-10,24,37,24.125,-88.625,0,4,4
2010-10,24,38,24.125,-88.375,0,1,1
2010-10,24,53,24.125,-84.625,0,11,11
2010-10,24,54,24.125,-84.375,0,1,1
2010-10,24,55,24.125,-84.125,0,9,9
2010-10,25,19,24.375,-93.125,0,2,2
2010-10,25,20,24.375,-92.875,0,14,14
2010-10,25,36,24.375,-88.875,0,2,2
2010-10,25,37,24.375,-88.625,0,9,9
2010-10,25,38,24.375,-88.375,0,3,3
2010-10,25,54,24.375,-84.375,0,4,4
2010-10,26,37,24.625,-88.625,0,3,3
2010-10,26,38,24.625,-88.375,0,9,9
2010-10,26,45,24.625,-86.625,11,0,11
2010-10,27,11,24.875,-95.125,28,0,28
2010-10,27,12,24.875,-94.875,2,0,2
2010-10,27,22,24.875,-92.375,0,1,1
2010-10,27,45,24.875,-86.625,7,0,7
2010-10,27,46,24.875,-86.375,1,0,1
2010-10,28,11,25.125,-95.125,1,0,1
2010-10,28,45,25.125,-86.625,12,0,12
2010-10,34,6,26.625,-96.375,0,4,4
2010-10,34,7,26.625,-96.125,0,5,5
2010-10,34,21,26.625,-92.625,4,0,4
2010-10,34,22,26.625,-92.375,8,0,8
2010-10,34,23,26.625,-92.125,11,0,11
2010-10,35,7,26.875,-96.125,0,5,5
2010-10,35,8,26.875,-95.875,0,3,3
2010-10,35,19,26.875,-93.125,2,0,2
2010-10,35,20,26.875,-92.875,3,0,3
2010-10,35,21,26.875,-92.625,1,0,1
2010-10,41,29,28.375,-90.625,0,4,4
2010-10,41,30,28.375,-90.375,0,11,11
2010-10,41,31,28.375,-90.125,0,2,2
2010-10,41,46,28.375,-86.375,0,1,1
2010-10,41,47,28.375,-86.125,0,2,2
2010-10,42,47,28.625,-86.125,0,6,6
2010-10,43,44,28.875,-86.875,0,4,4
2010-10,43,45,28.875,-86.625,0,1,1
2010-10,43,46,28.875,-86.375,0,3,3
2010-10,46,71,29.625,-80.125,0,3,3
2010-10,47,70,29.875,-80.375,0,3,3
2010-10,50,70,30.625,-80.375,0,2,2
2010-11,0,70,18.125,-80.375,1,0,1
2010-11,2,67,18.625,-81.125,2,0,2
2010-11,2,68,18.625,-80.875,2,0,2
2010-11,2,69,18.625,-80.625,2,0,2
2010-11,3,49,18.875,-85.625,3,0,3
2010-11,3,50,18.875,-85.375,3,0,3
2010-11,3,66,18.875,-81.375,3,0,3
2010-11,3,67,18.875,-81.125,1,0,1
2010-11,4,47,19.125,-86.125,1,0,1
2010-11,4,48,19.125,-85.875,5,0,5
2010-11,4,49,19.125,-85.625,2,0,2
2010-11,4,64,19.125,-81.875,6,0,6
2010-11,4,65,19.125,-81.625,4,0,4
2010-11,5,47,19.375,-86.125,3,0,3
2010-11,5,62,19.375,-82.375,1,0,1
2010-11,5,63,19.375,-82.125,5,0,5
2010-11,5,64,19.375,-81.875,1,0,1
2010-11,6,47,19.625,-86.125,2,0,2
2010-11,6,48,19.625,-85.875,1,0,1
2010-11,7,10,19.875,-95.375,4,0,4
2010-11,7,11,19.875,-95.125,4,0,4
2010-11,7,12,19.875,-94.875,3,0,3
2010-11,7,13,19.875,-94.625,2,0,2
2010-11,7,14,19.875,-94.375,2,0,2
2010-11,7,48,19.875,-85.875,3,0,3
2010-11,8,10,20.125,-95.375,4,0,4
2010-11,8,11,20.125,-95.125,2,0,2
2010-11,8,12,20.125,-94.875,4,0,4
2010-11,10,49,20.625,-85.625,5,0,5
2010-11,11,56,20.875,-83.875,0,12,12
2010-11,12,54,21.125,-84.375,0,6,6
2010-11,12,55,21.125,-84.125,0,7,7
2010-11,12,56,21.125,-83.875,0,5,5
2010-11,13,13,21.375,-94.625,0,2,2
2010-11,13,14,21.375,-94.375,0,2,2
2010-11,14,13,21.625,-94.625,0,2,2
2010-11,15,13,21.875,-94.625,0,1,1
2010-11,16,8,22.125,-95.875,10,0,10
2010-11,16,9,22.125,-95.625,14,0,14
2010-11,16,13,22.125,-94.625,0,5,5
2010-11,16,14,22.125,-94.375,0,2,2
2010-11,17,8,22.375,-95.875,1,0,1
2010-11,17,9,22.375,-95.625,5,0,5
2010-11,17,13,22.375,-94.625,0,2,2
2010-11,17,14,22.375,-94.375,0,2,2
2010-11,20,23,23.125,-92.125,2,0,2
2010-11,21,18,23.375,-93.375,9,0,9
2010-11,21,21,23.375,-92.625,2,0,2
2010-11,21,22,23.375,-92.375,1,0,1
2010-11,22,19,23.625,-93.125,7,0,7
2010-11,22,20,23.625,-92.875,4,0,4
2010-11,22,21,23.625,-92.625,1,0,1
2010-11,23,40,23.875,-87.875,0,5,5
2010-11,24,38,24.125,-88.375,0,3,3
2010-11,24,39,24.125,-88.125,0,6,6
2010-11,24,40,24.125,-87.875,0,3,3
2010-11,24,54,24.125,-84.375,0,4,4
2010-11,25,38,24.375,-88.375,0,11,11
2010-11,25,39,24.375,-88.125,0,2,2
2010-11,25,53,24.375,-84.625,0,8,8
2010-11,25,54,24.375,-84.375,0,1,1
2010-11,26,53,24.625,-84.625,0,10,10
2010-11,26,54,24.625,-84.375,0,7,7
2010-11,27,11,24.875,-95.125,1,0,1
2010-11,27,20,24.875,-92.875,0,2,2
2010-11,27,21,24.875,-92.625,0,6,6
2010-11,27,22,24.875,-92.375,0,4,4
2010-11,27,45,24.875,-86.625,8,0,8
2010-11,28,10,25.125,-95.375,7,0,7
2010-11,28,11,25.125,-95.125,22,0,22
2010-11,28,21,25.125,-92.625,0,3,3
2010-11,28,22,25.125,-92.375,0,9,9
2010-11,28,23,25.125,-92.125,0,2,2
2010-11,28,45,25.125,-86.625,6,0,6
2010-11,29,23,25.375,-92.125,0,4,4
2010-11,29,45,25.375,-86.625,6,0,6
2010-11,30,45,25.625,-86.625,10,0,10
2010-11,35,8,26.875,-95.875,0,6,6
2010-11,36,8,27.125,-95.875,0,5,5
2010-11,36,9,27.125,-95.625,0,7,7
2010-11,37,8,27.375,-95.875,0,8,8
2010-11,39,32,27.875,-89.875,0,4,4
2010-11,39,33,27.875,-89.625,0,2,2
2010-11,40,31,28.125,-90.125,0,3,3
2010-11,40,32,28.125,-89.875,0,4,4
2010-11,41,43,28.375,-87.125,0,2,2
2010-11,41,44,28.375,-86.875,0,1,1
2010-11,41,45,28.375,-86.625,0,8,8
2010-11,41,46,28.375,-86.375,0,1,1
2010-11,42,44,28.625,-86.875,0,9,9
2010-11,43,44,28.875,-86.875,0,6,6
2010-11,43,45,28.875,-86.625,0,3,3
2010-12,1,69,18.375,-80.625,3,0,3
2010-12,1,70,18.375,-80.375,1,0,1
2010-12,1,71,18.375,-80.125,1,0,1
2010-12,2,65,18.625,-81.625,1,0,1
2010-12,2,66,18.625,-81.375,1,0,1
2010-12,2,67,18.625,-81.125,2,0,2
2010-12,2,68,18.625,-80.875,2,0,2
2010-12,5,59,19.375,-83.125,1,0,1
2010-12,5,60,19.375,-82.875,3,0,3
2010-12,5,61,19.375,-82.625,3,0,3
2010-12,5,62,19.375,-82.375,3,0,3
2010-12,6,59,19.625,-83.125,8,0,8
2010-12,6,60,19.625,-82.875,4,0,4
2010-12,6,61,19.625,-82.625,1,0,1
2010-12,7,9,19.875,-95.625,2,0,2
2010-12,7,10,19.875,-95.375,6,0,6
2010-12,7,58,19.875,-83.375,5,0,5
2010-12,7,59,19.875,-83.125,3,0,3
2010-12,8,69,20.125,-80.625,0,1,1
2010-12,8,70,20.125,-80.375,0,4,4
2010-12,8,71,20.125,-80.125,0,4,4
2010-12,9,68,20.375,-80.875,0,3,3
2010-12,9,69,20.375,-80.625,0,3,3
2010-12,10,49,20.625,-85.625,1,0,1
2010-12,11,48,20.875,-85.875,4,0,4
2010-12,11,49,20.875,-85.625,3,0,3
2010-12,11,55,20.875,-84.125,0,11,11
2010-12,11,56,20.875,-83.875,0,6,6
2010-12,12,48,21.125,-85.875,3,0,3
2010-12,12,49,21.125,-85.625,1,0,1
2010-12,12,55,21.125,-84.125,0,1,1
2010-12,12,56,21.125,-83.875,0,3,3
2010-12,12,57,21.125,-83.625,0,2,2
2010-12,13,12,21.375,-94.875,0,10,10
2010-12,13,13,21.375,-94.625,0,20,20
2010-12,14,13,21.625,-94.625,0,1,1
2010-12,14,50,21.625,-85.375,1,0,1
2010-12,16,7,22.125,-96.125,1,0,1
2010-12,16,8,22.125,-95.875,2,0,2
2010-12,20,8,23.125,-95.875,2,0,2
2010-12,21,7,23.375,-96.125,1,0,1
2010-12,21,8,23.375,-95.875,1,0,1
2010-12,21,16,23.375,-93.875,2,0,2
2010-12,21,17,23.375,-93.625,3,0,3
2010-12,22,7,23.625,-96.125,2,0,2
2010-12,22,8,23.625,-95.875,4,0,4
2010-12,23,51,23.875,-85.125,0,5,5
2010-12,23,52,23.875,-84.875,0,8,8
2010-12,24,40,24.125,-87.875,0,5,5
2010-12,24,52,24.125,-84.875,0,6,6
2010-12,24,53,24.125,-84.625,0,10,10
2010-12,24,54,24.125,-84.375,0,1,1
2010-12,25,36,24.375,-88.875,0,2,2
2010-12,25,54,24.375,-84.375,0,1,1
2010-12,26,33,24.625,-89.625,0,6,6
2010-12,26,34,24.625,-89.375,0,6,6
2010-12,26,35,24.625,-89.125,0,3,3
2010-12,26,36,24.625,-88.875,0,4,4
2010-12,26,37,24.625,-88.625,0,2,2
2010-12,26,38,24.625,-88.375,0,2,2
2010-12,27,17,24.875,-93.625,0,11,11
2010-12,28,10,25.125,-95.375,3,0,3
2010-12,28,17,25.125,-93.625,0,1,1
2010-12,28,18,25.125,-93.375,0,7,7
2010-12,28,19,25.125,-93.125,0,9,9
2010-12,28,20,25.125,-92.875,0,2,2
2010-12,29,10,25.375,-95.375,10,0,10
2010-12,29,17,25.375,-93.625,0,1,1
2010-12,30,10,25.625,-95.375,5,0,5
2010-12,30,11,25.625,-95.125,1,0,1
2010-12,30,45,25.625,-86.625,28,0,28
2010-12,30,50,25.625,-85.375,3,0,3
2010-12,31,11,25.875,-95.125,3,0,3
2010-12,31,40,25.875,-87.875,3,0,3
2010-12,32,12,26.125,-94.875,9,0,9
2010-12,35,7,26.875,-96.125,0,4,4
2010-12,35,8,26.875,-95.875,0,6,6
2010-12,36,8,27.125,-95.875,0,18,18
2010-12,41,42,28.375,-87.375,0,3,3
2010-12,41,43,28.375,-87.125,0,2,2
2010-12,42,41,28.625,-87.625,0,1,1
2010-12,42,42,28.625,-87.375,0,11,11
2011-01,1,70,18.375,-80.375,3,0,3
2011-01,2,70,18.625,-80.375,1,0,1
2011-01,2,71,18.625,-80.125,3,0,3
2011-01,3,70,18.875,-80.375,3,0,3
2011-01,5,56,19.375,-83.875,1,0,1
2011-01,5,57,19.375,-83.625,3,0,3
2011-01,5,58,19.375,-83.375,2,0,2
2011-01,5,59,19.375,-83.125,1,0,1
2011-01,6,53,19.625,-84.625,2,0,2
2011-01,6,54,19.625,-84.375,2,0,2
2011-01,6,55,19.625,-84.125,3,0,3
2011-01,6,56,19.625,-83.875,1,0,1
2011-01,7,52,19.875,-84.875,5,0,5
2011-01,7,53,19.875,-84.625,1,0,1
2011-01,8,50,20.125,-85.375,5,0,5
2011-01,8,51,20.125,-85.125,4,0,4
2011-01,8,69,20.125,-80.625,0,1,1
2011-01,9,13,20.375,-94.625,0,6,6
2011-01,9,50,20.375,-85.375,1,0,1
2011-01,9,66,20.375,-81.375,0,1,1
2011-01,9,67,20.375,-81.125,0,3,3
2011-01,9,68,20.375,-80.875,0,6,6
2011-01,10,13,20.625,-94.625,0,4,4
2011-01,10,64,20.625,-81.875,0,3,3
2011-01,10,65,20.625,-81.625,0,9,9
2011-01,10,66,20.625,-81.375,0,1,1
2011-01,11,69,20.875,-80.625,0,2,2
2011-01,11,70,20.875,-80.375,0,1,1
2011-01,12,11,21.125,-95.125,0,1,1
2011-01,12,12,21.125,-94.875,0,5,5
2011-01,13,9,21.375,-95.625,0,1,1
2011-01,13,10,21.375,-95.375,0,5,5
2011-01,13,11,21.375,-95.125,0,3,3
2011-01,14,7,21.625,-96.125,0,3,3
2011-01,14,8,21.625,-95.875,0,4,4
2011-01,14,9,21.625,-95.625,0,1,1
2011-01,15,6,21.875,-96.375,0,4,4
2011-01,15,7,21.875,-96.125,0,4,4
2011-01,20,19,23.125,-93.125,2,0,2
2011-01,20,20,23.125,-92.875,1,0,1
2011-01,21,6,23.375,-96.375,1,0,1
2011-01,21,7,23.375,-96.125,4,0,4
2011-01,21,20,23.375,-92.875,5,0,5
2011-01,21,21,23.375,-92.625,5,0,5
2011-01,21,22,23.375,-92.375,4,0,4
2011-01,22,6,23.625,-96.375,17,0,17
2011-01,22,7,23.625,-96.125,2,0,2
2011-01,22,22,23.625,-92.375,3,0,3
2011-01,22,23,23.625,-92.125,7,0,7
2011-01,22,54,23.625,-84.375,0,3,3
2011-01,22,55,23.625,-84.125,0,4,4
2011-01,22,56,23.625,-83.875,0,4,4
2011-01,22,57,23.625,-83.625,0,2,2
2011-01,23,6,23.875,-96.375,4,0,4
2011-01,23,50,23.875,-85.375,0,5,5
2011-01,23,51,23.875,-85.125,0,5,5
2011-01,23,53,23.875,-84.625,0,4,4
2011-01,23,54,23.875,-84.375,0,1,1
2011-01,24,7,24.125,-96.125,2,0,2
2011-01,25,27,24.375,-91.125,0,2,2
2011-01,25,28,24.375,-90.875,0,4,4
2011-01,25,29,24.375,-90.625,0,7,7
2011-01,25,30,24.375,-90.375,0,6,6
2011-01,25,31,24.375,-90.125,0,7,7
2011-01,25,32,24.375,-89.875,0,1,1
2011-01,26,32,24.625,-89.875,0,4,4
2011-01,26,51,24.625,-85.125,3,0,3
2011-01,27,17,24.875,-93.625,0,6,6
2011-01,27,50,24.875,-85.375,3,0,3
2011-01,27,51,24.875,-85.125,6,0,6
2011-01,28,17,25.125,-93.625,0,11,11
2011-01,28,50,25.125,-85.375,6,0,6
2011-01,29,17,25.375,-93.625,0,13,13
2011-01,29,50,25.375,-85.375,6,0,6
2011-01,30,17,25.625,-93.625,0,1,1
2011-01,30,37,25.625,-88.625,2,0,2
2011-01,30,38,25.625,-88.375,4,0,4
2011-01,30,50,25.625,-85.375,3,0,3
2011-01,30,51,25.625,-85.125,4,0,4
2011-01,31,37,25.875,-88.625,7,0,7
2011-01,31,38,25.875,-88.375,7,0,7
2011-01,31,39,25.875,-88.125,1,0,1
2011-01,31,45,25.875,-86.625,0,9,9
2011-01,32,12,26.125,-94.875,1,0,1
2011-01,32,13,26.125,-94.625,3,0,3
2011-01,32,37,26.125,-88.625,5,0,5
2011-01,32,39,26.125,-88.125,2,0,2
2011-01,33,13,26.375,-94.625,22,0,22
2011-01,33,14,26.375,-94.375,5,0,5
2011-01,33,37,26.375,-88.625,3,0,3
2011-01,36,7,27.125,-96.125,0,4,4
2011-01,40,42,28.125,-87.375,0,1,1
2011-01,41,42,28.375,-87.375,0,10,10
2011-02,0,51,18.125,-85.125,0,2,2
2011-02,0,52,18.125,-84.875,0,3,3
2011-02,1,49,18.375,-85.625,0,2,2
2011-02,1,50,18.375,-85.375,0,1,1
2011-02,2,47,18.625,-86.125,0,4,4
2011-02,2,48,18.625,-85.875,0,3,3
2011-02,2,49,18.625,-85.625,0,1,1
2011-02,3,47,18.875,-86.125,0,1,1
2011-02,3,69,18.875,-80.625,4,0,4
2011-02,4,68,19.125,-80.875,4,0,4
2011-02,4,69,19.125,-80.625,3,0,3
2011-02,5,67,19.375,-81.125,1,0,1
2011-02,5,68,19.375,-80.875,6,0,6
2011-02,8,51,20.125,-85.125,3,0,3
2011-02,9,12,20.375,-94.875,0,2,2
2011-02,9,13,20.375,-94.625,0,12,12
2011-02,9,51,20.375,-85.125,8,0,8
2011-02,9,52,20.375,-84.875,6,0,6
2011-02,10,13,20.625,-94.625,0,14,14
2011-02,10,50,20.625,-85.375,1,0,1
2011-02,10,51,20.625,-85.125,10,0,10
2011-02,10,61,20.625,-82.625,0,1,1
2011-02,10,62,20.625,-82.375,0,3,3
2011-02,10,65,20.625,-81.625,0,1,1
2011-02,10,66,20.625,-81.375,0,2,2
2011-02,10,67,20.625,-81.125,0,3,3
2011-02,10,68,20.625,-80.875,0,3,3
2011-02,11,62,20.875,-82.375,0,9,9
2011-02,11,63,20.875,-82.125,0,1,1
2011-02,11,68,20.875,-80.875,0,1,1
2011-02,11,69,20.875,-80.625,0,1,1
2011-02,15,6,21.875,-96.375,0,2,2
2011-02,16,6,22.125,-96.375,0,3,3
2011-02,17,6,22.375,-96.375,0,3,3
2011-02,18,6,22.625,-96.375,0,1,1
2011-02,19,6,22.875,-96.375,0,2,2
2011-02,20,6,23.125,-96.375,0,4,4
2011-02,20,18,23.125,-93.375,1,0,1
2011-02,20,19,23.125,-93.125,12,0,12
2011-02,21,6,23.375,-96.375,0,1,1
2011-02,21,18,23.375,-93.375,13,0,13
2011-02,21,19,23.375,-93.125,2,0,2
2011-02,22,57,23.625,-83.625,0,5,5
2011-02,22,58,23.625,-83.375,0,9,9
2011-02,22,59,23.625,-83.125,0,6,6
2011-02,23,9,23.875,-95.625,0,2,2
2011-02,23,59,23.875,-83.125,0,5,5
2011-02,24,7,24.125,-96.125,2,0,2
2011-02,24,8,24.125,-95.875,0,1,1
2011-02,24,9,24.125,-95.625,0,6,6
2011-02,24,10,24.125,-95.375,0,1,1
2011-02,24,11,24.125,-95.125,0,1,1
2011-02,24,25,24.125,-91.625,0,5,5
2011-02,24,51,24.125,-85.125,6,0,6
2011-02,24,52,24.125,-84.875,2,0,2
2011-02,25,6,24.375,-96.375,5,0,5
2011-02,25,12,24.375,-94.875,0,2,2
2011-02,25,25,24.375,-91.625,0,4,4
2011-02,25,26,24.375,-91.375,0,14,14
2011-02,25,27,24.375,-91.125,0,5,5
2011-02,25,51,24.375,-85.125,10,0,10
2011-02,26,6,24.625,-96.375,1,0,1
2011-02,26,14,24.625,-94.375,0,1,1
2011-02,26,51,24.625,-85.125,10,0,10
2011-02,27,15,24.875,-94.125,0,6,6
2011-02,27,16,24.875,-93.875,0,4,4
2011-02,28,7,25.125,-96.125,1,0,1
2011-02,29,7,25.375,-96.125,1,0,1
2011-02,29,8,25.375,-95.875,7,0,7
2011-02,29,9,25.375,-95.625,5,0,5
2011-02,29,17,25.375,-93.625,0,3,3
2011-02,31,44,25.875,-86.875,0,7,7
2011-02,31,45,25.875,-86.625,0,20,20
2011-02,32,45,26.125,-86.625,0,1,1
2011-02,33,14,26.375,-94.375,7,0,7
2011-02,33,15,26.375,-94.125,2,0,2
2011-02,33,34,26.375,-89.375,13,0,13
2011-02,33,35,26.375,-89.125,7,0,7
2011-02,33,36,26.375,-88.875,8,0,8
2011-02,34,14,26.625,-94.375,7,0,7
2011-02,34,15,26.625,-94.125,10,0,10
2011-02,35,14,26.875,-94.375,2,0,2
2011-02,35,20,26.875,-92.875,0,11,11
2011-02,36,19,27.125,-93.125,0,6,6
2011-02,36,20,27.125,-92.875,0,5,5
2011-02,41,39,28.375,-88.125,0,2,2
2011-02,41,40,28.375,-87.875,0,3,3
2011-02,41,41,28.375,-87.625,0,7,7
2011-02,41,42,28.375,-87.375,0,1,1
2011-02,42,39,28.625,-88.125,0,6,6
2011-02,42,40,28.625,-87.875,0,6,6
2011-02,42,41,28.625,-87.625,0,1,1
2011-03,0,57,18.125,-83.625,2,0,2
2011-03,1,45,18.375,-86.625,0,5,5
2011-03,1,46,18.375,-86.375,0,8,8
2011-03,1,47,18.375,-86.125,0,1,1
2011-03,1,48,18.375,-85.875,0,3,3
2011-03,1,53,18.375,-84.625,1,0,1
2011-03,1,54,18.375,-84.375,5,0,5
2011-03,1,57,18.375,-83.625,2,0,2
2011-03,2,46,18.625,-86.375,0,3,3
2011-03,2,47,18.625,-86.125,0,3,3
2011-03,2,48,18.625,-85.875,0,3,3
2011-03,2,49,18.625,-85.625,0,4,4
2011-03,2,50,18.625,-85.375,0,1,1
2011-03,2,54,18.625,-84.375,1,0,1
2011-03,2,55,18.625,-84.125,4,0,4
2011-03,2,56,18.625,-83.875,2,0,2
2011-03,2,57,18.625,-83.625,1,0,1
2011-03,5,68,19.375,-80.875,4,0,4
2011-03,5,69,19.375,-80.625,14,0,14
2011-03,5,70,19.375,-80.375,2,0,2
2011-03,5,71,19.375,-80.125,7,0,7
2011-03,6,68,19.625,-80.875,2,0,2
2011-03,8,10,20.125,-95.375,0,6,6
2011-03,8,11,20.125,-95.125,0,15,15
2011-03,8,12,20.125,-94.875,0,7,7
2011-03,8,52,20.125,-84.875,6,0,6
2011-03,8,57,20.125,-83.625,0,4,4
2011-03,8,58,20.125,-83.375,0,1,1
2011-03,9,12,20.375,-94.875,0,2,2
2011-03,9,52,20.375,-84.875,2,0,2
2011-03,9,56,20.375,-83.875,0,5,5
2011-03,9,57,20.375,-83.625,0,1,1
2011-03,9,58,20.375,-83.375,0,3,3
2011-03,9,59,20.375,-83.125,0,2,2
2011-03,9,60,20.375,-82.875,0,2,2
2011-03,9,61,20.375,-82.625,0,1,1
2011-03,10,51,20.625,-85.125,5,0,5
2011-03,10,56,20.625,-83.875,0,2,2
2011-03,10,61,20.625,-82.625,0,2,2
2011-03,10,62,20.625,-82.375,0,3,3
2011-03,11,51,20.875,-85.125,1,0,1
2011-03,11,57,20.875,-83.625,0,1,1
2011-03,11,58,20.875,-83.375,0,1,1
2011-03,12,19,21.125,-93.125,0,2,2
2011-03,12,20,21.125,-92.875,0,6,6
2011-03,12,21,21.125,-92.625,0,2,2
2011-03,12,52,21.125,-84.875,1,0,1
2011-03,13,8,21.375,-95.875,8,0,8
2011-03,13,19,21.375,-93.125,0,4,4
2011-03,14,8,21.625,-95.875,2,0,2
2011-03,20,16,23.125,-93.875,1,0,1
2011-03,20,17,23.125,-93.625,1,0,1
2011-03,21,16,23.375,-93.875,5,0,5
2011-03,21,17,23.375,-93.625,14,0,14
2011-03,21,18,23.375,-93.375,10,0,10
2011-03,22,56,23.625,-83.875,3,0,3
2011-03,23,7,23.875,-96.125,0,11,11
2011-03,23,8,23.875,-95.875,0,3,3
2011-03,23,22,23.875,-92.375,0,3,3
2011-03,23,59,23.875,-83.125,0,6,6
2011-03,23,60,23.875,-82.875,0,5,5
2011-03,23,61,23.875,-82.625,0,2,2
2011-03,23,62,23.875,-82.375,0,5,5
2011-03,23,63,23.875,-82.125,0,3,3
2011-03,23,64,23.875,-81.875,0,3,3
2011-03,23,65,23.875,-81.625,0,5,5
2011-03,23,66,23.875,-81.375,0,2,2
2011-03,24,7,24.125,-96.125,0,13,13
2011-03,24,8,24.125,-95.875,0,4,4
2011-03,24,22,24.125,-92.375,0,1,1
2011-03,24,23,24.125,-92.125,0,10,10
2011-03,24,24,24.125,-91.875,0,14,14
2011-03,24,25,24.125,-91.625,0,3,3
2011-03,24,52,24.125,-84.875,6,0,6
2011-03,24,53,24.125,-84.625,2,0,2
2011-03,25,53,24.375,-84.625,10,0,10
2011-03,26,53,24.625,-84.625,3,0,3
2011-03,27,53,24.875,-84.625,1,0,1
2011-03,29,9,25.375,-95.625,5,0,5
2011-03,29,10,25.375,-95.375,4,0,4
2011-03,30,12,25.625,-94.875,2,0,2
2011-03,30,13,25.625,-94.625,17,0,17
2011-03,30,14,25.625,-94.375,3,0,3
2011-03,31,43,25.875,-87.125,0,14,14
2011-03,32,20,26.125,-92.875,0,1,1
2011-03,32,32,26.125,-89.875,9,0,9
2011-03,32,33,26.125,-89.625,1,0,1
2011-03,32,43,26.125,-87.125,0,8,8
2011-03,33,32,26.375,-89.875,7,0,7
2011-03,33,33,26.375,-89.625,7,0,7
2011-03,33,34,26.375,-89.375,1,0,1
2011-03,33,43,26.375,-87.125,0,9,9
2011-03,34,20,26.625,-92.875,0,3,3
2011-03,34,34,26.625,-89.375,6,0,6
2011-03,35,10,26.875,-95.375,6,0,6
2011-03,35,13,26.875,-94.625,6,0,6
2011-03,35,14,26.875,-94.375,3,0,3
2011-03,35,19,26.875,-93.125,0,2,2
2011-03,35,20,26.875,-92.875,0,2,2
2011-03,35,21,26.875,-92.625,0,3,3
2011-03,36,10,27.125,-95.375,10,0,10
2011-03,36,11,27.125,-95.125,5,0,5
2011-03,36,19,27.125,-93.125,0,5,5
2011-03,42,38,28.625,-88.375,0,6,6
2011-03,42,39,28.625,-88.125,0,1,1
2011-04,0,45,18.125,-86.625,0,8,8
2011-04,0,51,18.125,-85.125,3,0,3
2011-04,0,52,18.125,-84.875,4,0,4
2011-04,1,44,18.375,-86.875,0,2,2
2011-04,1,52,18.375,-84.875,6,0,6
2011-04,1,53,18.375,-84.625,15,0,15
2011-04,2,53,18.625,-84.625,2,0,2
2011-04,5,71,19.375,-80.125,2,0,2
2011-04,6,70,19.625,-80.375,10,0,10
2011-04,6,71,19.625,-80.125,3,0,3
2011-04,7,57,19.875,-83.625,0,1,1
2011-04,7,68,19.875,-80.875,1,0,1
2011-04,7,69,19.875,-80.625,3,0,3
2011-04,8,9,20.125,-95.625,0,1,1
2011-04,8,10,20.125,-95.375,0,16,16
2011-04,8,56,20.125,-83.875,0,2,2
2011-04,9,9,20.375,-95.625,0,4,4
2011-04,9,10,20.375,-95.375,0,2,2
2011-04,9,53,20.375,-84.625,0,3,3
2011-04,9,54,20.375,-84.375,0,2,2
2011-04,9,55,20.375,-84.125,0,10,10
2011-04,10,8,20.625,-95.875,0,2,2
2011-04,10,54,20.625,-84.375,0,8,8
2011-04,11,18,20.875,-93.375,0,2,2
2011-04,12,18,21.125,-93.375,0,3,3
2011-04,12,19,21.125,-93.125,0,2,2
2011-04,13,8,21.375,-95.875,5,0,5
2011-04,13,19,21.375,-93.125,0,7,7
2011-04,13,20,21.375,-92.875,0,4,4
2011-04,14,8,21.625,-95.875,5,0,5
2011-04,14,9,21.625,-95.625,4,0,4
2011-04,14,19,21.625,-93.125,0,6,6
2011-04,15,8,21.875,-95.875,16,0,16
2011-04,21,15,23.375,-94.125,8,0,8
2011-04,21,21,23.375,-92.625,0,1,1
2011-04,21,22,23.375,-92.375,0,8,8
2011-04,21,23,23.375,-92.125,0,4,4
2011-04,22,15,23.625,-94.125,3,0,3
2011-04,22,16,23.625,-93.875,2,0,2
2011-04,22,21,23.625,-92.625,0,7,7
2011-04,22,23,23.625,-92.125,0,3,3
2011-04,23,22,23.875,-92.375,0,7,7
2011-04,23,39,23.875,-88.125,3,0,3
2011-04,23,40,23.875,-87.875,1,0,1
2011-04,23,66,23.875,-81.375,0,2,2
2011-04,24,7,24.125,-96.125,0,14,14
2011-04,24,68,24.125,-80.875,0,6,6
2011-04,24,69,24.125,-80.625,0,1,1
2011-04,25,7,24.375,-96.125,0,4,4
2011-04,25,8,24.375,-95.875,0,12,12
2011-04,25,15,24.375,-94.125,4,0,4
2011-04,26,15,24.625,-94.125,3,0,3
2011-04,26,50,24.625,-85.375,6,0,6
2011-04,26,51,24.625,-85.125,7,0,7
2011-04,27,52,24.875,-84.875,15,0,15
2011-04,28,25,25.125,-91.625,4,0,4
2011-04,28,52,25.125,-84.875,2,0,2
2011-04,29,14,25.375,-94.375,4,0,4
2011-04,29,24,25.375,-91.875,4,0,4
2011-04,29,25,25.375,-91.625,5,0,5
2011-04,30,14,25.625,-94.375,5,0,5
2011-04,31,13,25.875,-94.625,5,0,5
2011-04,31,14,25.875,-94.375,9,0,9
2011-04,32,41,26.125,-87.625,0,1,1
2011-04,32,42,26.125,-87.375,0,6,6
2011-04,33,20,26.375,-92.875,0,5,5
2011-04,33,33,26.375,-89.625,7,0,7
2011-04,33,42,26.375,-87.375,0,2,2
2011-04,33,43,26.375,-87.125,0,21,21
2011-04,34,19,26.625,-93.125,0,12,12
2011-04,34,20,26.625,-92.875,0,3,3
2011-04,34,33,26.625,-89.625,8,0,8
2011-04,34,34,26.625,-89.375,6,0,6
2011-04,35,19,26.875,-93.125,0,10,10
2011-04,35,32,26.875,-89.875,3,0,3
2011-04,35,33,26.875,-89.625,6,0,6
2011-04,36,50,27.125,-85.375,1,0,1
2011-04,37,49,27.375,-85.625,1,0,1
2011-04,40,49,28.125,-85.625,4,0,4
2011-04,41,48,28.375,-85.875,3,0,3
2011-05,0,71,18.125,-80.125,0,1,1
2011-05,1,70,18.375,-80.375,0,2,2
2011-05,1,71,18.375,-80.125,0,3,3
2011-05,2,59,18.625,-83.125,0,2,2
2011-05,2,60,18.625,-82.875,0,2,2
2011-05,2,61,18.625,-82.625,0,1,1
2011-05,2,62,18.625,-82.375,0,1,1
2011-05,2,63,18.625,-82.125,0,2,2
2011-05,2,64,18.625,-81.875,0,1,1
2011-05,2,69,18.625,-80.625,0,4,4
2011-05,2,70,18.625,-80.375,0,2,2
2011-05,2,71,18.625,-80.125,0,1,1
2011-05,3,57,18.875,-83.625,0,2,2
2011-05,3,58,18.875,-83.375,0,3,3
2011-05,10,16,20.625,-93.875,0,3,3
2011-05,10,17,20.625,-93.625,0,2,2
2011-05,11,16,20.875,-93.875,0,4,4
2011-05,12,17,21.125,-93.625,0,5,5
2011-05,15,7,21.875,-96.125,1,0,1
2011-05,15,8,21.875,-95.875,14,0,14
2011-05,20,22,23.125,-92.375,0,6,6
2011-05,20,23,23.125,-92.125,0,2,2
2011-05,21,20,23.375,-92.875,0,2,2
2011-05,21,21,23.375,-92.625,0,10,10
2011-05,21,22,23.375,-92.375,0,4,4
2011-05,21,23,23.375,-92.125,0,1,1
2011-05,22,21,23.625,-92.625,0,4,4
2011-05,22,23,23.625,-92.125,0,1,1
2011-05,22,24,23.625,-91.875,0,1,1
2011-05,22,32,23.625,-89.875,0,1,1
2011-05,22,38,23.625,-88.375,1,0,1
2011-05,22,54,23.625,-84.375,3,0,3
2011-05,22,55,23.625,-84.125,4,0,4
2011-05,22,56,23.625,-83.875,3,0,3
2011-05,23,11,23.875,-95.125,2,0,2
2011-05,23,12,23.875,-94.875,6,0,6
2011-05,23,32,23.875,-89.875,0,4,4
2011-05,23,33,23.875,-89.625,0,1,1
2011-05,23,38,23.875,-88.375,1,0,1
2011-05,23,39,23.875,-88.125,8,0,8
2011-05,23,40,23.875,-87.875,5,0,5
2011-05,23,53,23.875,-84.625,4,0,4
2011-05,24,13,24.125,-94.625,5,0,5
2011-05,24,14,24.125,-94.375,9,0,9
2011-05,24,15,24.125,-94.125,5,0,5
2011-05,24,51,24.125,-85.125,1,0,1
2011-05,24,52,24.125,-84.875,4,0,4
2011-05,24,53,24.125,-84.625,1,0,1
2011-05,25,15,24.375,-94.125,4,0,4
2011-05,25,35,24.375,-89.125,3,0,3
2011-05,25,36,24.375,-88.875,8,0,8
2011-05,25,50,24.375,-85.375,2,0,2
2011-05,25,51,24.375,-85.125,3,0,3
2011-05,26,8,24.625,-95.875,0,12,12
2011-05,26,34,24.625,-89.375,1,0,1
2011-05,26,35,24.625,-89.125,2,0,2
2011-05,27,8,24.875,-95.875,0,4,4
2011-05,27,9,24.875,-95.625,0,2,2
2011-05,28,9,25.125,-95.625,0,11,11
2011-05,28,10,25.125,-95.375,0,2,2
2011-05,28,25,25.125,-91.625,1,0,1
2011-05,28,26,25.125,-91.375,7,0,7
2011-05,28,27,25.125,-91.125,1,0,1
2011-05,29,24,25.375,-91.875,11,0,11
2011-05,29,25,25.375,-91.625,9,0,9
2011-05,29,26,25.375,-91.375,1,0,1
2011-05,29,27,25.375,-91.125,1,0,1
2011-05,31,48,25.875,-85.875,1,0,1
2011-05,31,49,25.875,-85.625,2,0,2
2011-05,31,50,25.875,-85.375,3,0,3
2011-05,32,40,26.125,-87.875,0,6,6
2011-05,32,41,26.125,-87.625,0,5,5
2011-05,32,48,26.125,-85.875,8,0,8
2011-05,32,49,26.125,-85.625,3,0,3
2011-05,33,39,26.375,-88.125,0,18,18
2011-05,33,40,26.375,-87.875,0,2,2
2011-05,33,49,26.375,-85.625,3,0,3
2011-05,33,50,26.375,-85.375,3,0,3
2011-05,34,18,26.625,-93.375,0,1,1
2011-05,34,19,26.625,-93.125,0,1,1
2011-05,34,20,26.625,-92.875,0,1,1
2011-05,34,31,26.625,-90.125,1,0,1
2011-05,34,50,26.625,-85.375,1,0,1
2011-05,34,51,26.625,-85.125,3,0,3
2011-05,35,19,26.875,-93.125,0,23,23
2011-05,35,20,26.875,-92.875,0,5,5
2011-05,35,31,26.875,-90.125,13,0,13
2011-05,35,51,26.875,-85.125,3,0,3
2011-05,36,31,27.125,-90.125,5,0,5
2011-05,36,32,27.125,-89.875,2,0,2
2011-05,37,31,27.375,-90.125,2,0,2
2011-05,38,33,27.625,-89.625,2,0,2
2011-05,39,33,27.875,-89.625,4,0,4
2011-05,39,34,27.875,-89.375,1,0,1
2011-05,40,34,28.125,-89.375,1,0,1
2011-06,0,56,18.125,-83.875,0,2,2
2011-06,0,57,18.125,-83.625,0,5,5
2011-06,3,51,18.875,-85.125,0,4,4
2011-06,3,52,18.875,-84.875,0,2,2
2011-06,3,53,18.875,-84.625,0,2,2
2011-06,3,54,18.875,-84.375,0,3,3
2011-06,3,55,18.875,-84.125,0,3,3
2011-06,3,56,18.875,-83.875,0,2,2
2011-06,3,57,18.875,-83.625,0,1,1
2011-06,4,50,19.125,-85.375,0,2,2
2011-06,5,48,19.375,-85.875,0,2,2
2011-06,5,71,19.375,-80.125,4,0,4
2011-06,6,48,19.625,-85.875,0,3,3
2011-06,6,54,19.625,-84.375,5,0,5
2011-06,6,55,19.625,-84.125,1,0,1
2011-06,6,71,19.625,-80.125,10,0,10
2011-06,7,48,19.875,-85.875,0,3,3
2011-06,8,48,20.125,-85.875,0,1,1
2011-06,8,49,20.125,-85.625,0,2,2
2011-06,8,56,20.125,-83.875,7,0,7
2011-06,8,57,20.125,-83.625,7,0,7
2011-06,9,20,20.375,-92.875,0,2,2
2011-06,9,57,20.375,-83.625,4,0,4
2011-06,9,58,20.375,-83.375,1,0,1
2011-06,10,17,20.625,-93.625,0,9,9
2011-06,10,18,20.625,-93.375,0,4,4
2011-06,10,19,20.625,-93.125,0,1,1
2011-06,10,20,20.625,-92.875,0,1,1
2011-06,11,16,20.875,-93.875,0,1,1
2011-06,11,17,20.875,-93.625,0,10,10
2011-06,11,18,20.875,-93.375,0,2,2
2011-06,13,57,21.375,-83.625,6,0,6
2011-06,16,11,22.125,-95.125,1,0,1
2011-06,17,13,22.375,-94.625,5,0,5
2011-06,18,13,22.625,-94.625,4,0,4
2011-06,20,18,23.125,-93.375,0,2,2
2011-06,20,19,23.125,-93.125,0,15,15
2011-06,20,20,23.125,-92.875,0,4,4
2011-06,21,18,23.375,-93.375,0,1,1
2011-06,21,20,23.375,-92.875,0,2,2
2011-06,22,52,23.625,-84.875,0,1,1
2011-06,22,53,23.625,-84.625,0,1,1
2011-06,22,54,23.625,-84.375,0,4,4
2011-06,22,55,23.625,-84.125,0,5,5
2011-06,22,56,23.625,-83.875,0,4,4
2011-06,23,6,23.875,-96.375,3,0,3
2011-06,23,7,23.875,-96.125,9,0,9
2011-06,23,8,23.875,-95.875,1,0,1
2011-06,23,9,23.875,-95.625,3,0,3
2011-06,23,10,23.875,-95.375,4,0,4
2011-06,23,11,23.875,-95.125,3,0,3
2011-06,23,30,23.875,-90.375,0,17,17
2011-06,23,31,23.875,-90.125,0,11,11
2011-06,23,32,23.875,-89.875,0,1,1
2011-06,23,51,23.875,-85.125,0,2,2
2011-06,23,52,23.875,-84.875,0,4,4
2011-06,23,53,23.875,-84.625,0,3,3
2011-06,23,64,23.875,-81.875,5,0,5
2011-06,23,65,23.875,-81.625,3,0,3
2011-06,26,9,24.625,-95.625,0,4,4
2011-06,27,9,24.875,-95.625,0,20,20
2011-06,27,50,24.875,-85.375,6,0,6
2011-06,28,49,25.125,-85.625,2,0,2
2011-06,28,50,25.125,-85.375,4,0,4
2011-06,29,14,25.375,-94.375,1,0,1
2011-06,29,50,25.375,-85.375,4,0,4
2011-06,30,12,25.625,-94.875,2,0,2
2011-06,30,13,25.625,-94.625,2,0,2
2011-06,30,50,25.625,-85.375,2,0,2
2011-06,31,11,25.875,-95.125,4,0,4
2011-06,31,39,25.875,-88.125,0,11,11
2011-06,31,50,25.875,-85.375,4,0,4
2011-06,31,51,25.875,-85.125,8,0,8
2011-06,32,39,26.125,-88.125,0,3,3
2011-06,32,40,26.125,-87.875,0,9,9
2011-06,33,19,26.375,-93.125,0,5,5
2011-06,33,20,26.375,-92.875,0,13,13
2011-06,33,39,26.375,-88.125,0,7,7
2011-06,34,19,26.625,-93.125,0,7,7
2011-06,34,20,26.625,-92.875,0,5,5
2011-06,37,8,27.375,-95.875,0,8,8
2011-06,38,8,27.625,-95.875,0,5,5
2011-06,38,9,27.625,-95.625,0,6,6
2011-06,38,10,27.625,-95.375,0,3,3
2011-06,38,11,27.625,-95.125,0,3,3
2011-06,38,12,27.625,-94.875,0,1,1
2011-06,39,39,27.875,-88.125,1,0,1
2011-06,39,40,27.875,-87.875,1,0,1
2011-06,39,41,27.875,-87.625,1,0,1
2011-06,40,34,28.125,-89.375,6,0,6
2011-06,40,35,28.125,-89.125,7,0,7
2011-07,0,49,18.125,-85.625,0,2,2
2011-07,0,50,18.125,-85.375,0,3,3
2011-07,0,51,18.125,-85.125,0,4,4
2011-07,0,52,18.125,-84.875,0,1,1
2011-07,0,54,18.125,-84.375,0,3,3
2011-07,0,55,18.125,-84.125,0,3,3
2011-07,0,56,18.125,-83.875,2,1,3
2011-07,0,59,18.125,-83.125,2,0,2
2011-07,0,60,18.125,-82.875,2,0,2
2011-07,0,61,18.125,-82.625,3,0,3
2011-07,0,62,18.125,-82.375,2,0,2
2011-07,1,53,18.375,-84.625,0,3,3
2011-07,1,54,18.375,-84.375,0,1,1
2011-07,4,60,19.125,-82.875,0,1,1
2011-07,4,61,19.125,-82.625,0,1,1
2011-07,5,59,19.375,-83.125,0,2,2
2011-07,5,60,19.375,-82.875,0,2,2
2011-07,6,52,19.625,-84.875,4,0,4
2011-07,6,53,19.625,-84.625,6,0,6
2011-07,6,61,19.625,-82.625,0,1,1
2011-07,6,71,19.625,-80.125,3,0,3
2011-07,7,51,19.875,-85.125,2,0,2
2011-07,7,52,19.875,-84.875,3,0,3
2011-07,7,69,19.875,-80.625,1,0,1
2011-07,7,70,19.875,-80.375,3,0,3
2011-07,7,71,19.875,-80.125,4,0,4
2011-07,8,48,20.125,-85.875,0,2,2
2011-07,8,49,20.125,-85.625,4,6,10
2011-07,8,50,20.125,-85.375,3,0,3
2011-07,8,68,20.125,-80.875,2,0,2
2011-07,8,69,20.125,-80.625,1,0,1
2011-07,9,20,20.375,-92.875,0,1,1
2011-07,9,48,20.375,-85.875,1,1,2
2011-07,9,49,20.375,-85.625,3,2,5
2011-07,10,20,20.625,-92.875,0,4,4
2011-07,10,21,20.625,-92.625,0,2,2
2011-07,10,48,20.625,-85.875,1,1,2
2011-07,10,49,20.625,-85.625,0,1,1
2011-07,12,19,21.125,-93.125,0,6,6
2011-07,12,20,21.125,-92.875,0,1,1
2011-07,12,55,21.125,-84.125,2,0,2
2011-07,12,56,21.125,-83.875,18,0,18
2011-07,12,57,21.125,-83.625,3,0,3
2011-07,13,18,21.375,-93.375,0,16,16
2011-07,13,55,21.375,-84.125,3,0,3
2011-07,13,57,21.375,-83.625,3,0,3
2011-07,15,12,21.875,-94.875,1,0,1
2011-07,16,10,22.125,-95.375,1,0,1
2011-07,16,11,22.125,-95.125,14,0,14
2011-07,16,12,22.125,-94.875,2,0,2
2011-07,17,11,22.375,-95.125,1,0,1
2011-07,17,12,22.375,-94.875,2,0,2
2011-07,17,13,22.375,-94.625,2,0,2
2011-07,17,46,22.375,-86.375,1,0,1
2011-07,17,52,22.375,-84.875,0,1,1
2011-07,18,46,22.625,-86.375,8,0,8
2011-07,18,51,22.625,-85.125,0,2,2
2011-07,19,45,22.875,-86.625,1,0,1
2011-07,19,46,22.875,-86.375,2,0,2
2011-07,19,51,22.875,-85.125,0,3,3
2011-07,20,19,23.125,-93.125,2,0,2
2011-07,20,20,23.125,-92.875,3,0,3
2011-07,20,45,23.125,-86.625,2,0,2
2011-07,21,27,23.375,-91.125,0,3,3
2011-07,21,28,23.375,-90.875,0,16,16
2011-07,21,45,23.375,-86.625,3,0,3
2011-07,22,28,23.625,-90.875,0,5,5
2011-07,22,29,23.625,-90.625,0,4,4
2011-07,22,44,23.625,-86.875,2,0,2
2011-07,22,45,23.625,-86.625,2,0,2
2011-07,22,50,23.625,-85.375,0,4,4
2011-07,22,51,23.625,-85.125,0,1,1
2011-07,22,56,23.625,-83.875,0,2,2
2011-07,22,57,23.625,-83.625,0,4,4
2011-07,23,30,23.875,-90.375,0,3,3
2011-07,23,44,23.875,-86.875,5,0,5
2011-07,23,50,23.875,-85.375,0,2,2
2011-07,23,51,23.875,-85.125,0,1,1
2011-07,23,57,23.875,-83.625,0,1,1
2011-07,23,58,23.875,-83.375,0,5,5
2011-07,23,59,23.875,-83.125,0,5,5
2011-07,23,60,23.875,-82.875,0,1,1
2011-07,23,65,23.875,-81.625,2,0,2
2011-07,24,66,24.125,-81.375,8,0,8
2011-07,24,67,24.125,-81.125,2,0,2
2011-07,24,69,24.125,-80.625,1,0,1
2011-07,25,68,24.375,-80.875,1,0,1
2011-07,25,69,24.375,-80.625,3,0,3
2011-07,25,70,24.375,-80.375,3,0,3
2011-07,26,51,24.625,-85.125,1,0,1
2011-07,27,50,24.875,-85.375,2,0,2
2011-07,27,51,24.875,-85.125,2,0,2
2011-07,29,26,25.375,-91.375,1,0,1
2011-07,29,27,25.375,-91.125,1,0,1
2011-07,29,28,25.375,-90.875,2,0,2
2011-07,30,16,25.625,-93.875,0,10,10
2011-07,30,17,25.625,-93.625,0,9,9
2011-07,30,25,25.625,-91.625,2,0,2
2011-07,30,26,25.625,-91.375,2,0,2
2011-07,30,27,25.625,-91.125,1,0,1
2011-07,30,51,25.625,-85.125,1,0,1
2011-07,31,10,25.875,-95.375,1,0,1
2011-07,31,11,25.875,-95.125,10,0,10
2011-07,31,12,25.875,-94.875,2,0,2
2011-07,31,17,25.875,-93.625,0,2,2
2011-07,31,18,25.875,-93.375,0,1,1
2011-07,31,25,25.875,-91.625,4,0,4
2011-07,31,38,25.875,-88.375,0,3,3
2011-07,31,51,25.875,-85.125,3,0,3
2011-07,32,12,26.125,-94.875,18,0,18
2011-07,32,19,26.125,-93.125,0,7,7
2011-07,32,37,26.125,-88.625,0,3,3
2011-07,32,38,26.125,-88.375,0,3,3
2011-07,33,19,26.375,-93.125,0,2,2
2011-07,33,35,26.375,-89.125,0,5,5
2011-07,33,36,26.375,-88.875,0,9,9
2011-07,33,37,26.375,-88.625,0,5,5
2011-07,34,35,26.625,-89.125,0,3,3
2011-07,35,8,26.875,-95.875,0,9,9
2011-07,36,8,27.125,-95.875,0,10,10
2011-07,36,9,27.125,-95.625,0,3,3
2011-07,36,10,27.125,-95.375,0,3,3
2011-07,37,10,27.375,-95.375,0,1,1
2011-07,37,11,27.375,-95.125,0,1,1
2011-07,38,12,27.625,-94.875,0,3,3
2011-08,0,47,18.125,-86.125,0,5,5
2011-08,5,58,19.375,-83.375,0,2,2
2011-08,5,59,19.375,-83.125,0,1,1
2011-08,6,53,19.625,-84.625,0,3,3
2011-08,6,54,19.625,-84.375,0,5,5
2011-08,6,55,19.625,-84.125,0,3,3
2011-08,6,57,19.625,-83.625,0,2,2
2011-08,6,58,19.625,-83.375,0,1,1
2011-08,6,62,19.625,-82.375,2,0,2
2011-08,6,64,19.625,-81.875,5,0,5
2011-08,6,65,19.625,-81.625,1,0,1
2011-08,7,53,19.875,-84.625,0,5,5
2011-08,7,56,19.875,-83.875,0,3,3
2011-08,7,62,19.875,-82.375,1,0,1
2011-08,7,63,19.875,-82.125,4,0,4
2011-08,7,65,19.875,-81.625,5,0,5
2011-08,7,66,19.875,-81.375,5,0,5
2011-08,7,67,19.875,-81.125,2,0,2
2011-08,8,49,20.125,-85.625,1,0,1
2011-08,8,62,20.125,-82.375,5,0,5
2011-08,8,67,20.125,-81.125,1,0,1
2011-08,10,47,20.625,-86.125,1,0,1
2011-08,10,48,20.625,-85.875,1,0,1
2011-08,11,47,20.875,-86.125,1,0,1
2011-08,12,10,21.125,-95.375,0,1,1
2011-08,13,11,21.375,-95.125,0,3,3
2011-08,13,12,21.375,-94.875,0,2,2
2011-08,13,13,21.375,-94.625,0,6,6
2011-08,13,14,21.375,-94.375,0,3,3
2011-08,13,15,21.375,-94.125,0,4,4
2011-08,13,16,21.375,-93.875,0,1,1
2011-08,13,17,21.375,-93.625,0,2,2
2011-08,13,18,21.375,-93.375,0,1,1
2011-08,14,16,21.625,-93.875,0,1,1
2011-08,14,17,21.625,-93.625,0,1,1
2011-08,15,7,21.875,-96.125,0,3,3
2011-08,15,8,21.875,-95.875,0,3,3
2011-08,20,17,23.125,-93.625,1,0,1
2011-08,20,18,23.125,-93.375,4,0,4
2011-08,20,19,23.125,-93.125,2,0,2
2011-08,20,25,23.125,-91.625,0,1,1
2011-08,20,26,23.125,-91.375,0,1,1
2011-08,21,11,23.375,-95.125,2,0,2
2011-08,21,12,23.375,-94.875,6,0,6
2011-08,21,13,23.375,-94.625,5,0,5
2011-08,21,14,23.375,-94.375,4,0,4
2011-08,21,15,23.375,-94.125,2,0,2
2011-08,21,16,23.375,-93.875,4,0,4
2011-08,21,17,23.375,-93.625,1,0,1
2011-08,21,25,23.375,-91.625,0,4,4
2011-08,21,26,23.375,-91.375,0,2,2
2011-08,21,27,23.375,-91.125,0,3,3
2011-08,22,50,23.625,-85.375,0,1,1
2011-08,23,49,23.875,-85.625,0,3,3
2011-08,23,50,23.875,-85.375,0,3,3
2011-08,24,48,24.125,-85.875,0,10,10
2011-08,24,49,24.125,-85.625,0,14,14
2011-08,26,42,24.625,-87.375,2,0,2
2011-08,26,43,24.625,-87.125,1,0,1
2011-08,27,13,24.875,-94.625,0,5,5
2011-08,27,14,24.875,-94.375,0,9,9
2011-08,27,15,24.875,-94.125,0,4,4
2011-08,27,41,24.875,-87.625,3,0,3
2011-08,27,42,24.875,-87.375,2,0,2
2011-08,28,13,25.125,-94.625,0,2,2
2011-08,28,14,25.125,-94.375,0,3,3
2011-08,28,41,25.125,-87.625,3,0,3
2011-08,29,16,25.375,-93.875,0,7,7
2011-08,29,40,25.375,-87.875,2,0,2
2011-08,29,41,25.375,-87.625,2,0,2
2011-08,30,22,25.625,-92.375,2,0,2
2011-08,30,23,25.625,-92.125,4,0,4
2011-08,30,39,25.625,-88.125,3,0,3
2011-08,30,40,25.625,-87.875,8,0,8
2011-08,30,41,25.625,-87.625,3,0,3
2011-08,31,20,25.875,-92.875,5,0,5
2011-08,31,21,25.875,-92.625,3,0,3
2011-08,31,23,25.875,-92.125,3,0,3
2011-08,31,24,25.875,-91.875,4,0,4
2011-08,31,25,25.875,-91.625,3,0,3
2011-08,32,12,26.125,-94.875,28,0,28
2011-08,32,13,26.125,-94.625,3,0,3
2011-08,32,24,26.125,-91.875,6,0,6
2011-08,32,25,26.125,-91.625,1,0,1
2011-08,32,29,26.125,-90.625,0,4,4
2011-08,32,30,26.125,-90.375,0,5,5
2011-08,32,31,26.125,-90.125,0,3,3
2011-08,32,32,26.125,-89.875,0,5,5
2011-08,32,51,26.125,-85.125,2,0,2
2011-08,33,32,26.375,-89.875,0,1,1
2011-08,33,33,26.375,-89.625,0,6,6
2011-08,33,34,26.375,-89.375,0,7,7
2011-08,33,49,26.375,-85.625,4,0,4
2011-08,33,50,26.375,-85.375,2,0,2
2011-08,33,51,26.375,-85.125,3,0,3
2011-08,34,49,26.625,-85.625,6,0,6
2011-08,34,50,26.625,-85.375,9,0,9
2011-08,34,51,26.625,-85.125,2,0,2
2011-08,36,8,27.125,-95.875,0,5,5
2011-08,36,9,27.125,-95.625,0,2,2
2011-08,36,12,27.125,-94.875,0,10,10
2011-08,36,13,27.125,-94.625,0,9,9
2011-08,41,42,28.375,-87.375,0,1,1
2011-08,41,43,28.375,-87.125,0,1,1
2011-08,42,42,28.625,-87.375,0,5,5
2011-08,42,43,28.625,-87.125,0,11,11
2011-08,42,44,28.625,-86.875,0,2,2
2011-08,42,45,28.625,-86.625,0,2,2
2011-08,42,46,28.625,-86.375,0,3,3
2011-09,0,47,18.125,-86.125,1,0,1
2011-09,0,56,18.125,-83.875,0,1,1
2011-09,0,70,18.125,-80.375,1,0,1
2011-09,1,70,18.375,-80.375,1,0,1
2011-09,5,57,19.375,-83.625,1,0,1
2011-09,5,58,19.375,-83.375,1,0,1
2011-09,5,59,19.375,-83.125,4,0,4
2011-09,5,60,19.375,-82.875,2,0,2
2011-09,6,60,19.625,-82.875,2,0,2
2011-09,6,61,19.625,-82.625,3,0,3
2011-09,6,62,19.625,-82.375,3,0,3
2011-09,10,17,20.625,-93.625,2,0,2
2011-09,10,67,20.625,-81.125,0,2,2
2011-09,10,68,20.625,-80.875,0,8,8
2011-09,11,7,20.875,-96.125,0,8,8
2011-09,11,16,20.875,-93.875,4,0,4
2011-09,11,17,20.875,-93.625,5,0,5
2011-09,12,7,21.125,-96.125,0,4,4
2011-09,12,16,21.125,-93.875,4,0,4
2011-09,12,56,21.125,-83.875,0,2,2
2011-09,13,7,21.375,-96.125,0,6,6
2011-09,13,16,21.375,-93.875,3,0,3
2011-09,14,7,21.625,-96.125,0,6,6
2011-09,14,16,21.625,-93.875,4,0,4
2011-09,15,7,21.875,-96.125,0,6,6
2011-09,15,15,21.875,-94.125,2,0,2
2011-09,15,16,21.875,-93.875,3,0,3
2011-09,19,25,22.875,-91.625,0,1,1
2011-09,20,24,23.125,-91.875,0,19,19
2011-09,20,25,23.125,-91.625,0,10,10
2011-09,21,11,23.375,-95.125,1,0,1
2011-09,22,8,23.625,-95.875,1,0,1
2011-09,22,9,23.625,-95.625,6,0,6
2011-09,22,10,23.625,-95.375,3,0,3
2011-09,22,11,23.625,-95.125,1,0,1
2011-09,23,7,23.875,-96.125,2,0,2
2011-09,23,8,23.875,-95.875,5,0,5
2011-09,23,55,23.875,-84.125,5,0,5
2011-09,24,48,24.125,-85.875,0,1,1
2011-09,24,55,24.125,-84.125,3,0,3
2011-09,25,47,24.375,-86.125,0,6,6
2011-09,25,55,24.375,-84.125,4,0,4
2011-09,26,11,24.625,-95.125,0,1,1
2011-09,26,47,24.625,-86.125,0,5,5
2011-09,26,54,24.625,-84.375,2,0,2
2011-09,26,55,24.625,-84.125,1,0,1
2011-09,27,15,24.875,-94.125,0,3,3
2011-09,27,47,24.875,-86.125,0,4,4
2011-09,27,54,24.875,-84.375,6,0,6
2011-09,28,14,25.125,-94.375,0,4,4
2011-09,28,15,25.125,-94.125,0,2,2
2011-09,28,46,25.125,-86.375,0,14,14
2011-09,28,54,25.125,-84.375,3,0,3
2011-09,30,23,25.625,-92.125,0,3,3
2011-09,30,24,25.625,-91.875,0,2,2
2011-09,30,37,25.625,-88.625,5,0,5
2011-09,30,38,25.625,-88.375,1,0,1
2011-09,30,39,25.625,-88.125,8,0,8
2011-09,31,24,25.875,-91.875,0,3,3
2011-09,31,25,25.875,-91.625,0,4,4
2011-09,31,26,25.875,-91.375,0,4,4
2011-09,31,27,25.875,-91.125,0,4,4
2011-09,31,38,25.875,-88.375,16,0,16
2011-09,32,13,26.125,-94.625,3,0,3
2011-09,32,27,26.125,-91.125,0,2,2
2011-09,32,28,26.125,-90.875,0,6,6
2011-09,32,29,26.125,-90.625,0,2,2
2011-09,33,51,26.375,-85.125,1,0,1
2011-09,34,10,26.625,-95.375,0,3,3
2011-09,34,11,26.625,-95.125,0,8,8
2011-09,34,50,26.625,-85.375,2,0,2
2011-09,35,11,26.875,-95.125,0,7,7
2011-09,35,12,26.875,-94.875,0,5,5
2011-09,36,12,27.125,-94.875,0,3,3
2011-09,36,13,27.125,-94.625,0,3,3
2011-09,36,28,27.125,-90.875,1,0,1
2011-09,36,51,27.125,-85.125,3,0,3
2011-09,36,52,27.125,-84.875,3,0,3
2011-09,37,27,27.375,-91.125,1,0,1
2011-09,39,19,27.875,-93.125,1,0,1
2011-09,39,20,27.875,-92.875,1,0,1
2011-09,39,21,27.875,-92.625,2,0,2
2011-09,40,17,28.125,-93.625,1,0,1
2011-09,40,18,28.125,-93.375,1,0,1
2011-09,40,19,28.125,-93.125,1,0,1
2011-09,41,42,28.375,-87.375,0,5,5
2011-09,41,43,28.375,-87.125,0,9,9
2011-09,41,44,28.375,-86.875,0,10,10
2011-09,42,42,28.625,-87.375,0,5,5
2011-10,0,56,18.125,-83.875,0,1,1
2011-10,0,58,18.125,-83.375,2,0,2
2011-10,0,59,18.125,-83.125,2,0,2
2011-10,0,60,18.125,-82.875,3,0,3
2011-10,1,51,18.375,-85.125,0,2,2
2011-10,1,52,18.375,-84.875,0,2,2
2011-10,1,53,18.375,-84.625,0,4,4
2011-10,1,54,18.375,-84.375,0,2,2
2011-10,1,55,18.375,-84.125,0,6,6
2011-10,1,56,18.375,-83.875,0,3,3
2011-10,2,51,18.625,-85.125,0,3,3
2011-10,2,52,18.625,-84.875,0,1,1
2011-10,2,55,18.625,-84.125,0,1,1
2011-10,2,69,18.625,-80.625,1,0,1
2011-10,3,67,18.875,-81.125,1,0,1
2011-10,3,68,18.875,-80.875,2,0,2
2011-10,4,62,19.125,-82.375,2,0,2
2011-10,4,63,19.125,-82.125,3,0,3
2011-10,4,64,19.125,-81.875,3,0,3
2011-10,4,65,19.125,-81.625,2,0,2
2011-10,4,66,19.125,-81.375,3,0,3
2011-10,4,67,19.125,-81.125,1,0,1
2011-10,5,60,19.375,-82.875,2,0,2
2011-10,5,61,19.375,-82.625,3,0,3
2011-10,5,62,19.375,-82.375,1,0,1
2011-10,6,69,19.625,-80.625,0,5,5
2011-10,6,70,19.625,-80.375,0,4,4
2011-10,7,69,19.875,-80.625,0,4,4
2011-10,8,68,20.125,-80.875,0,3,3
2011-10,9,7,20.375,-96.125,0,2,2
2011-10,9,66,20.375,-81.375,0,5,5
2011-10,9,68,20.375,-80.875,0,5,5
2011-10,10,7,20.625,-96.125,0,4,4
2011-10,10,68,20.625,-80.875,0,4,4
2011-10,11,7,20.875,-96.125,0,3,3
2011-10,11,54,20.875,-84.375,0,2,2
2011-10,11,55,20.875,-84.125,0,7,7
2011-10,11,56,20.875,-83.875,0,3,3
2011-10,11,57,20.875,-83.625,0,3,3
2011-10,12,56,21.125,-83.875,0,10,10
2011-10,12,57,21.125,-83.625,0,3,3
2011-10,15,10,21.875,-95.375,3,0,3
2011-10,15,11,21.875,-95.125,2,0,2
2011-10,15,13,21.875,-94.625,4,0,4
2011-10,15,14,21.875,-94.375,7,0,7
2011-10,16,12,22.125,-94.875,3,0,3
2011-10,16,13,22.125,-94.625,1,0,1
2011-10,16,15,22.125,-94.125,4,0,4
2011-10,16,16,22.125,-93.875,1,0,1
2011-10,17,14,22.375,-94.375,2,0,2
2011-10,17,15,22.375,-94.125,4,0,4
2011-10,20,23,23.125,-92.125,0,3,3
2011-10,20,24,23.125,-91.875,0,1,1
2011-10,21,23,23.375,-92.125,0,2,2
2011-10,22,54,23.625,-84.375,6,0,6
2011-10,22,55,23.625,-84.125,18,0,18
2011-10,23,55,23.875,-84.125,1,0,1
2011-10,24,7,24.125,-96.125,0,3,3
2011-10,24,8,24.125,-95.875,0,4,4
2011-10,25,7,24.375,-96.125,0,10,10
2011-10,25,8,24.375,-95.875,0,5,5
2011-10,25,9,24.375,-95.625,0,2,2
2011-10,25,10,24.375,-95.375,0,2,2
2011-10,26,10,24.625,-95.375,0,1,1
2011-10,26,11,24.625,-95.125,0,2,2
2011-10,26,51,24.625,-85.125,2,0,2
2011-10,26,52,24.625,-84.875,3,0,3
2011-10,26,53,24.625,-84.625,1,0,1
2011-10,27,22,24.875,-92.375,0,2,2
2011-10,28,23,25.125,-92.125,0,7,7
2011-10,28,45,25.125,-86.625,0,6,6
2011-10,28,46,25.125,-86.375,0,6,6
2011-10,29,23,25.375,-92.125,0,8,8
2011-10,29,44,25.375,-86.875,0,3,3
2011-10,29,46,25.375,-86.375,0,2,2
2011-10,29,50,25.375,-85.375,1,0,1
2011-10,29,51,25.375,-85.125,2,0,2
2011-10,30,23,25.625,-92.125,0,14,14
2011-10,30,36,25.625,-88.875,4,0,4
2011-10,30,37,25.625,-88.625,3,0,3
2011-10,30,44,25.625,-86.875,0,1,1
2011-10,30,51,25.625,-85.125,2,0,2
2011-10,31,11,25.875,-95.125,0,1,1
2011-10,31,36,25.875,-88.875,5,0,5
2011-10,31,44,25.875,-86.875,0,4,4
2011-10,31,51,25.875,-85.125,1,0,1
2011-10,31,52,25.875,-84.875,3,0,3
2011-10,32,11,26.125,-95.125,0,1,1
2011-10,32,36,26.125,-88.875,4,0,4
2011-10,32,44,26.125,-86.875,0,4,4
2011-10,32,52,26.125,-84.875,1,0,1
2011-10,33,11,26.375,-95.125,0,13,13
2011-10,33,12,26.375,-94.875,0,2,2
2011-10,33,30,26.375,-90.375,1,0,1
2011-10,33,36,26.375,-88.875,6,0,6
2011-10,33,37,26.375,-88.625,2,0,2
2011-10,33,44,26.375,-86.875,0,5,5
2011-10,33,52,26.375,-84.875,1,0,1
2011-10,34,10,26.625,-95.375,0,1,1
2011-10,34,11,26.625,-95.125,0,6,6
2011-10,34,12,26.625,-94.875,0,6,6
2011-10,34,29,26.625,-90.625,6,0,6
2011-10,34,30,26.625,-90.375,1,0,1
2011-10,34,37,26.625,-88.625,4,0,4
2011-10,34,51,26.625,-85.125,1,0,1
2011-10,35,11,26.875,-95.125,0,1,1
2011-10,35,28,26.875,-90.875,1,0,1
2011-10,35,29,26.875,-90.625,13,0,13
2011-10,35,51,26.875,-85.125,1,0,1
2011-10,35,52,26.875,-84.875,1,0,1
2011-10,36,28,27.125,-90.875,7,0,7
2011-10,36,29,27.125,-90.625,2,0,2
2011-10,36,50,27.125,-85.375,1,0,1
2011-10,36,51,27.125,-85.125,6,0,6
2011-10,37,38,27.375,-88.375,3,0,3
2011-10,37,50,27.375,-85.375,3,0,3
2011-10,37,51,27.375,-85.125,1,0,1
2011-10,38,18,27.625,-93.375,5,0,5
2011-10,39,15,27.875,-94.125,7,0,7
2011-10,39,16,27.875,-93.875,3,0,3
2011-10,39,17,27.875,-93.625,2,0,2
2011-10,39,18,27.875,-93.375,4,0,4
2011-10,40,16,28.125,-93.875,2,0,2
2011-10,40,17,28.125,-93.625,1,0,1
2011-10,40,18,28.125,-93.375,3,0,3
2011-10,41,41,28.375,-87.625,0,1,1
2011-10,42,41,28.625,-87.625,0,14,14
2011-10,42,71,28.625,-80.125,0,4,4
2011-10,43,40,28.875,-87.875,0,15,15
2011-11,0,50,18.125,-85.375,0,2,2
2011-11,0,51,18.125,-85.125,0,2,2
2011-11,0,52,18.125,-84.875,0,1,1
2011-11,0,57,18.125,-83.625,2,0,2
2011-11,0,58,18.125,-83.375,1,0,1
2011-11,0,69,18.125,-80.625,3,0,3
2011-11,1,47,18.375,-86.125,0,3,3
2011-11,1,48,18.375,-85.875,0,3,3
2011-11,1,49,18.375,-85.625,0,2,2
2011-11,1,53,18.375,-84.625,6,0,6
2011-11,1,54,18.375,-84.375,5,0,5
2011-11,1,55,18.375,-84.125,5,0,5
2011-11,1,56,18.375,-83.875,6,0,6
2011-11,1,57,18.375,-83.625,4,0,4
2011-11,1,58,18.375,-83.375,1,0,1
2011-11,1,68,18.375,-80.875,2,0,2
2011-11,2,46,18.625,-86.375,0,2,2
2011-11,2,67,18.625,-81.125,2,0,2
2011-11,4,70,19.125,-80.375,0,1,1
2011-11,4,71,19.125,-80.125,0,17,17
2011-11,9,66,20.375,-81.375,0,1,1
2011-11,10,54,20.625,-84.375,0,2,2
2011-11,10,57,20.625,-83.625,0,1,1
2011-11,11,53,20.875,-84.625,0,9,9
2011-11,11,54,20.875,-84.375,0,12,12
2011-11,12,52,21.125,-84.875,0,1,1
2011-11,14,9,21.625,-95.625,3,0,3
2011-11,14,10,21.625,-95.375,2,0,2
2011-11,15,10,21.875,-95.375,8,0,8
2011-11,15,11,21.875,-95.125,7,0,7
2011-11,15,12,21.875,-94.875,5,0,5
2011-11,16,11,22.125,-95.125,1,0,1
2011-11,16,12,22.125,-94.875,4,0,4
2011-11,23,48,23.875,-85.875,2,0,2
2011-11,23,56,23.875,-83.875,0,3,3
2011-11,23,57,23.875,-83.625,0,11,11
2011-11,24,22,24.125,-92.375,0,2,2
2011-11,24,48,24.125,-85.875,8,0,8
2011-11,24,56,24.125,-83.875,0,3,3
2011-11,25,22,24.375,-92.375,0,6,6
2011-11,25,48,24.375,-85.875,5,0,5
2011-11,25,57,24.375,-83.625,0,2,2
2011-11,26,22,24.625,-92.375,0,14,14
2011-11,26,23,24.625,-92.125,0,4,4
2011-11,26,48,24.625,-85.875,4,0,4
2011-11,26,49,24.625,-85.625,7,0,7
2011-11,26,50,24.625,-85.375,1,0,1
2011-11,26,51,24.625,-85.125,1,0,1
2011-11,26,57,24.625,-83.625,0,2,2
2011-11,27,22,24.875,-92.375,0,4,4
2011-11,27,49,24.875,-85.625,1,0,1
2011-11,27,50,24.875,-85.375,1,0,1
2011-11,28,11,25.125,-95.125,0,5,5
2011-11,28,12,25.125,-94.875,0,12,12
2011-11,29,11,25.375,-95.125,0,3,3
2011-11,29,12,25.375,-94.875,0,6,6
2011-11,30,11,25.625,-95.125,0,2,2
2011-11,31,11,25.875,-95.125,0,2,2
2011-11,31,32,25.875,-89.875,2,0,2
2011-11,32,28,26.125,-90.875,2,0,2
2011-11,32,29,26.125,-90.625,7,0,7
2011-11,32,30,26.125,-90.375,5,0,5
2011-11,32,31,26.125,-90.125,9,0,9
2011-11,32,32,26.125,-89.875,5,0,5
2011-11,32,43,26.125,-87.125,0,6,6
2011-11,33,44,26.375,-86.875,0,24,24
2011-11,36,16,27.125,-93.875,2,0,2
2011-11,36,17,27.125,-93.625,6,0,6
2011-11,37,38,27.375,-88.375,2,0,2
2011-11,38,17,27.625,-93.625,2,0,2
2011-11,38,18,27.625,-93.375,1,0,1
2011-11,38,38,27.625,-88.375,4,0,4
2011-11,38,39,27.625,-88.125,4,0,4
2011-11,39,17,27.875,-93.625,2,0,2
2011-11,39,18,27.875,-93.375,1,0,1
2011-11,39,40,27.875,-87.875,4,0,4
2011-11,39,41,27.875,-87.625,9,0,9
2011-11,39,42,27.875,-87.375,4,0,4
2011-11,39,43,27.875,-87.125,3,0,3
2011-11,40,16,28.125,-93.875,1,0,1
2011-12,0,46,18.125,-86.375,7,0,7
2011-12,0,47,18.125,-86.125,2,0,2
2011-12,0,48,18.125,-85.875,2,0,2
2011-12,0,69,18.125,-80.625,2,0,2
2011-12,1,52,18.375,-84.875,1,0,1
2011-12,1,67,18.375,-81.125,5,0,5
2011-12,1,68,18.375,-80.875,5,0,5
2011-12,2,50,18.625,-85.375,3,0,3
2011-12,2,51,18.625,-85.125,4,0,4
2011-12,2,52,18.625,-84.875,5,0,5
2011-12,2,64,18.625,-81.875,1,0,1
2011-12,2,65,18.625,-81.625,2,0,2
2011-12,2,66,18.625,-81.375,2,0,2
2011-12,2,67,18.625,-81.125,1,0,1
2011-12,3,49,18.875,-85.625,4,0,4
2011-12,3,50,18.875,-85.375,2,0,2
2011-12,3,62,18.875,-82.375,2,0,2
2011-12,3,63,18.875,-82.125,2,0,2
2011-12,3,64,18.875,-81.875,1,0,1
2011-12,5,71,19.375,-80.125,1,0,1
2011-12,10,69,20.625,-80.625,0,2,2
2011-12,10,70,20.625,-80.375,0,4,4
2011-12,10,71,20.625,-80.125,0,1,1
2011-12,11,52,20.875,-84.875,0,1,1
2011-12,11,63,20.875,-82.125,0,3,3
2011-12,11,64,20.875,-81.875,0,4,4
2011-12,11,70,20.875,-80.375,0,2,2
2011-12,11,71,20.875,-80.125,0,3,3
2011-12,12,52,21.125,-84.875,0,3,3
2011-12,15,10,21.875,-95.375,2,0,2
2011-12,15,11,21.875,-95.125,3,0,3
2011-12,16,10,22.125,-95.375,1,0,1
2011-12,16,11,22.125,-95.125,2,0,2
2011-12,20,10,23.125,-95.375,2,0,2
2011-12,21,17,23.375,-93.625,0,4,4
2011-12,21,18,23.375,-93.375,0,3,3
2011-12,21,19,23.375,-93.125,0,2,2
2011-12,21,20,23.375,-92.875,0,4,4
2011-12,21,21,23.375,-92.625,0,1,1
2011-12,22,21,23.625,-92.625,0,3,3
2011-12,22,22,23.625,-92.375,0,2,2
2011-12,23,22,23.875,-92.375,0,6,6
2011-12,23,46,23.875,-86.375,5,0,5
2011-12,23,47,23.875,-86.125,9,0,9
2011-12,23,48,23.875,-85.875,1,0,1
2011-12,23,56,23.875,-83.875,0,5,5
2011-12,23,57,23.875,-83.625,0,9,9
2011-12,24,22,24.125,-92.375,0,2,2
2011-12,24,46,24.125,-86.375,4,0,4
2011-12,24,55,24.125,-84.125,0,2,2
2011-12,25,15,24.375,-94.125,0,4,4
2011-12,25,54,24.375,-84.375,0,1,1
2011-12,25,55,24.375,-84.125,0,2,2
2011-12,26,47,24.625,-86.125,1,0,1
2011-12,26,54,24.625,-84.375,0,2,2
2011-12,26,55,24.625,-84.125,0,1,1
2011-12,27,47,24.875,-86.125,1,0,1
2011-12,27,54,24.875,-84.375,0,6,6
2011-12,28,46,25.125,-86.375,5,0,5
2011-12,28,54,25.125,-84.375,0,3,3
2011-12,29,12,25.375,-94.875,0,21,21
2011-12,29,13,25.375,-94.625,0,2,2
2011-12,29,14,25.375,-94.375,0,4,4
2011-12,29,38,25.375,-88.375,0,3,3
2011-12,30,38,25.625,-88.375,0,2,2
2011-12,30,39,25.625,-88.125,0,3,3
2011-12,31,39,25.875,-88.125,0,7,7
2011-12,31,40,25.875,-87.875,0,4,4
2011-12,32,25,26.125,-91.625,5,0,5
2011-12,32,26,26.125,-91.375,10,0,10
2011-12,32,27,26.125,-91.125,11,0,11
2011-12,32,28,26.125,-90.875,5,0,5
2011-12,32,40,26.125,-87.875,0,1,1
2011-12,32,41,26.125,-87.625,0,4,4
2011-12,32,42,26.125,-87.375,0,7,7
2011-12,33,48,26.375,-85.875,1,0,1
2011-12,34,48,26.625,-85.875,4,0,4
2011-12,35,48,26.875,-85.875,3,0,3
2011-12,36,47,27.125,-86.125,2,0,2
2011-12,36,48,27.125,-85.875,1,0,1
2011-12,37,46,27.375,-86.375,1,0,1
2011-12,37,47,27.375,-86.125,2,0,2
2011-12,38,45,27.625,-86.625,2,0,2
2011-12,38,46,27.625,-86.375,1,0,1
2011-12,39,44,27.875,-86.875,2,0,2
2012-01,0,46,18.125,-86.375,2,0,2
2012-01,1,71,18.375,-80.125,1,0,1
2012-01,2,71,18.625,-80.125,5,0,5
2012-01,3,67,18.875,-81.125,1,0,1
2012-01,3,69,18.875,-80.625,3,0,3
2012-01,3,70,18.875,-80.375,4,0,4
2012-01,6,50,19.625,-85.375,4,0,4
2012-01,7,49,19.875,-85.625,3,0,3
2012-01,7,50,19.875,-85.375,1,0,1
2012-01,8,51,20.125,-85.125,1,0,1
2012-01,10,8,20.625,-95.875,1,0,1
2012-01,10,9,20.625,-95.625,2,0,2
2012-01,10,64,20.625,-81.875,0,2,2
2012-01,11,8,20.875,-95.875,2,0,2
2012-01,11,9,20.875,-95.625,9,0,9
2012-01,11,10,20.875,-95.375,1,0,1
2012-01,11,59,20.875,-83.125,0,1,1
2012-01,11,60,20.875,-82.875,0,2,2
2012-01,11,61,20.875,-82.625,0,7,7
2012-01,11,62,20.875,-82.375,0,2,2
2012-01,11,63,20.875,-82.125,0,9,9
2012-01,12,9,21.125,-95.625,6,0,6
2012-01,12,10,21.125,-95.375,3,0,3
2012-01,12,56,21.125,-83.875,0,3,3
2012-01,12,57,21.125,-83.625,0,2,2
2012-01,13,10,21.375,-95.375,4,0,4
2012-01,14,10,21.625,-95.375,1,0,1
2012-01,16,14,22.125,-94.375,0,5,5
2012-01,20,14,23.125,-94.375,0,3,3
2012-01,21,14,23.375,-94.375,0,4,4
2012-01,22,14,23.625,-94.375,0,3,3
2012-01,22,18,23.625,-93.375,5,0,5
2012-01,22,19,23.625,-93.125,3,0,3
2012-01,23,14,23.875,-94.375,0,5,5
2012-01,23,19,23.875,-93.125,6,0,6
2012-01,23,49,23.875,-85.625,0,1,1
2012-01,23,50,23.875,-85.375,0,4,4
2012-01,23,51,23.875,-85.125,0,4,4
2012-01,23,52,23.875,-84.875,0,2,2
2012-01,24,7,24.125,-96.125,4,0,4
2012-01,24,14,24.125,-94.375,0,6,6
2012-01,24,19,24.125,-93.125,3,0,3
2012-01,24,20,24.125,-92.875,2,0,2
2012-01,24,53,24.125,-84.625,0,7,7
2012-01,24,54,24.125,-84.375,0,4,4
2012-01,24,55,24.125,-84.125,0,2,2
2012-01,25,6,24.375,-96.375,15,0,15
2012-01,25,7,24.375,-96.125,5,0,5
2012-01,25,15,24.375,-94.125,0,3,3
2012-01,25,20,24.375,-92.875,3,0,3
2012-01,25,55,24.375,-84.125,0,5,5
2012-01,26,20,24.625,-92.875,2,0,2
2012-01,26,54,24.625,-84.375,0,2,2
2012-01,28,14,25.125,-94.375,0,7,7
2012-01,28,33,25.125,-89.625,0,4,4
2012-01,28,34,25.125,-89.375,0,6,6
2012-01,28,35,25.125,-89.125,0,5,5
2012-01,28,36,25.125,-88.875,0,4,4
2012-01,28,37,25.125,-88.625,0,6,6
2012-01,28,38,25.125,-88.375,0,3,3
2012-01,29,38,25.375,-88.375,0,3,3
2012-01,29,46,25.375,-86.375,4,0,4
2012-01,30,45,25.625,-86.625,6,0,6
2012-01,31,44,25.875,-86.875,6,0,6
2012-01,31,45,25.875,-86.625,3,0,3
2012-01,32,25,26.125,-91.625,4,0,4
2012-01,32,26,26.125,-91.375,2,0,2
2012-01,32,27,26.125,-91.125,8,0,8
2012-01,32,42,26.125,-87.375,1,0,1
2012-01,32,43,26.125,-87.125,11,0,11
2012-01,33,16,26.375,-93.875,1,0,1
2012-01,33,17,26.375,-93.625,1,0,1
2012-01,33,26,26.375,-91.375,8,0,8
2012-01,33,27,26.375,-91.125,5,0,5
2012-01,34,15,26.625,-94.125,4,0,4
2012-01,34,16,26.625,-93.875,4,0,4
2012-01,34,27,26.625,-91.125,4,0,4
2012-01,34,51,26.625,-85.125,0,4,4
2012-01,35,8,26.875,-95.875,0,7,7
2012-01,35,51,26.875,-85.125,0,13,13
2012-01,35,52,26.875,-84.875,0,2,2
2012-01,36,8,27.125,-95.875,0,7,7
2012-01,36,49,27.125,-85.625,0,1,1
2012-01,36,50,27.125,-85.375,0,6,6
2012-01,37,49,27.375,-85.625,0,1,1
2012-01,37,50,27.375,-85.375,0,1,1
2012-01,39,47,27.875,-86.125,0,3,3
2012-02,0,55,18.125,-84.125,0,5,5
2012-02,1,54,18.375,-84.375,0,2,2
2012-02,1,55,18.375,-84.125,0,2,2
2012-02,1,56,18.375,-83.875,0,1,1
2012-02,1,57,18.375,-83.625,0,2,2
2012-02,3,63,18.875,-82.125,2,0,2
2012-02,3,64,18.875,-81.875,2,0,2
2012-02,3,65,18.875,-81.625,2,0,2
2012-02,3,66,18.875,-81.375,3,0,3
2012-02,4,62,19.125,-82.375,3,0,3
2012-02,4,63,19.125,-82.125,2,0,2
2012-02,5,60,19.375,-82.875,1,0,1
2012-02,5,62,19.375,-82.375,1,0,1
2012-02,7,46,19.875,-86.375,6,0,6
2012-02,7,47,19.875,-86.125,1,0,1
2012-02,7,48,19.875,-85.875,6,0,6
2012-02,8,46,20.125,-86.375,4,0,4
2012-02,8,47,20.125,-86.125,9,0,9
2012-02,8,48,20.125,-85.875,2,0,2
2012-02,9,7,20.375,-96.125,1,0,1
2012-02,10,7,20.625,-96.125,9,0,9
2012-02,10,8,20.625,-95.875,6,0,6
2012-02,10,59,20.625,-83.125,0,1,1
2012-02,11,8,20.875,-95.875,1,0,1
2012-02,11,56,20.875,-83.875,0,1,1
2012-02,11,57,20.875,-83.625,0,5,5
2012-02,11,58,20.875,-83.375,0,14,14
2012-02,11,59,20.875,-83.125,0,1,1
2012-02,12,56,21.125,-83.875,0,5,5
2012-02,12,57,21.125,-83.625,0,1,1
2012-02,15,7,21.875,-96.125,0,2,2
2012-02,15,8,21.875,-95.875,0,1,1
2012-02,15,9,21.875,-95.625,0,2,2
2012-02,15,10,21.875,-95.375,0,3,3
2012-02,15,11,21.875,-95.125,0,5,5
2012-02,15,12,21.875,-94.875,0,4,4
2012-02,15,13,21.875,-94.625,0,6,6
2012-02,16,12,22.125,-94.875,0,1,1
2012-02,16,13,22.125,-94.625,0,3,3
2012-02,16,14,22.125,-94.375,0,2,2
2012-02,19,14,22.875,-94.375,1,0,1
2012-02,19,15,22.875,-94.125,1,0,1
2012-02,19,27,22.875,-91.125,5,0,5
2012-02,19,28,22.875,-90.875,5,0,5
2012-02,20,15,23.125,-94.125,7,0,7
2012-02,20,16,23.125,-93.875,3,0,3
2012-02,20,28,23.125,-90.875,4,0,4
2012-02,20,29,23.125,-90.625,2,0,2
2012-02,21,16,23.375,-93.875,8,0,8
2012-02,21,17,23.375,-93.625,5,0,5
2012-02,22,17,23.625,-93.625,2,0,2
2012-02,22,18,23.625,-93.375,2,0,2
2012-02,22,49,23.625,-85.625,0,1,1
2012-02,23,46,23.875,-86.375,0,3,3
2012-02,23,47,23.875,-86.125,0,3,3
2012-02,24,46,24.125,-86.375,0,7,7
2012-02,25,6,24.375,-96.375,9,0,9
2012-02,25,45,24.375,-86.625,0,2,2
2012-02,25,46,24.375,-86.375,0,3,3
2012-02,26,6,24.625,-96.375,14,0,14
2012-02,26,45,24.625,-86.625,0,4,4
2012-02,27,6,24.875,-96.375,1,0,1
2012-02,27,7,24.875,-96.125,2,0,2
2012-02,27,14,24.875,-94.375,0,9,9
2012-02,27,15,24.875,-94.125,0,3,3
2012-02,27,45,24.875,-86.625,0,1,1
2012-02,28,14,25.125,-94.375,0,13,13
2012-02,28,15,25.125,-94.125,0,4,4
2012-02,28,30,25.125,-90.375,0,4,4
2012-02,28,32,25.125,-89.875,0,5,5
2012-02,28,33,25.125,-89.625,0,3,3
2012-02,28,45,25.125,-86.625,0,3,3
2012-02,29,30,25.375,-90.375,0,3,3
2012-02,29,31,25.375,-90.125,0,11,11
2012-02,29,32,25.375,-89.875,0,3,3
2012-02,29,45,25.375,-86.625,0,1,1
2012-02,29,51,25.375,-85.125,6,0,6
2012-02,29,52,25.375,-84.875,5,0,5
2012-02,30,50,25.625,-85.375,3,0,3
2012-02,31,39,25.875,-88.125,4,0,4
2012-02,31,49,25.875,-85.625,1,0,1
2012-02,32,37,26.125,-88.625,2,0,2
2012-02,32,38,26.125,-88.375,2,0,2
2012-02,32,39,26.125,-88.125,2,0,2
2012-02,32,42,26.125,-87.375,6,0,6
2012-02,32,43,26.125,-87.125,1,0,1
2012-02,33,16,26.375,-93.875,21,0,21
2012-02,33,17,26.375,-93.625,6,0,6
2012-02,33,37,26.375,-88.625,2,0,2
2012-02,33,38,26.375,-88.375,3,0,3
2012-02,33,45,26.375,-86.625,1,0,1
2012-02,33,46,26.375,-86.375,1,0,1
2012-02,34,8,26.625,-95.875,0,16,16
2012-02,34,9,26.625,-95.625,0,1,1
2012-02,34,27,26.625,-91.125,2,0,2
2012-02,34,28,26.625,-90.875,1,0,1
2012-02,35,8,26.875,-95.875,0,4,4
2012-02,35,9,26.875,-95.625,0,6,6
2012-02,35,28,26.875,-90.875,2,0,2
2012-02,35,30,26.875,-90.375,2,0,2
2012-02,36,8,27.125,-95.875,0,1,1
2012-02,36,9,27.125,-95.625,0,1,1
2012-02,36,30,27.125,-90.375,1,0,1
2012-02,39,47,27.875,-86.125,0,2,2
2012-02,40,43,28.125,-87.125,0,1,1
2012-02,40,44,28.125,-86.875,0,5,5
2012-02,40,45,28.125,-86.625,0,6,6
2012-02,40,46,28.125,-86.375,0,5,5
2012-02,40,47,28.125,-86.125,0,1,1
2012-02,41,43,28.375,-87.125,0,1,1
2012-02,41,44,28.375,-86.875,0,7,7
2012-02,41,45,28.375,-86.625,0,1,1
2012-03,0,51,18.125,-85.125,0,3,3
2012-03,1,47,18.375,-86.125,0,3,3
2012-03,1,48,18.375,-85.875,0,4,4
2012-03,1,49,18.375,-85.625,0,4,4
2012-03,1,50,18.375,-85.375,0,3,3
2012-03,1,51,18.375,-85.125,0,1,1
2012-03,1,53,18.375,-84.625,0,2,2
2012-03,1,54,18.375,-84.375,0,1,1
2012-03,2,47,18.625,-86.125,0,4,4
2012-03,3,46,18.875,-86.375,0,1,1
2012-03,3,47,18.875,-86.125,0,2,2
2012-03,4,46,19.125,-86.375,0,1,1
2012-03,12,56,21.125,-83.875,0,19,19
2012-03,13,13,21.375,-94.625,8,0,8
2012-03,13,14,21.375,-94.375,4,0,4
2012-03,14,12,21.625,-94.875,2,0,2
2012-03,14,13,21.625,-94.625,8,0,8
2012-03,14,14,21.625,-94.375,4,0,4
2012-03,15,7,21.875,-96.125,0,8,8
2012-03,16,6,22.125,-96.375,0,3,3
2012-03,16,7,22.125,-96.125,0,1,1
2012-03,17,6,22.375,-96.375,0,2,2
2012-03,18,6,22.625,-96.375,0,1,1
2012-03,18,14,22.625,-94.375,2,0,2
2012-03,19,7,22.875,-96.125,0,1,1
2012-03,19,14,22.875,-94.375,3,0,3
2012-03,19,26,22.875,-91.375,2,0,2
2012-03,19,27,22.875,-91.125,2,0,2
2012-03,20,7,23.125,-96.125,0,3,3
2012-03,20,24,23.125,-91.875,2,0,2
2012-03,20,25,23.125,-91.625,4,0,4
2012-03,20,26,23.125,-91.375,1,0,1
2012-03,20,46,23.125,-86.375,2,0,2
2012-03,20,47,23.125,-86.125,1,0,1
2012-03,20,48,23.125,-85.875,2,0,2
2012-03,21,7,23.375,-96.125,0,5,5
2012-03,21,23,23.375,-92.125,3,0,3
2012-03,21,24,23.375,-91.875,3,0,3
2012-03,22,7,23.625,-96.125,0,4,4
2012-03,22,8,23.625,-95.875,0,3,3
2012-03,22,22,23.625,-92.375,6,0,6
2012-03,22,23,23.625,-92.125,2,0,2
2012-03,23,21,23.875,-92.625,1,0,1
2012-03,24,52,24.125,-84.875,1,0,1
2012-03,24,54,24.125,-84.375,3,0,3
2012-03,24,55,24.125,-84.125,1,0,1
2012-03,25,52,24.375,-84.875,1,0,1
2012-03,25,53,24.375,-84.625,1,0,1
2012-03,25,54,24.375,-84.375,3,0,3
2012-03,26,13,24.625,-94.625,0,1,1
2012-03,26,29,24.625,-90.625,0,11,11
2012-03,26,30,24.625,-90.375,0,4,4
2012-03,26,52,24.625,-84.875,6,0,6
2012-03,26,53,24.625,-84.625,1,0,1
2012-03,27,13,24.875,-94.625,0,1,1
2012-03,27,14,24.875,-94.375,0,8,8
2012-03,27,30,24.875,-90.375,0,10,10
2012-03,27,52,24.875,-84.875,7,0,7
2012-03,28,30,25.125,-90.375,0,6,6
2012-03,28,52,25.125,-84.875,6,0,6
2012-03,28,53,25.125,-84.625,1,0,1
2012-03,29,45,25.375,-86.625,0,5,5
2012-03,30,45,25.625,-86.625,0,1,1
2012-03,30,47,25.625,-86.125,0,4,4
2012-03,31,24,25.875,-91.875,1,0,1
2012-03,31,37,25.875,-88.625,3,0,3
2012-03,31,46,25.875,-86.375,0,4,4
2012-03,31,47,25.875,-86.125,0,6,6
2012-03,32,13,26.125,-94.625,3,0,3
2012-03,32,14,26.125,-94.375,5,0,5
2012-03,32,24,26.125,-91.875,7,0,7
2012-03,32,25,26.125,-91.625,1,0,1
2012-03,32,37,26.125,-88.625,14,0,14
2012-03,32,38,26.125,-88.375,9,0,9
2012-03,32,45,26.125,-86.625,0,4,4
2012-03,32,46,26.125,-86.375,0,6,6
2012-03,33,14,26.375,-94.375,6,0,6
2012-03,33,15,26.375,-94.125,12,0,12
2012-03,33,16,26.375,-93.875,4,0,4
2012-03,33,24,26.375,-91.875,18,0,18
2012-03,33,37,26.375,-88.625,5,0,5
2012-03,34,24,26.625,-91.875,2,0,2
2012-03,34,49,26.625,-85.625,1,0,1
2012-03,34,50,26.625,-85.375,1,0,1
2012-03,35,8,26.875,-95.875,0,2,2
2012-03,35,9,26.875,-95.625,0,15,15
2012-03,35,48,26.875,-85.875,1,0,1
2012-03,35,49,26.875,-85.625,4,0,4
2012-03,36,48,27.125,-85.875,5,0,5
2012-03,36,49,27.125,-85.625,1,0,1
2012-03,40,44,28.125,-86.875,0,1,1
2012-03,41,42,28.375,-87.375,0,3,3
2012-03,41,43,28.375,-87.125,0,3,3
2012-03,41,44,28.375,-86.875,0,6,6
2012-03,41,46,28.375,-86.375,4,0,4
2012-03,41,47,28.375,-86.125,1,0,1
2012-03,42,39,28.625,-88.125,0,3,3
2012-03,42,40,28.625,-87.875,0,11,11
2012-03,42,41,28.625,-87.625,0,4,4
2012-03,42,46,28.625,-86.375,4,0,4
2012-03,42,47,28.625,-86.125,1,0,1
2012-04,0,43,18.125,-87.125,0,1,1
2012-04,0,44,18.125,-86.875,0,1,1
2012-04,0,54,18.125,-84.375,3,0,3
2012-04,0,55,18.125,-84.125,3,0,3
2012-04,1,43,18.375,-87.125,0,1,1
2012-04,1,55,18.375,-84.125,3,0,3
2012-04,2,54,18.625,-84.375,2,0,2
2012-04,2,55,18.625,-84.125,4,0,4
2012-04,3,53,18.875,-84.625,4,0,4
2012-04,3,54,18.875,-84.375,3,0,3
2012-04,3,55,18.875,-84.125,1,0,1
2012-04,3,71,18.875,-80.125,8,0,8
2012-04,4,52,19.125,-84.875,2,0,2
2012-04,4,53,19.125,-84.625,1,0,1
2012-04,4,68,19.125,-80.875,1,0,1
2012-04,4,69,19.125,-80.625,9,0,9
2012-04,4,70,19.125,-80.375,7,0,7
2012-04,4,71,19.125,-80.125,1,0,1
2012-04,5,13,19.375,-94.625,0,3,3
2012-04,5,14,19.375,-94.375,0,3,3
2012-04,5,69,19.375,-80.625,1,0,1
2012-04,6,12,19.625,-94.875,0,1,1
2012-04,6,13,19.625,-94.625,0,1,1
2012-04,6,14,19.625,-94.375,0,6,6
2012-04,7,16,19.875,-93.875,0,1,1
2012-04,8,16,20.125,-93.875,0,2,2
2012-04,11,55,20.875,-84.125,0,2,2
2012-04,11,56,20.875,-83.875,0,7,7
2012-04,12,56,21.125,-83.875,0,8,8
2012-04,12,57,21.125,-83.625,0,5,5
2012-04,14,9,21.625,-95.625,5,0,5
2012-04,14,11,21.625,-95.125,5,0,5
2012-04,14,12,21.625,-94.875,8,0,8
2012-04,15,10,21.875,-95.375,3,0,3
2012-04,15,11,21.875,-95.125,7,0,7
2012-04,15,12,21.875,-94.875,2,0,2
2012-04,20,16,23.125,-93.875,3,0,3
2012-04,20,17,23.125,-93.625,2,0,2
2012-04,21,45,23.375,-86.625,2,0,2
2012-04,22,7,23.625,-96.125,0,1,1
2012-04,22,44,23.625,-86.875,2,0,2
2012-04,22,55,23.625,-84.125,0,4,4
2012-04,23,7,23.875,-96.125,0,2,2
2012-04,23,8,23.875,-95.875,0,6,6
2012-04,23,41,23.875,-87.625,4,0,4
2012-04,23,43,23.875,-87.125,7,0,7
2012-04,23,54,23.875,-84.375,0,2,2
2012-04,23,55,23.875,-84.125,2,2,4
2012-04,23,56,23.875,-83.875,4,0,4
2012-04,23,57,23.875,-83.625,3,0,3
2012-04,23,58,23.875,-83.375,3,0,3
2012-04,23,60,23.875,-82.875,1,0,1
2012-04,23,61,23.875,-82.625,2,0,2
2012-04,23,62,23.875,-82.375,5,0,5
2012-04,24,8,24.125,-95.875,0,3,3
2012-04,24,26,24.125,-91.375,0,3,3
2012-04,24,27,24.125,-91.125,0,8,8
2012-04,24,41,24.125,-87.625,8,0,8
2012-04,24,42,24.125,-87.375,7,0,7
2012-04,24,54,24.125,-84.375,0,1,1
2012-04,24,55,24.125,-84.125,3,0,3
2012-04,24,62,24.125,-82.375,1,0,1
2012-04,25,8,24.375,-95.875,0,2,2
2012-04,25,9,24.375,-95.625,0,5,5
2012-04,25,28,24.375,-90.875,0,7,7
2012-04,25,29,24.375,-90.625,0,10,10
2012-04,26,9,24.625,-95.625,0,4,4
2012-04,26,10,24.625,-95.375,0,2,2
2012-04,26,29,24.625,-90.625,0,2,2
2012-04,27,11,24.875,-95.125,0,4,4
2012-04,27,12,24.875,-94.875,0,1,1
2012-04,27,52,24.875,-84.875,6,0,6
2012-04,28,46,25.125,-86.375,0,6,6
2012-04,28,52,25.125,-84.875,3,0,3
2012-04,28,53,25.125,-84.625,1,0,1
2012-04,29,46,25.375,-86.375,0,9,9
2012-04,29,52,25.375,-84.875,1,0,1
2012-04,29,53,25.375,-84.625,1,0,1
2012-04,30,46,25.625,-86.375,0,5,5
2012-04,30,52,25.625,-84.875,1,0,1
2012-04,31,46,25.875,-86.375,0,5,5
2012-04,31,52,25.875,-84.875,3,0,3
2012-04,32,13,26.125,-94.625,1,0,1
2012-04,32,14,26.125,-94.375,8,0,8
2012-04,32,46,26.125,-86.375,0,5,5
2012-04,32,51,26.125,-85.125,7,0,7
2012-04,32,52,26.125,-84.875,1,0,1
2012-04,33,14,26.375,-94.375,21,0,21
2012-04,33,36,26.375,-88.875,30,0,30
2012-04,33,50,26.375,-85.375,4,0,4
2012-04,34,23,26.625,-92.125,4,0,4
2012-04,34,24,26.625,-91.875,21,0,21
2012-04,34,25,26.625,-91.625,5,0,5
2012-04,34,50,26.625,-85.375,2,0,2
2012-04,40,40,28.125,-87.875,0,1,1
2012-04,41,35,28.375,-89.125,0,2,2
2012-04,41,36,28.375,-88.875,0,3,3
2012-04,41,37,28.375,-88.625,0,4,4
2012-04,41,38,28.375,-88.375,0,2,2
2012-04,41,39,28.375,-88.125,0,1,1
2012-04,41,40,28.375,-87.875,0,11,11
2012-04,41,43,28.375,-87.125,1,0,1
2012-04,41,44,28.375,-86.875,1,0,1
2012-04,42,39,28.625,-88.125,0,6,6
2012-04,42,43,28.625,-87.125,5,0,5
2012-04,42,44,28.625,-86.875,2,0,2
2012-04,42,45,28.625,-86.625,5,0,5
2012-04,42,46,28.625,-86.375,11,0,11
2012-04,43,43,28.875,-87.125,3,0,3
2012-04,43,44,28.875,-86.875,2,0,2
2012-05,2,61,18.625,-82.625,2,0,2
2012-05,2,62,18.625,-82.375,4,0,4
2012-05,2,63,18.625,-82.125,6,0,6
2012-05,2,64,18.625,-81.875,1,0,1
2012-05,3,61,18.875,-82.625,1,0,1
2012-05,3,64,18.875,-81.875,9,0,9
2012-05,3,65,18.875,-81.625,2,0,2
2012-05,3,66,18.875,-81.375,2,0,2
2012-05,4,49,19.125,-85.625,1,0,1
2012-05,4,50,19.125,-85.375,5,0,5
2012-05,4,51,19.125,-85.125,1,0,1
2012-05,4,52,19.125,-84.875,1,0,1
2012-05,4,68,19.125,-80.875,1,0,1
2012-05,5,49,19.375,-85.625,5,0,5
2012-05,6,48,19.625,-85.875,8,0,8
2012-05,7,47,19.875,-86.125,3,0,3
2012-05,7,48,19.875,-85.875,2,0,2
2012-05,8,16,20.125,-93.875,0,7,7
2012-05,8,17,20.125,-93.625,0,2,2
2012-05,8,47,20.125,-86.125,4,0,4
2012-05,9,17,20.375,-93.625,0,1,1
2012-05,9,18,20.375,-93.375,0,6,6
2012-05,9,19,20.375,-93.125,0,1,1
2012-05,9,47,20.375,-86.125,1,0,1
2012-05,10,8,20.625,-95.875,2,0,2
2012-05,10,15,20.625,-94.125,0,2,2
2012-05,10,16,20.625,-93.875,0,4,4
2012-05,10,17,20.625,-93.625,0,6,6
2012-05,10,18,20.625,-93.375,0,1,1
2012-05,11,8,20.875,-95.875,6,0,6
2012-05,11,55,20.875,-84.125,0,7,7
2012-05,11,56,20.875,-83.875,0,3,3
2012-05,12,8,21.125,-95.875,6,0,6
2012-05,12,54,21.125,-84.375,0,3,3
2012-05,12,55,21.125,-84.125,0,9,9
2012-05,12,56,21.125,-83.875,0,8,8
2012-05,13,8,21.375,-95.875,9,0,9
2012-05,14,8,21.625,-95.875,6,0,6
2012-05,14,9,21.625,-95.625,2,0,2
2012-05,18,39,22.625,-88.125,1,0,1
2012-05,20,16,23.125,-93.875,3,0,3
2012-05,21,10,23.375,-95.375,3,0,3
2012-05,21,11,23.375,-95.125,3,0,3
2012-05,21,13,23.375,-94.625,1,0,1
2012-05,21,14,23.375,-94.375,3,0,3
2012-05,21,15,23.375,-94.125,8,0,8
2012-05,21,53,23.375,-84.625,0,3,3
2012-05,21,54,23.375,-84.375,0,2,2
2012-05,22,12,23.625,-94.875,3,0,3
2012-05,22,13,23.625,-94.625,3,0,3
2012-05,22,14,23.625,-94.375,2,0,2
2012-05,22,57,23.625,-83.625,0,1,1
2012-05,22,58,23.625,-83.375,0,1,1
2012-05,22,59,23.625,-83.125,0,3,3
2012-05,22,60,23.625,-82.875,0,2,2
2012-05,23,21,23.875,-92.625,0,14,14
2012-05,23,22,23.875,-92.375,0,5,5
2012-05,23,23,23.875,-92.125,0,3,3
2012-05,23,24,23.875,-91.875,0,2,2
2012-05,23,41,23.875,-87.625,3,0,3
2012-05,23,52,23.875,-84.875,9,0,9
2012-05,23,60,23.875,-82.875,0,2,2
2012-05,23,61,23.875,-82.625,0,6,6
2012-05,23,62,23.875,-82.375,1,3,4
2012-05,23,63,23.875,-82.125,3,0,3
2012-05,23,65,23.875,-81.625,2,0,2
2012-05,23,66,23.875,-81.375,3,0,3
2012-05,23,67,23.875,-81.125,2,0,2
2012-05,23,68,23.875,-80.875,1,0,1
2012-05,24,24,24.125,-91.875,0,2,2
2012-05,24,25,24.125,-91.625,0,4,4
2012-05,24,26,24.125,-91.375,0,1,1
2012-05,24,52,24.125,-84.875,3,0,3
2012-05,24,69,24.125,-80.625,2,0,2
2012-05,24,70,24.125,-80.375,4,0,4
2012-05,25,52,24.375,-84.875,5,0,5
2012-05,25,70,24.375,-80.375,3,0,3
2012-05,25,71,24.375,-80.125,1,0,1
2012-05,26,52,24.625,-84.875,6,0,6
2012-05,26,53,24.625,-84.625,4,0,4
2012-05,27,11,24.875,-95.125,0,1,1
2012-05,27,53,24.875,-84.625,4,0,4
2012-05,28,9,25.125,-95.625,0,1,1
2012-05,29,9,25.375,-95.625,0,1,1
2012-05,30,46,25.625,-86.375,0,17,17
2012-05,31,46,25.875,-86.375,0,13,13
2012-05,32,34,26.125,-89.375,10,0,10
2012-05,32,35,26.125,-89.125,5,0,5
2012-05,32,46,26.125,-86.375,0,1,1
2012-05,33,18,26.375,-93.375,13,0,13
2012-05,33,19,26.375,-93.125,9,0,9
2012-05,33,20,26.375,-92.875,9,0,9
2012-05,33,35,26.375,-89.125,2,0,2
2012-05,33,36,26.375,-88.875,7,0,7
2012-05,34,36,26.625,-88.875,1,0,1
2012-05,34,37,26.625,-88.625,6,0,6
2012-05,39,14,27.875,-94.375,0,1,1
2012-05,39,15,27.875,-94.125,0,1,1
2012-05,39,43,27.875,-87.125,3,0,3
2012-05,40,14,28.125,-94.375,0,2,2
2012-05,40,15,28.125,-94.125,0,1,1
2012-05,40,33,28.125,-89.625,0,1,1
2012-05,40,34,28.125,-89.375,0,2,2
2012-05,40,35,28.125,-89.125,0,6,6
2012-05,40,36,28.125,-88.875,0,19,19
2012-05,41,36,28.375,-88.875,0,3,3
2012-05,41,44,28.375,-86.875,1,0,1
2012-06,0,49,18.125,-85.625,0,4,4
2012-06,1,48,18.375,-85.875,0,2,2
2012-06,1,49,18.375,-85.625,0,4,4
2012-06,1,59,18.375,-83.125,2,0,2
2012-06,2,59,18.625,-83.125,2,0,2
2012-06,2,60,18.625,-82.875,3,0,3
2012-06,5,62,19.375,-82.375,0,4,4
2012-06,5,63,19.375,-82.125,0,5,5
2012-06,5,64,19.375,-81.875,0,4,4
2012-06,5,65,19.375,-81.625,0,2,2
2012-06,5,66,19.375,-81.375,0,1,1
2012-06,6,63,19.625,-82.125,0,5,5
2012-06,7,54,19.875,-84.375,4,0,4
2012-06,9,8,20.375,-95.875,6,0,6
2012-06,9,9,20.375,-95.625,2,0,2
2012-06,9,47,20.375,-86.125,1,0,1
2012-06,10,8,20.625,-95.875,2,0,2
2012-06,10,10,20.625,-95.375,1,0,1
2012-06,10,16,20.625,-93.875,0,3,3
2012-06,10,47,20.625,-86.125,1,0,1
2012-06,11,8,20.875,-95.875,2,0,2
2012-06,11,9,20.875,-95.625,8,0,8
2012-06,11,10,20.875,-95.375,6,0,6
2012-06,11,16,20.875,-93.875,0,5,5
2012-06,11,47,20.875,-86.125,2,0,2
2012-06,11,53,20.875,-84.625,0,3,3
2012-06,12,16,21.125,-93.875,0,4,4
2012-06,12,20,21.125,-92.875,1,0,1
2012-06,12,53,21.125,-84.625,0,5,5
2012-06,12,54,21.125,-84.375,0,11,11
2012-06,13,20,21.375,-92.875,3,0,3
2012-06,13,21,21.375,-92.625,5,0,5
2012-06,13,22,21.375,-92.375,1,0,1
2012-06,13,23,21.375,-92.125,4,0,4
2012-06,18,39,22.625,-88.125,5,0,5
2012-06,19,38,22.875,-88.375,6,0,6
2012-06,19,39,22.875,-88.125,12,0,12
2012-06,20,38,23.125,-88.375,4,0,4
2012-06,21,7,23.375,-96.125,3,0,3
2012-06,21,8,23.375,-95.875,12,0,12
2012-06,21,9,23.375,-95.625,7,0,7
2012-06,21,10,23.375,-95.375,4,0,4
2012-06,22,7,23.625,-96.125,1,0,1
2012-06,22,8,23.625,-95.875,1,0,1
2012-06,22,9,23.625,-95.625,1,0,1
2012-06,22,17,23.625,-93.625,0,7,7
2012-06,22,49,23.625,-85.625,5,0,5
2012-06,22,50,23.625,-85.375,3,0,3
2012-06,23,8,23.875,-95.875,1,0,1
2012-06,23,18,23.875,-93.375,0,6,6
2012-06,23,19,23.875,-93.125,0,8,8
2012-06,23,20,23.875,-92.875,0,7,7
2012-06,23,21,23.875,-92.625,0,2,2
2012-06,23,50,23.875,-85.375,4,0,4
2012-06,23,51,23.875,-85.125,6,0,6
2012-06,23,52,23.875,-84.875,12,0,12
2012-06,23,59,23.875,-83.125,0,1,1
2012-06,23,60,23.875,-82.875,0,4,4
2012-06,23,61,23.875,-82.625,0,1,1
2012-06,23,62,23.875,-82.375,0,6,6
2012-06,24,59,24.125,-83.125,0,1,1
2012-06,24,60,24.125,-82.875,0,1,1
2012-06,28,9,25.125,-95.625,0,1,1
2012-06,29,8,25.375,-95.875,0,8,8
2012-06,29,9,25.375,-95.625,0,11,11
2012-06,30,9,25.625,-95.625,0,8,8
2012-06,30,41,25.625,-87.625,0,5,5
2012-06,30,42,25.625,-87.375,0,5,5
2012-06,30,43,25.625,-87.125,0,2,2
2012-06,31,9,25.875,-95.625,0,1,1
2012-06,31,10,25.875,-95.375,0,1,1
2012-06,31,43,25.875,-87.125,0,2,2
2012-06,31,44,25.875,-86.875,0,5,5
2012-06,31,45,25.875,-86.625,0,11,11
2012-06,32,20,26.125,-92.875,3,0,3
2012-06,32,32,26.125,-89.875,9,0,9
2012-06,32,33,26.125,-89.625,7,0,7
2012-06,32,34,26.125,-89.375,2,0,2
2012-06,33,20,26.375,-92.875,27,0,27
2012-06,33,31,26.375,-90.125,5,0,5
2012-06,33,32,26.375,-89.875,1,0,1
2012-06,34,31,26.625,-90.125,5,0,5
2012-06,34,32,26.625,-89.875,1,0,1
2012-06,36,11,27.125,-95.125,0,1,1
2012-06,36,12,27.125,-94.875,0,2,2
2012-06,36,13,27.125,-94.625,0,5,5
2012-06,36,14,27.125,-94.375,0,1,1
2012-06,38,47,27.625,-86.125,1,0,1
2012-06,39,14,27.875,-94.375,0,8,8
2012-06,39,35,27.875,-89.125,0,2,2
2012-06,39,43,27.875,-87.125,2,0,2
2012-06,39,44,27.875,-86.875,1,0,1
2012-06,39,45,27.875,-86.625,5,0,5
2012-06,39,46,27.875,-86.375,14,0,14
2012-06,39,47,27.875,-86.125,2,0,2
2012-06,40,44,28.125,-86.875,1,0,1
2012-06,40,45,28.125,-86.625,4,0,4
2012-07,0,64,18.125,-81.875,1,0,1
2012-07,0,65,18.125,-81.625,2,0,2
2012-07,1,46,18.375,-86.375,0,1,1
2012-07,1,47,18.375,-86.125,0,1,1
2012-07,1,48,18.375,-85.875,0,3,3
2012-07,1,71,18.375,-80.125,0,5,5
2012-07,2,45,18.625,-86.625,0,2,2
2012-07,2,46,18.625,-86.375,0,5,5
2012-07,2,47,18.625,-86.125,0,2,2
2012-07,2,48,18.625,-85.875,0,1,1
2012-07,2,70,18.625,-80.375,0,3,3
2012-07,3,45,18.875,-86.625,0,3,3
2012-07,3,46,18.875,-86.375,0,1,1
2012-07,5,62,19.375,-82.375,0,1,1
2012-07,6,52,19.625,-84.875,1,0,1
2012-07,6,53,19.625,-84.625,4,0,4
2012-07,6,54,19.625,-84.375,1,0,1
2012-07,6,61,19.625,-82.625,0,2,2
2012-07,6,62,19.625,-82.375,0,4,4
2012-07,7,45,19.875,-86.625,0,1,1
2012-07,7,52,19.875,-84.875,3,0,3
2012-07,7,53,19.875,-84.625,6,0,6
2012-07,7,55,19.875,-84.125,0,4,4
2012-07,7,56,19.875,-83.875,0,5,5
2012-07,7,60,19.875,-82.875,0,3,3
2012-07,7,61,19.875,-82.625,0,1,1
2012-07,8,52,20.125,-84.875,5,0,5
2012-07,8,57,20.125,-83.625,0,4,4
2012-07,8,58,20.125,-83.375,0,4,4
2012-07,8,59,20.125,-83.125,0,3,3
2012-07,9,51,20.375,-85.125,2,0,2
2012-07,9,52,20.375,-84.875,3,0,3
2012-07,10,51,20.625,-85.125,2,0,2
2012-07,11,6,20.875,-96.375,3,0,3
2012-07,11,7,20.875,-96.125,4,0,4
2012-07,11,8,20.875,-95.875,4,0,4
2012-07,11,65,20.875,-81.625,3,0,3
2012-07,12,17,21.125,-93.625,5,0,5
2012-07,12,18,21.125,-93.375,7,0,7
2012-07,12,19,21.125,-93.125,4,0,4
2012-07,12,20,21.125,-92.875,1,0,1
2012-07,12,64,21.125,-81.875,3,0,3
2012-07,12,65,21.125,-81.625,1,0,1
2012-07,13,15,21.375,-94.125,6,0,6
2012-07,13,16,21.375,-93.875,5,0,5
2012-07,13,17,21.375,-93.625,3,0,3
2012-07,13,63,21.375,-82.125,1,0,1
2012-07,13,64,21.375,-81.875,3,0,3
2012-07,14,62,21.625,-82.375,1,0,1
2012-07,19,10,22.875,-95.375,0,4,4
2012-07,19,11,22.875,-95.125,0,4,4
2012-07,19,12,22.875,-94.875,0,2,2
2012-07,20,12,23.125,-94.875,0,3,3
2012-07,20,13,23.125,-94.625,0,4,4
2012-07,20,14,23.125,-94.375,0,1,1
2012-07,21,14,23.375,-94.375,0,4,4
2012-07,21,15,23.375,-94.125,0,4,4
2012-07,21,16,23.375,-93.875,0,1,1
2012-07,21,24,23.375,-91.875,1,0,1
2012-07,21,25,23.375,-91.625,5,0,5
2012-07,21,26,23.375,-91.375,4,0,4
2012-07,21,49,23.375,-85.625,13,0,13
2012-07,22,16,23.625,-93.875,0,4,4
2012-07,22,27,23.625,-91.125,4,0,4
2012-07,22,49,23.625,-85.625,9,0,9
2012-07,22,58,23.625,-83.375,0,4,4
2012-07,23,8,23.875,-95.875,5,0,5
2012-07,23,49,23.875,-85.625,2,0,2
2012-07,23,57,23.875,-83.625,0,3,3
2012-07,23,58,23.875,-83.375,0,15,15
2012-07,23,59,23.875,-83.125,0,6,6
2012-07,24,8,24.125,-95.875,4,0,4
2012-07,24,48,24.125,-85.875,3,0,3
2012-07,24,49,24.125,-85.625,4,0,4
2012-07,24,58,24.125,-83.375,0,3,3
2012-07,25,8,24.375,-95.875,4,0,4
2012-07,25,9,24.375,-95.625,3,0,3
2012-07,26,9,24.625,-95.625,8,0,8
2012-07,30,37,25.625,-88.625,0,1,1
2012-07,30,38,25.625,-88.375,0,10,10
2012-07,30,39,25.625,-88.125,0,10,10
2012-07,30,40,25.625,-87.875,0,5,5
2012-07,30,41,25.625,-87.625,0,5,5
2012-07,31,9,25.875,-95.625,0,4,4
2012-07,31,10,25.875,-95.375,0,1,1
2012-07,32,9,26.125,-95.625,0,14,14
2012-07,32,10,26.125,-95.375,0,10,10
2012-07,32,20,26.125,-92.875,25,0,25
2012-07,32,21,26.125,-92.625,6,0,6
2012-07,32,47,26.125,-86.125,0,1,1
2012-07,33,10,26.375,-95.375,0,2,2
2012-07,33,29,26.375,-90.625,4,0,4
2012-07,33,32,26.375,-89.875,2,0,2
2012-07,33,49,26.375,-85.625,0,2,2
2012-07,33,50,26.375,-85.375,0,2,2
2012-07,34,29,26.625,-90.625,1,0,1
2012-07,34,31,26.625,-90.125,4,0,4
2012-07,34,32,26.625,-89.875,9,0,9
2012-07,34,51,26.625,-85.125,0,9,9
2012-07,35,30,26.875,-90.375,2,0,2
2012-07,35,31,26.875,-90.125,5,0,5
2012-07,35,51,26.875,-85.125,0,2,2
2012-07,36,51,27.125,-85.125,0,2,2
2012-07,37,52,27.375,-84.875,0,1,1
2012-07,38,45,27.625,-86.625,2,0,2
2012-07,38,46,27.625,-86.375,5,0,5
2012-07,39,45,27.875,-86.625,2,0,2
2012-07,39,46,27.875,-86.375,22,0,22
2012-08,0,44,18.125,-86.875,1,0,1
2012-08,0,45,18.125,-86.625,3,0,3
2012-08,0,46,18.125,-86.375,5,0,5
2012-08,0,47,18.125,-86.125,4,0,4
2012-08,0,68,18.125,-80.875,0,3,3
2012-08,0,69,18.125,-80.625,0,5,5
2012-08,0,70,18.125,-80.375,0,5,5
2012-08,0,71,18.125,-80.125,0,3,3
2012-08,1,44,18.375,-86.875,4,0,4
2012-08,1,45,18.375,-86.625,13,0,13
2012-08,1,68,18.375,-80.875,0,1,1
2012-08,1,70,18.375,-80.375,0,1,1
2012-08,1,71,18.375,-80.125,0,2,2
2012-08,2,71,18.625,-80.125,2,0,2
2012-08,8,53,20.125,-84.625,0,3,3
2012-08,8,54,20.125,-84.375,0,16,16
2012-08,8,55,20.125,-84.125,0,1,1
2012-08,9,53,20.375,-84.625,0,1,1
2012-08,9,54,20.375,-84.375,0,10,10
2012-08,9,61,20.375,-82.625,5,0,5
2012-08,10,15,20.625,-94.125,2,0,2
2012-08,10,61,20.625,-82.625,8,0,8
2012-08,10,62,20.625,-82.375,4,0,4
2012-08,11,13,20.875,-94.625,8,0,8
2012-08,11,14,20.875,-94.375,8,0,8
2012-08,11,15,20.875,-94.125,9,0,9
2012-08,11,63,20.875,-82.125,1,0,1
2012-08,11,64,20.875,-81.875,3,0,3
2012-08,11,65,20.875,-81.625,5,0,5
2012-08,12,14,21.125,-94.375,3,0,3
2012-08,12,15,21.125,-94.125,1,0,1
2012-08,12,66,21.125,-81.375,4,0,4
2012-08,19,8,22.875,-95.875,0,8,8
2012-08,19,9,22.875,-95.625,0,6,6
2012-08,19,10,22.875,-95.375,0,1,1
2012-08,20,7,23.125,-96.125,0,7,7
2012-08,20,8,23.125,-95.875,0,1,1
2012-08,21,6,23.375,-96.375,0,3,3
2012-08,21,7,23.375,-96.125,0,5,5
2012-08,21,21,23.375,-92.625,3,0,3
2012-08,21,22,23.375,-92.375,1,0,1
2012-08,21,23,23.375,-92.125,6,0,6
2012-08,21,24,23.375,-91.875,4,0,4
2012-08,22,20,23.625,-92.875,10,0,10
2012-08,22,21,23.625,-92.625,7,0,7
2012-08,22,59,23.625,-83.125,0,5,5
2012-08,23,48,23.875,-85.875,6,0,6
2012-08,23,49,23.875,-85.625,11,0,11
2012-08,23,58,23.875,-83.375,0,3,3
2012-08,23,59,23.875,-83.125,0,9,9
2012-08,23,60,23.875,-82.875,0,8,8
2012-08,24,48,24.125,-85.875,10,0,10
2012-08,24,49,24.125,-85.625,4,0,4
2012-08,24,58,24.125,-83.375,0,2,2
2012-08,24,59,24.125,-83.125,0,1,1
2012-08,25,59,24.375,-83.125,0,1,1
2012-08,30,36,25.625,-88.875,0,3,3
2012-08,30,37,25.625,-88.625,0,10,10
2012-08,31,8,25.875,-95.875,0,1,1
2012-08,31,9,25.875,-95.625,0,1,1
2012-08,31,35,25.875,-89.125,0,1,1
2012-08,31,36,25.875,-88.875,0,11,11
2012-08,32,8,26.125,-95.875,0,1,1
2012-08,32,9,26.125,-95.625,0,2,2
2012-08,32,17,26.125,-93.625,2,0,2
2012-08,32,18,26.125,-93.375,5,0,5
2012-08,32,19,26.125,-93.125,7,0,7
2012-08,32,20,26.125,-92.875,6,0,6
2012-08,32,21,26.125,-92.625,11,0,11
2012-08,32,35,26.125,-89.125,0,4,4
2012-08,32,36,26.125,-88.875,0,2,2
2012-08,33,8,26.375,-95.875,0,3,3
2012-08,34,8,26.625,-95.875,0,2,2
2012-08,34,43,26.625,-87.125,5,0,5
2012-08,34,44,26.625,-86.875,2,0,2
2012-08,35,43,26.875,-87.125,11,0,11
2012-08,36,7,27.125,-96.125,0,9,9
2012-08,36,8,27.125,-95.875,0,2,2
2012-08,36,44,27.125,-86.875,2,0,2
2012-08,37,7,27.375,-96.125,0,8,8
2012-08,37,44,27.375,-86.875,1,0,1
2012-08,37,45,27.375,-86.625,1,0,1
2012-08,37,51,27.375,-85.125,0,1,1
2012-08,38,45,27.625,-86.625,5,0,5
2012-08,38,51,27.625,-85.125,0,6,6
2012-08,38,52,27.625,-84.875,0,2,2
2012-08,39,49,27.875,-85.625,0,3,3
2012-08,39,50,27.875,-85.375,0,1,1
2012-08,39,51,27.875,-85.125,0,2,2
2012-08,39,53,27.875,-84.625,0,1,1
2012-08,40,49,28.125,-85.625,0,1,1
2012-08,40,53,28.125,-84.625,0,1,1
2012-08,40,54,28.125,-84.375,0,3,3
2012-08,41,54,28.375,-84.375,0,3,3
2012-08,41,55,28.375,-84.125,0,1,1
2012-09,1,44,18.375,-86.875,1,0,1
2012-09,1,45,18.375,-86.625,1,0,1
2012-09,2,70,18.625,-80.375,2,0,2
2012-09,2,71,18.625,-80.125,4,0,4
2012-09,3,69,18.875,-80.625,1,0,1
2012-09,3,70,18.875,-80.375,5,0,5
2012-09,4,69,19.125,-80.625,8,0,8
2012-09,4,70,19.125,-80.375,2,0,2
2012-09,4,71,19.125,-80.125,6,0,6
2012-09,8,51,20.125,-85.125,0,1,1
2012-09,8,52,20.125,-84.875,0,1,1
2012-09,8,53,20.125,-84.625,0,2,2
2012-09,8,57,20.125,-83.625,3,0,3
2012-09,8,58,20.125,-83.375,4,0,4
2012-09,9,48,20.375,-85.875,0,5,5
2012-09,9,49,20.375,-85.625,0,3,3
2012-09,9,50,20.375,-85.375,0,10,10
2012-09,9,51,20.375,-85.125,0,8,8
2012-09,9,58,20.375,-83.375,1,0,1
2012-09,9,59,20.375,-83.125,4,0,4
2012-09,9,60,20.375,-82.875,4,0,4
2012-09,9,64,20.375,-81.875,0,3,3
2012-09,10,60,20.625,-82.875,3,0,3
2012-09,10,63,20.625,-82.125,0,4,4
2012-09,10,64,20.625,-81.875,0,1,1
2012-09,11,12,20.875,-94.875,8,0,8
2012-09,11,13,20.875,-94.625,2,0,2
2012-09,11,61,20.875,-82.625,0,5,5
2012-09,11,62,20.875,-82.375,0,1,1
2012-09,12,61,21.125,-82.625,0,3,3
2012-09,18,30,22.625,-90.375,1,0,1
2012-09,19,29,22.875,-90.625,1,0,1
2012-09,19,30,22.875,-90.375,8,0,8
2012-09,20,29,23.125,-90.625,1,0,1
2012-09,21,6,23.375,-96.375,0,10,10
2012-09,21,19,23.375,-93.125,5,0,5
2012-09,21,29,23.375,-90.625,1,0,1
2012-09,22,6,23.625,-96.375,0,3,3
2012-09,22,7,23.625,-96.125,0,1,1
2012-09,22,19,23.625,-93.125,2,0,2
2012-09,22,20,23.625,-92.875,3,0,3
2012-09,22,28,23.625,-90.875,3,0,3
2012-09,22,58,23.625,-83.375,0,3,3
2012-09,22,59,23.625,-83.125,0,8,8
2012-09,23,7,23.875,-96.125,0,2,2
2012-09,23,27,23.875,-91.125,2,0,2
2012-09,23,48,23.875,-85.875,5,0,5
2012-09,23,49,23.875,-85.625,5,0,5
2012-09,23,58,23.875,-83.375,0,1,1
2012-09,23,59,23.875,-83.125,0,14,14
2012-09,23,60,23.875,-82.875,0,2,2
2012-09,24,8,24.125,-95.875,0,1,1
2012-09,24,9,24.125,-95.625,0,9,9
2012-09,24,10,24.125,-95.375,0,1,1
2012-09,24,27,24.125,-91.125,4,0,4
2012-09,24,48,24.125,-85.875,4,0,4
2012-09,25,10,24.375,-95.375,0,3,3
2012-09,25,27,24.375,-91.125,2,0,2
2012-09,25,48,24.375,-85.875,16,0,16
2012-09,26,37,24.625,-88.625,0,4,4
2012-09,27,37,24.875,-88.625,0,15,15
2012-09,28,37,25.125,-88.625,0,6,6
2012-09,29,36,25.375,-88.875,0,2,2
2012-09,30,36,25.625,-88.875,0,3,3
2012-09,31,15,25.875,-94.125,15,0,15
2012-09,31,16,25.875,-93.875,11,0,11
2012-09,31,17,25.875,-93.625,2,0,2
2012-09,31,44,25.875,-86.875,1,0,1
2012-09,32,16,26.125,-93.875,1,0,1
2012-09,32,17,26.125,-93.625,1,0,1
2012-09,32,44,26.125,-86.875,5,0,5
2012-09,33,44,26.375,-86.875,4,0,4
2012-09,34,5,26.625,-96.625,0,2,2
2012-09,34,27,26.625,-91.125,0,10,10
2012-09,35,5,26.875,-96.625,0,6,6
2012-09,35,6,26.875,-96.375,0,3,3
2012-09,35,27,26.875,-91.125,0,2,2
2012-09,35,28,26.875,-90.875,0,5,5
2012-09,35,29,26.875,-90.625,0,4,4
2012-09,36,6,27.125,-96.375,0,1,1
2012-09,36,7,27.125,-96.125,0,7,7
2012-09,38,49,27.625,-85.625,0,1,1
2012-09,39,47,27.875,-86.125,0,2,2
2012-09,39,48,27.875,-85.875,0,2,2
2012-09,39,49,27.875,-85.625,0,3,3
2012-09,39,50,27.875,-85.375,0,8,8
2012-09,40,47,28.125,-86.125,0,10,10
2012-09,40,49,28.125,-85.625,0,1,1
2012-10,0,50,18.125,-85.375,0,2,2
2012-10,0,51,18.125,-85.125,0,1,1
2012-10,0,69,18.125,-80.625,1,0,1
2012-10,0,70,18.125,-80.375,3,0,3
2012-10,0,71,18.125,-80.125,1,0,1
2012-10,1,52,18.375,-84.875,0,1,1
2012-10,1,62,18.375,-82.375,1,0,1
2012-10,2,60,18.625,-82.875,1,0,1
2012-10,2,61,18.625,-82.625,4,0,4
2012-10,2,62,18.625,-82.375,1,0,1
2012-10,3,60,18.875,-82.875,1,0,1
2012-10,6,50,19.625,-85.375,1,0,1
2012-10,7,46,19.875,-86.375,2,0,2
2012-10,7,49,19.875,-85.625,3,0,3
2012-10,7,50,19.875,-85.375,5,0,5
2012-10,8,48,20.125,-85.875,5,0,5
2012-10,8,49,20.125,-85.625,2,0,2
2012-10,9,9,20.375,-95.625,3,0,3
2012-10,9,10,20.375,-95.375,9,0,9
2012-10,9,11,20.375,-95.125,3,0,3
2012-10,9,46,20.375,-86.375,0,3,3
2012-10,9,47,20.375,-86.125,0,5,5
2012-10,10,9,20.625,-95.625,9,0,9
2012-10,11,47,20.875,-86.125,0,1,1
2012-10,11,61,20.875,-82.625,0,5,5
2012-10,11,62,20.875,-82.375,0,1,1
2012-10,12,47,21.125,-86.125,0,1,1
2012-10,12,61,21.125,-82.625,0,5,5
2012-10,18,12,22.625,-94.875,2,0,2
2012-10,18,13,22.625,-94.625,1,0,1
2012-10,18,18,22.625,-93.375,0,2,2
2012-10,19,11,22.875,-95.125,4,0,4
2012-10,19,12,22.875,-94.875,2,0,2
2012-10,20,9,23.125,-95.625,1,0,1
2012-10,20,10,23.125,-95.375,4,0,4
2012-10,20,18,23.125,-93.375,0,6,6
2012-10,20,19,23.125,-93.125,0,1,1
2012-10,21,8,23.375,-95.875,4,0,4
2012-10,21,9,23.375,-95.625,5,0,5
2012-10,21,18,23.375,-93.375,0,5,5
2012-10,22,8,23.625,-95.875,1,0,1
2012-10,22,17,23.625,-93.625,0,4,4
2012-10,22,57,23.625,-83.625,0,7,7
2012-10,22,58,23.625,-83.375,0,1,1
2012-10,23,16,23.875,-93.875,0,5,5
2012-10,23,57,23.875,-83.625,0,5,5
2012-10,23,58,23.875,-83.375,0,1,1
2012-10,24,48,24.125,-85.875,5,0,5
2012-10,24,58,24.125,-83.375,0,6,6
2012-10,25,10,24.375,-95.375,0,7,7
2012-10,25,11,24.375,-95.125,0,1,1
2012-10,25,26,24.375,-91.375,3,0,3
2012-10,25,27,24.375,-91.125,9,0,9
2012-10,25,35,24.375,-89.125,0,5,5
2012-10,25,36,24.375,-88.875,0,13,13
2012-10,25,37,24.375,-88.625,0,6,6
2012-10,25,48,24.375,-85.875,4,0,4
2012-10,25,58,24.375,-83.375,0,3,3
2012-10,26,37,24.625,-88.625,0,7,7
2012-10,26,46,24.625,-86.375,4,0,4
2012-10,26,47,24.625,-86.125,9,0,9
2012-10,26,58,24.625,-83.375,0,2,2
2012-10,27,46,24.875,-86.375,7,0,7
2012-10,27,47,24.875,-86.125,2,0,2
2012-10,30,17,25.625,-93.625,23,0,23
2012-10,31,17,25.875,-93.625,8,0,8
2012-10,34,26,26.625,-91.375,0,29,29
2012-10,34,27,26.625,-91.125,0,2,2
2012-10,38,54,27.625,-84.375,0,1,1
2012-10,39,45,27.875,-86.625,0,2,2
2012-10,39,46,27.875,-86.375,0,5,5
2012-10,39,47,27.875,-86.125,0,3,3
2012-10,39,48,27.875,-85.875,0,1,1
2012-10,39,52,27.875,-84.875,0,1,1
2012-10,39,53,27.875,-84.625,0,3,3
2012-10,40,43,28.125,-87.125,0,12,12
2012-10,40,44,28.125,-86.875,0,4,4
2012-10,40,45,28.125,-86.625,0,1,1
2012-10,40,47,28.125,-86.125,0,1,1
2012-10,40,52,28.125,-84.875,0,1,1
2012-11,0,49,18.125,-85.625,0,2,2
2012-11,0,50,18.125,-85.375,0,3,3
2012-11,0,70,18.125,-80.375,3,0,3
2012-11,0,71,18.125,-80.125,3,0,3
2012-11,1,49,18.375,-85.625,0,2,2
2012-11,1,58,18.375,-83.375,1,0,1
2012-11,1,69,18.375,-80.625,6,0,6
2012-11,2,49,18.625,-85.625,0,2,2
2012-11,3,49,18.875,-85.625,0,4,4
2012-11,3,50,18.875,-85.375,1,0,1
2012-11,3,51,18.875,-85.125,2,0,2
2012-11,3,52,18.875,-84.875,1,0,1
2012-11,3,53,18.875,-84.625,2,0,2
2012-11,3,54,18.875,-84.375,1,0,1
2012-11,3,60,18.875,-82.875,3,0,3
2012-11,4,54,19.125,-84.375,1,0,1
2012-11,4,55,19.125,-84.125,2,0,2
2012-11,4,56,19.125,-83.875,3,0,3
2012-11,4,57,19.125,-83.625,3,0,3
2012-11,4,58,19.125,-83.375,3,0,3
2012-11,4,59,19.125,-83.125,3,0,3
2012-11,4,60,19.125,-82.875,2,0,2
2012-11,4,61,19.125,-82.625,1,0,1
2012-11,5,61,19.375,-82.625,1,0,1
2012-11,7,46,19.875,-86.375,4,0,4
2012-11,7,63,19.875,-82.125,0,1,1
2012-11,8,63,20.125,-82.125,0,2,2
2012-11,9,8,20.375,-95.875,16,0,16
2012-11,9,9,20.375,-95.625,5,0,5
2012-11,10,8,20.625,-95.875,2,0,2
2012-11,10,9,20.625,-95.625,7,0,7
2012-11,18,15,22.625,-94.125,0,14,14
2012-11,18,16,22.625,-93.875,0,9,9
2012-11,18,17,22.625,-93.625,0,7,7
2012-11,20,41,23.125,-87.625,0,1,1
2012-11,21,40,23.375,-87.875,0,2,2
2012-11,21,41,23.375,-87.625,0,7,7
2012-11,22,7,23.625,-96.125,8,0,8
2012-11,22,8,23.625,-95.875,6,0,6
2012-11,22,40,23.625,-87.875,0,10,10
2012-11,23,7,23.875,-96.125,10,0,10
2012-11,23,8,23.875,-95.875,2,0,2
2012-11,23,39,23.875,-88.125,0,1,1
2012-11,23,40,23.875,-87.875,0,2,2
2012-11,24,7,24.125,-96.125,1,0,1
2012-11,24,8,24.125,-95.875,1,0,1
2012-11,24,57,24.125,-83.625,0,8,8
2012-11,25,33,24.375,-89.625,0,1,1
2012-11,25,34,24.375,-89.375,0,6,6
2012-11,25,57,24.375,-83.625,0,3,3
2012-11,25,58,24.375,-83.375,0,3,3
2012-11,26,57,24.625,-83.625,0,3,3
2012-11,26,58,24.625,-83.375,0,8,8
2012-11,26,59,24.625,-83.125,0,1,1
2012-11,27,45,24.875,-86.625,1,0,1
2012-11,27,46,24.875,-86.375,2,0,2
2012-11,27,58,24.875,-83.375,0,4,4
2012-11,28,45,25.125,-86.625,7,0,7
2012-11,29,14,25.375,-94.375,3,0,3
2012-11,29,15,25.375,-94.125,5,0,5
2012-11,29,16,25.375,-93.875,6,0,6
2012-11,29,44,25.375,-86.875,9,0,9
2012-11,29,45,25.375,-86.625,6,0,6
2012-11,30,14,25.625,-94.375,3,0,3
2012-11,30,15,25.625,-94.125,1,0,1
2012-11,30,16,25.625,-93.875,6,0,6
2012-11,30,17,25.625,-93.625,6,0,6
2012-11,30,26,25.625,-91.375,0,2,2
2012-11,30,27,25.625,-91.125,0,3,3
2012-11,30,43,25.625,-87.125,2,0,2
2012-11,30,44,25.625,-86.875,3,0,3
2012-11,31,24,25.875,-91.875,0,1,1
2012-11,31,25,25.875,-91.625,0,8,8
2012-11,31,26,25.875,-91.375,0,3,3
2012-11,32,24,26.125,-91.875,0,3,3
2012-11,34,25,26.625,-91.625,0,3,3
2012-11,34,26,26.625,-91.375,0,7,7
2012-11,39,43,27.875,-87.125,0,2,2
2012-11,39,44,27.875,-86.875,0,8,8
2012-11,39,53,27.875,-84.625,0,7,7
2012-11,39,54,27.875,-84.375,0,8,8
2012-11,40,41,28.125,-87.625,0,4,4
2012-11,40,42,28.125,-87.375,0,6,6
2012-11,40,44,28.125,-86.875,0,2,2
2012-11,40,52,28.125,-84.875,0,3,3
2012-11,40,53,28.125,-84.625,0,4,4
2012-11,40,54,28.125,-84.375,0,1,1
2012-11,41,40,28.375,-87.875,0,3,3
2012-11,41,41,28.375,-87.625,0,5,5
2012-11,41,51,28.375,-85.125,0,1,1
2012-11,41,52,28.375,-84.875,0,2,2
2012-11,41,53,28.375,-84.625,0,1,1
2012-11,41,54,28.375,-84.375,0,3,3
2012-12,1,68,18.375,-80.875,2,0,2
2012-12,1,69,18.375,-80.625,6,0,6
2012-12,1,70,18.375,-80.375,3,0,3
2012-12,2,67,18.625,-81.125,3,0,3
2012-12,2,68,18.625,-80.875,9,0,9
2012-12,3,50,18.875,-85.375,2,0,2
2012-12,3,63,18.875,-82.125,2,0,2
2012-12,3,64,18.875,-81.875,3,0,3
2012-12,3,65,18.875,-81.625,1,0,1
2012-12,3,66,18.875,-81.375,2,0,2
2012-12,4,49,19.125,-85.625,3,0,3
2012-12,4,50,19.125,-85.375,2,0,2
2012-12,5,49,19.375,-85.625,1,0,1
2012-12,5,50,19.375,-85.375,2,0,2
2012-12,6,50,19.625,-85.375,4,0,4
2012-12,7,62,19.875,-82.375,0,1,1
2012-12,8,50,20.125,-85.375,1,0,1
2012-12,8,51,20.125,-85.125,6,0,6
2012-12,8,52,20.125,-84.875,3,0,3
2012-12,8,63,20.125,-82.125,0,4,4
2012-12,9,9,20.375,-95.625,20,0,20
2012-12,9,10,20.375,-95.375,4,0,4
2012-12,9,11,20.375,-95.125,7,0,7
2012-12,9,50,20.375,-85.375,3,0,3
2012-12,9,63,20.375,-82.125,0,1,1
2012-12,9,64,20.375,-81.875,0,1,1
2012-12,10,48,20.625,-85.875,1,0,1
2012-12,10,49,20.625,-85.625,1,0,1
2012-12,10,50,20.625,-85.375,2,0,2
2012-12,12,64,21.125,-81.875,0,2,2
2012-12,12,65,21.125,-81.625,0,8,8
2012-12,12,66,21.125,-81.375,0,1,1
2012-12,13,63,21.375,-82.125,0,2,2
2012-12,13,64,21.375,-81.875,0,7,7
2012-12,17,14,22.375,-94.375,0,27,27
2012-12,17,15,22.375,-94.125,0,1,1
2012-12,18,15,22.625,-94.125,0,3,3
2012-12,19,42,22.875,-87.375,0,5,5
2012-12,20,41,23.125,-87.625,0,7,7
2012-12,21,41,23.375,-87.625,0,2,2
2012-12,22,48,23.625,-85.875,0,1,1
2012-12,22,49,23.625,-85.625,0,6,6
2012-12,23,48,23.875,-85.875,0,2,2
2012-12,23,49,23.875,-85.625,0,2,2
2012-12,23,51,23.875,-85.125,0,4,4
2012-12,23,61,23.875,-82.625,0,2,2
2012-12,23,62,23.875,-82.375,0,3,3
2012-12,24,49,24.125,-85.625,0,1,1
2012-12,24,50,24.125,-85.375,0,13,13
2012-12,26,59,24.625,-83.125,0,1,1
2012-12,27,11,24.875,-95.125,2,0,2
2012-12,27,12,24.875,-94.875,4,0,4
2012-12,27,30,24.875,-90.375,9,0,9
2012-12,28,12,25.125,-94.875,7,0,7
2012-12,28,13,25.125,-94.625,4,0,4
2012-12,29,13,25.375,-94.625,7,0,7
2012-12,29,14,25.375,-94.375,7,0,7
2012-12,29,21,25.375,-92.625,0,1,1
2012-12,29,22,25.375,-92.375,0,3,3
2012-12,30,22,25.625,-92.375,0,6,6
2012-12,30,23,25.625,-92.125,0,6,6
2012-12,31,23,25.875,-92.125,0,4,4
2012-12,31,24,25.875,-91.875,0,10,10
2012-12,31,40,25.875,-87.875,1,0,1
2012-12,31,41,25.875,-87.625,8,0,8
2012-12,31,42,25.875,-87.375,3,0,3
2012-12,32,24,26.125,-91.875,0,1,1
2012-12,32,40,26.125,-87.875,2,0,2
2012-12,32,41,26.125,-87.625,2,0,2
2012-12,32,55,26.125,-84.125,0,2,2
2012-12,32,56,26.125,-83.875,0,5,5
2012-12,33,39,26.375,-88.125,8,0,8
2012-12,33,40,26.375,-87.875,7,0,7
2012-12,33,55,26.375,-84.125,0,5,5
2012-12,34,55,26.625,-84.125,0,3,3
2012-12,35,55,26.875,-84.125,0,1,1
2012-12,36,55,27.125,-84.125,0,1,1
2012-12,37,54,27.375,-84.375,0,2,2
2012-12,38,44,27.625,-86.875,0,1,1
2012-12,38,54,27.625,-84.375,0,1,1
2012-12,39,43,27.875,-87.125,0,1,1
2012-12,39,44,27.875,-86.875,0,1,1
2012-12,40,40,28.125,-87.875,0,1,1
2012-12,40,41,28.125,-87.625,0,5,5
2012-12,40,42,28.125,-87.375,0,3,3
2012-12,40,54,28.125,-84.375,0,3,3
2012-12,41,38,28.375,-88.375,0,3,3
2012-12,41,39,28.375,-88.125,0,3,3
2012-12,41,40,28.375,-87.875,0,2,2
2012-12,41,41,28.375,-87.625,0,4,4
2012-12,41,42,28.375,-87.375,0,5,5
2013-01,0,46,18.125,-86.375,0,3,3
2013-01,0,47,18.125,-86.125,0,4,4
2013-01,0,48,18.125,-85.875,0,4,4
2013-01,1,53,18.375,-84.625,2,0,2
2013-01,1,54,18.375,-84.375,3,0,3
2013-01,1,55,18.375,-84.125,3,0,3
2013-01,2,56,18.625,-83.875,3,0,3
2013-01,2,57,18.625,-83.625,2,0,2
2013-01,2,58,18.625,-83.375,3,0,3
2013-01,2,59,18.625,-83.125,1,0,1
2013-01,3,59,18.875,-83.125,1,0,1
2013-01,3,60,18.875,-82.875,2,0,2
2013-01,3,61,18.875,-82.625,5,0,5
2013-01,3,62,18.875,-82.375,4,0,4
2013-01,3,63,18.875,-82.125,2,0,2
2013-01,6,69,19.625,-80.625,0,2,2
2013-01,6,70,19.625,-80.375,0,8,8
2013-01,6,71,19.625,-80.125,0,1,1
2013-01,7,67,19.875,-81.125,0,2,2
2013-01,7,68,19.875,-80.875,0,2,2
2013-01,7,69,19.875,-80.625,0,3,3
2013-01,8,8,20.125,-95.875,4,0,4
2013-01,8,9,20.125,-95.625,2,0,2
2013-01,8,11,20.125,-95.125,2,0,2
2013-01,9,9,20.375,-95.625,4,0,4
2013-01,9,11,20.375,-95.125,2,0,2
2013-01,9,12,20.375,-94.875,13,0,13
2013-01,9,47,20.375,-86.125,1,0,1
2013-01,9,48,20.375,-85.875,1,0,1
2013-01,10,48,20.625,-85.875,2,0,2
2013-01,10,49,20.625,-85.625,1,0,1
2013-01,11,64,20.875,-81.875,0,3,3
2013-01,11,65,20.875,-81.625,0,2,2
2013-01,12,52,21.125,-84.875,5,0,5
2013-01,12,63,21.125,-82.125,0,1,1
2013-01,12,64,21.125,-81.875,0,2,2
2013-01,12,65,21.125,-81.625,0,1,1
2013-01,13,52,21.375,-84.875,1,0,1
2013-01,13,63,21.375,-82.125,0,1,1
2013-01,16,11,22.125,-95.125,0,2,2
2013-01,16,12,22.125,-94.875,0,11,11
2013-01,16,13,22.125,-94.625,0,4,4
2013-01,17,13,22.375,-94.625,0,7,7
2013-01,17,14,22.375,-94.375,0,7,7
2013-01,22,55,23.625,-84.125,7,0,7
2013-01,22,56,23.625,-83.875,6,0,6
2013-01,23,35,23.875,-89.125,0,7,7
2013-01,23,36,23.875,-88.875,0,3,3
2013-01,23,48,23.875,-85.875,0,3,3
2013-01,23,55,23.875,-84.125,1,0,1
2013-01,23,56,23.875,-83.875,5,0,5
2013-01,24,47,24.125,-86.125,0,1,1
2013-01,24,48,24.125,-85.875,0,1,1
2013-01,25,26,24.375,-91.375,4,0,4
2013-01,25,47,24.375,-86.125,0,1,1
2013-01,26,11,24.625,-95.125,17,0,17
2013-01,26,26,24.625,-91.375,2,0,2
2013-01,26,27,24.625,-91.125,7,0,7
2013-01,26,28,24.625,-90.875,7,0,7
2013-01,26,29,24.625,-90.625,7,0,7
2013-01,26,47,24.625,-86.125,0,2,2
2013-01,27,11,24.875,-95.125,14,0,14
2013-01,27,29,24.875,-90.625,4,0,4
2013-01,27,47,24.875,-86.125,0,2,2
2013-01,28,47,25.125,-86.125,0,1,1
2013-01,28,48,25.125,-85.875,0,13,13
2013-01,29,21,25.375,-92.625,0,10,10
2013-01,29,48,25.375,-85.875,0,7,7
2013-01,30,20,25.625,-92.875,0,5,5
2013-01,30,21,25.625,-92.625,0,1,1
2013-01,31,20,25.875,-92.875,0,14,14
2013-01,31,39,25.875,-88.125,9,0,9
2013-01,31,40,25.875,-87.875,3,0,3
2013-01,32,20,26.125,-92.875,0,1,1
2013-01,32,37,26.125,-88.625,1,0,1
2013-01,32,38,26.125,-88.375,3,0,3
2013-01,32,39,26.125,-88.125,14,0,14
2013-01,33,38,26.375,-88.375,1,0,1
2013-01,35,13,26.875,-94.625,5,0,5
2013-01,36,12,27.125,-94.875,4,0,4
2013-01,36,13,27.125,-94.625,2,0,2
2013-01,41,37,28.375,-88.625,0,1,1
2013-01,41,38,28.375,-88.375,0,5,5
2013-01,41,39,28.375,-88.125,0,18,18
2013-01,41,40,28.375,-87.875,0,7,7
2013-02,0,48,18.125,-85.875,7,0,7
2013-02,0,49,18.125,-85.625,3,0,3
2013-02,1,49,18.375,-85.625,1,0,1
2013-02,1,50,18.375,-85.375,3,0,3
2013-02,1,51,18.375,-85.125,1,0,1
2013-02,1,52,18.375,-84.875,2,0,2
2013-02,1,53,18.375,-84.625,1,0,1
2013-02,6,62,19.625,-82.375,0,2,2
2013-02,6,64,19.625,-81.875,0,4,4
2013-02,6,65,19.625,-81.625,0,4,4
2013-02,6,66,19.625,-81.375,0,3,3
2013-02,7,67,19.875,-81.125,0,4,4
2013-02,7,68,19.875,-80.875,0,1,1
2013-02,8,51,20.125,-85.125,1,0,1
2013-02,8,52,20.125,-84.875,4,0,4
2013-02,8,55,20.125,-84.125,5,0,5
2013-02,8,64,20.125,-81.875,0,2,2
2013-02,8,65,20.125,-81.625,0,8,8
2013-02,9,53,20.375,-84.625,1,0,1
2013-02,9,54,20.375,-84.375,2,0,2
2013-02,9,56,20.375,-83.875,8,0,8
2013-02,10,53,20.625,-84.625,1,0,1
2013-02,11,52,20.875,-84.875,4,0,4
2013-02,16,10,22.125,-95.375,0,13,13
2013-02,16,11,22.125,-95.125,0,6,6
2013-02,20,30,23.125,-90.375,0,2,2
2013-02,21,30,23.375,-90.375,0,2,2
2013-02,21,31,23.375,-90.125,0,3,3
2013-02,21,55,23.375,-84.125,2,0,2
2013-02,22,32,23.625,-89.875,0,1,1
2013-02,22,33,23.625,-89.625,0,1,1
2013-02,22,55,23.625,-84.125,1,0,1
2013-02,22,56,23.625,-83.875,8,0,8
2013-02,23,22,23.875,-92.375,3,0,3
2013-02,23,23,23.875,-92.125,2,0,2
2013-02,23,33,23.875,-89.625,0,1,1
2013-02,23,34,23.875,-89.375,0,1,1
2013-02,23,35,23.875,-89.125,0,6,6
2013-02,23,44,23.875,-86.875,0,2,2
2013-02,24,23,24.125,-92.125,3,0,3
2013-02,24,24,24.125,-91.875,10,0,10
2013-02,24,25,24.125,-91.625,5,0,5
2013-02,24,35,24.125,-89.125,0,11,11
2013-02,24,44,24.125,-86.875,0,4,4
2013-02,24,50,24.125,-85.375,0,1,1
2013-02,24,51,24.125,-85.125,0,4,4
2013-02,25,25,24.375,-91.625,3,0,3
2013-02,25,26,24.375,-91.375,1,0,1
2013-02,25,49,24.375,-85.625,0,1,1
2013-02,25,50,24.375,-85.375,0,2,2
2013-02,25,51,24.375,-85.125,0,1,1
2013-02,26,10,24.625,-95.375,1,0,1
2013-02,26,11,24.625,-95.125,5,0,5
2013-02,26,49,24.625,-85.625,0,3,3
2013-02,27,9,24.875,-95.625,1,0,1
2013-02,27,10,24.875,-95.375,18,0,18
2013-02,27,11,24.875,-95.125,3,0,3
2013-02,27,47,24.875,-86.125,0,5,5
2013-02,27,50,24.875,-85.375,0,6,6
2013-02,28,47,25.125,-86.125,0,3,3
2013-02,28,48,25.125,-85.875,0,1,1
2013-02,30,44,25.625,-86.875,0,1,1
2013-02,30,50,25.625,-85.375,3,0,3
2013-02,31,49,25.875,-85.625,4,0,4
2013-02,32,17,26.125,-93.625,0,2,2
2013-02,32,18,26.125,-93.375,0,7,7
2013-02,32,19,26.125,-93.125,0,13,13
2013-02,32,20,26.125,-92.875,0,6,6
2013-02,32,36,26.125,-88.875,15,0,15
2013-02,32,37,26.125,-88.625,4,0,4
2013-02,32,49,26.125,-85.625,4,0,4
2013-02,33,36,26.375,-88.875,8,0,8
2013-02,33,43,26.375,-87.125,0,4,4
2013-02,33,49,26.375,-85.625,3,0,3
2013-02,34,36,26.625,-88.875,1,0,1
2013-02,34,43,26.625,-87.125,0,9,9
2013-02,34,49,26.625,-85.625,4,0,4
2013-02,35,49,26.875,-85.625,1,0,1
2013-02,35,50,26.875,-85.375,1,0,1
2013-02,36,10,27.125,-95.375,1,0,1
2013-02,36,11,27.125,-95.125,9,0,9
2013-02,36,12,27.125,-94.875,7,0,7
2013-02,36,49,27.125,-85.625,3,0,3
2013-02,36,50,27.125,-85.375,4,0,4
2013-02,37,10,27.375,-95.375,3,0,3
2013-02,37,11,27.375,-95.125,3,0,3
2013-02,38,9,27.625,-95.625,1,0,1
2013-02,38,10,27.625,-95.375,3,0,3
2013-02,39,11,27.875,-95.125,1,0,1
2013-02,41,37,28.375,-88.625,0,1,1
2013-02,41,38,28.375,-88.375,0,4,4
2013-02,42,36,28.625,-88.875,0,3,3
2013-02,42,37,28.625,-88.625,0,5,5
2013-03,1,58,18.375,-83.375,0,1,1
2013-03,1,59,18.375,-83.125,0,1,1
2013-03,2,56,18.625,-83.875,0,1,1
2013-03,2,57,18.625,-83.625,0,1,1
2013-03,3,56,18.875,-83.875,0,1,1
2013-03,5,71,19.375,-80.125,2,0,2
2013-03,6,12,19.625,-94.875,4,0,4
2013-03,6,56,19.625,-83.875,2,0,2
2013-03,7,12,19.875,-94.875,12,0,12
2013-03,7,13,19.875,-94.625,3,0,3
2013-03,7,56,19.875,-83.875,1,0,1
2013-03,8,51,20.125,-85.125,2,0,2
2013-03,8,64,20.125,-81.875,0,7,7
2013-03,9,55,20.375,-84.125,4,0,4
2013-03,9,56,20.375,-83.875,1,0,1
2013-03,9,61,20.375,-82.625,0,6,6
2013-03,9,62,20.375,-82.375,0,6,6
2013-03,9,63,20.375,-82.125,0,9,9
2013-03,10,61,20.625,-82.625,0,1,1
2013-03,10,62,20.625,-82.375,0,1,1
2013-03,16,45,22.125,-86.625,0,5,5
2013-03,17,6,22.375,-96.375,0,7,7
2013-03,17,7,22.375,-96.125,0,10,10
2013-03,17,8,22.375,-95.875,0,4,4
2013-03,17,9,22.375,-95.625,0,9,9
2013-03,18,6,22.625,-96.375,0,1,1
2013-03,18,44,22.625,-86.875,0,2,2
2013-03,19,27,22.875,-91.125,0,5,5
2013-03,19,44,22.875,-86.875,0,1,1
2013-03,20,29,23.125,-90.625,0,2,2
2013-03,20,44,23.125,-86.875,0,1,1
2013-03,21,27,23.375,-91.125,0,4,4
2013-03,21,28,23.375,-90.875,0,6,6
2013-03,21,43,23.375,-87.125,0,2,2
2013-03,21,44,23.375,-86.875,0,2,2
2013-03,22,43,23.625,-87.125,0,2,2
2013-03,22,44,23.625,-86.875,0,5,5
2013-03,22,45,23.625,-86.625,0,4,4
2013-03,23,15,23.875,-94.125,1,0,1
2013-03,23,16,23.875,-93.875,8,0,8
2013-03,23,17,23.875,-93.625,2,0,2
2013-03,23,44,23.875,-86.875,0,6,6
2013-03,23,56,23.875,-83.875,0,5,5
2013-03,24,13,24.125,-94.625,6,0,6
2013-03,24,15,24.125,-94.125,5,0,5
2013-03,24,16,24.125,-93.875,6,0,6
2013-03,24,52,24.125,-84.875,0,2,2
2013-03,24,53,24.125,-84.625,0,5,5
2013-03,24,54,24.125,-84.375,0,5,5
2013-03,24,55,24.125,-84.125,0,6,6
2013-03,24,56,24.125,-83.875,0,7,7
2013-03,27,10,24.875,-95.375,2,0,2
2013-03,27,48,24.875,-85.875,3,0,3
2013-03,28,48,25.125,-85.875,7,0,7
2013-03,28,49,25.125,-85.625,10,0,10
2013-03,29,28,25.375,-90.875,3,0,3
2013-03,29,29,25.375,-90.625,1,0,1
2013-03,29,49,25.375,-85.625,9,0,9
2013-03,30,30,25.625,-90.375,2,0,2
2013-03,30,50,25.625,-85.375,2,0,2
2013-03,31,30,25.875,-90.375,3,0,3
2013-03,32,16,26.125,-93.875,0,16,16
2013-03,32,17,26.125,-93.625,0,15,15
2013-03,34,35,26.625,-89.125,6,0,6
2013-03,34,36,26.625,-88.875,8,0,8
2013-03,34,44,26.625,-86.875,0,1,1
2013-03,35,36,26.875,-88.875,2,0,2
2013-03,35,37,26.875,-88.625,1,0,1
2013-03,35,44,26.875,-86.875,0,9,9
2013-03,35,45,26.875,-86.625,0,10,10
2013-03,36,37,27.125,-88.625,5,0,5
2013-03,36,45,27.125,-86.625,0,11,11
2013-03,37,10,27.375,-95.375,2,0,2
2013-03,37,11,27.375,-95.125,23,0,23
2013-03,37,37,27.375,-88.625,6,0,6
2013-03,38,10,27.625,-95.375,3,0,3
2013-03,38,11,27.625,-95.125,1,0,1
2013-03,38,38,27.625,-88.375,3,0,3
2013-04,0,59,18.125,-83.125,1,0,1
2013-04,0,60,18.125,-82.875,1,0,1
2013-04,0,61,18.125,-82.625,3,0,3
2013-04,0,62,18.125,-82.375,1,0,1
2013-04,0,71,18.125,-80.125,0,3,3
2013-04,1,58,18.375,-83.375,1,0,1
2013-04,1,59,18.375,-83.125,1,0,1
2013-04,1,62,18.375,-82.375,1,0,1
2013-04,1,63,18.375,-82.125,3,0,3
2013-04,1,64,18.375,-81.875,1,0,1
2013-04,1,65,18.375,-81.625,1,0,1
2013-04,1,69,18.375,-80.625,0,3,3
2013-04,1,70,18.375,-80.375,0,2,2
2013-04,2,67,18.625,-81.125,3,0,3
2013-04,3,55,18.875,-84.125,0,1,1
2013-04,3,66,18.875,-81.375,2,0,2
2013-04,4,54,19.125,-84.375,0,1,1
2013-04,5,51,19.375,-85.125,5,1,6
2013-04,5,52,19.375,-84.875,4,1,5
2013-04,5,53,19.375,-84.625,3,0,3
2013-04,6,50,19.625,-85.375,0,1,1
2013-04,6,54,19.625,-84.375,3,0,3
2013-04,6,55,19.625,-84.125,3,0,3
2013-04,6,56,19.625,-83.875,1,0,1
2013-04,7,13,19.875,-94.625,4,0,4
2013-04,7,51,19.875,-85.125,0,2,2
2013-04,7,52,19.875,-84.875,0,3,3
2013-04,8,12,20.125,-94.875,3,0,3
2013-04,8,13,20.125,-94.625,4,0,4
2013-04,8,52,20.125,-84.875,0,1,1
2013-04,8,70,20.125,-80.375,3,0,3
2013-04,9,52,20.375,-84.875,0,10,10
2013-04,9,53,20.375,-84.625,0,6,6
2013-04,9,69,20.375,-80.625,5,0,5
2013-04,9,70,20.375,-80.375,2,0,2
2013-04,10,52,20.625,-84.875,0,1,1
2013-04,10,53,20.625,-84.625,0,2,2
2013-04,10,68,20.625,-80.875,2,0,2
2013-04,10,69,20.625,-80.625,1,0,1
2013-04,13,9,21.375,-95.625,1,0,1
2013-04,13,10,21.375,-95.375,5,0,5
2013-04,14,10,21.625,-95.375,4,0,4
2013-04,15,10,21.875,-95.375,3,0,3
2013-04,16,10,22.125,-95.375,1,0,1
2013-04,17,10,22.375,-95.375,1,0,1
2013-04,17,11,22.375,-95.125,1,0,1
2013-04,18,6,22.625,-96.375,0,8,8
2013-04,19,5,22.875,-96.625,0,6,6
2013-04,19,6,22.875,-96.375,0,1,1
2013-04,20,5,23.125,-96.625,0,5,5
2013-04,20,12,23.125,-94.875,1,0,1
2013-04,21,5,23.375,-96.625,0,7,7
2013-04,22,5,23.625,-96.625,0,1,1
2013-04,22,6,23.625,-96.375,0,2,2
2013-04,22,12,23.625,-94.875,1,0,1
2013-04,22,13,23.625,-94.625,1,0,1
2013-04,23,55,23.875,-84.125,0,12,12
2013-04,23,56,23.875,-83.875,0,10,10
2013-04,24,11,24.125,-95.125,1,0,1
2013-04,24,12,24.125,-94.875,5,0,5
2013-04,24,45,24.125,-86.625,2,0,2
2013-04,24,54,24.125,-84.375,0,3,3
2013-04,24,55,24.125,-84.125,0,1,1
2013-04,24,56,24.125,-83.875,0,4,4
2013-04,25,12,24.375,-94.875,4,0,4
2013-04,25,45,24.375,-86.625,11,0,11
2013-04,25,63,24.375,-82.125,2,0,2
2013-04,26,10,24.625,-95.375,2,0,2
2013-04,26,11,24.625,-95.125,3,0,3
2013-04,26,12,24.625,-94.875,1,0,1
2013-04,26,45,24.625,-86.625,2,0,2
2013-04,26,46,24.625,-86.375,7,0,7
2013-04,27,9,24.875,-95.625,2,0,2
2013-04,27,10,24.875,-95.375,4,0,4
2013-04,27,47,24.875,-86.125,8,0,8
2013-04,28,7,25.125,-96.125,5,0,5
2013-04,28,8,25.125,-95.875,3,0,3
2013-04,28,25,25.125,-91.625,9,0,9
2013-04,28,26,25.125,-91.375,8,0,8
2013-04,29,26,25.375,-91.375,2,0,2
2013-04,29,27,25.375,-91.125,9,0,9
2013-04,29,28,25.375,-90.875,2,0,2
2013-04,32,13,26.125,-94.625,0,2,2
2013-04,32,14,26.125,-94.375,0,7,7
2013-04,32,15,26.125,-94.125,0,8,8
2013-04,32,16,26.125,-93.875,0,1,1
2013-04,33,14,26.375,-94.375,0,9,9
2013-04,33,15,26.375,-94.125,0,3,3
2013-04,35,42,26.875,-87.375,0,1,1
2013-04,35,43,26.875,-87.125,0,4,4
2013-04,35,44,26.875,-86.875,0,6,6
2013-04,35,45,26.875,-86.625,0,11,11
2013-04,36,45,27.125,-86.625,0,8,8
2013-04,38,8,27.625,-95.875,1,0,1
2013-04,38,9,27.625,-95.625,2,0,2
2013-04,38,38,27.625,-88.375,1,0,1
2013-04,39,8,27.875,-95.875,5,0,5
2013-04,39,38,27.875,-88.375,2,0,2
2013-04,39,39,27.875,-88.125,3,0,3
2013-04,40,39,28.125,-88.125,6,0,6
2013-04,41,40,28.375,-87.875,7,0,7
2013-04,41,41,28.375,-87.625,5,0,5
2013-04,41,42,28.375,-87.375,5,0,5
2013-04,42,41,28.625,-87.625,1,0,1
2013-05,0,50,18.125,-85.375,1,0,1
2013-05,0,51,18.125,-85.125,2,0,2
2013-05,0,52,18.125,-84.875,3,0,3
2013-05,0,53,18.125,-84.625,2,0,2
2013-05,0,54,18.125,-84.375,2,0,2
2013-05,0,55,18.125,-84.125,2,0,2
2013-05,1,48,18.375,-85.875,3,0,3
2013-05,1,49,18.375,-85.625,3,0,3
2013-05,1,50,18.375,-85.375,2,0,2
2013-05,1,57,18.375,-83.625,1,0,1
2013-05,1,58,18.375,-83.375,1,0,1
2013-05,1,67,18.375,-81.125,0,1,1
2013-05,1,68,18.375,-80.875,0,1,1
2013-05,2,48,18.625,-85.875,1,0,1
2013-05,2,65,18.625,-81.625,0,1,1
2013-05,2,66,18.625,-81.375,0,1,1
2013-05,2,67,18.625,-81.125,0,1,1
2013-05,3,63,18.875,-82.125,0,2,2
2013-05,3,64,18.875,-81.875,0,1,1
2013-05,4,62,19.125,-82.375,0,4,4
2013-05,4,63,19.125,-82.125,0,2,2
2013-05,4,67,19.125,-81.125,0,1,1
2013-05,5,59,19.375,-83.125,0,1,1
2013-05,5,60,19.375,-82.875,0,1,1
2013-05,5,61,19.375,-82.625,0,3,3
2013-05,6,60,19.625,-82.875,0,1,1
2013-05,6,61,19.625,-82.625,0,1,1
2013-05,9,66,20.375,-81.375,2,0,2
2013-05,9,67,20.375,-81.125,4,0,4
2013-05,10,50,20.625,-85.375,0,2,2
2013-05,10,51,20.625,-85.125,0,3,3
2013-05,10,52,20.625,-84.875,0,2,2
2013-05,10,54,20.625,-84.375,3,0,3
2013-05,10,55,20.625,-84.125,5,0,5
2013-05,10,56,20.625,-83.875,3,0,3
2013-05,10,59,20.625,-83.125,0,4,4
2013-05,10,67,20.625,-81.125,2,0,2
2013-05,10,68,20.625,-80.875,9,0,9
2013-05,11,9,20.875,-95.625,16,0,16
2013-05,11,10,20.875,-95.375,3,0,3
2013-05,11,18,20.875,-93.375,0,3,3
2013-05,11,19,20.875,-93.125,0,6,6
2013-05,11,20,20.875,-92.875,0,2,2
2013-05,11,49,20.875,-85.625,0,2,2
2013-05,11,50,20.875,-85.375,0,2,2
2013-05,11,52,20.875,-84.875,4,0,4
2013-05,11,53,20.875,-84.625,4,0,4
2013-05,11,56,20.875,-83.875,1,0,1
2013-05,11,57,20.875,-83.625,7,0,7
2013-05,11,58,20.875,-83.375,1,0,1
2013-05,12,9,21.125,-95.625,8,0,8
2013-05,12,16,21.125,-93.875,0,1,1
2013-05,12,17,21.125,-93.625,0,6,6
2013-05,12,18,21.125,-93.375,0,1,1
2013-05,12,49,21.125,-85.625,0,2,2
2013-05,12,50,21.125,-85.375,0,2,2
2013-05,12,57,21.125,-83.625,1,0,1
2013-05,13,9,21.375,-95.625,4,0,4
2013-05,13,49,21.375,-85.625,0,1,1
2013-05,20,5,23.125,-96.625,0,5,5
2013-05,20,10,23.125,-95.375,1,0,1
2013-05,21,5,23.375,-96.625,0,7,7
2013-05,21,6,23.375,-96.375,0,10,10
2013-05,21,11,23.375,-95.125,3,0,3
2013-05,22,6,23.625,-96.375,0,9,9
2013-05,22,11,23.625,-95.125,1,0,1
2013-05,22,12,23.625,-94.875,6,0,6
2013-05,23,12,23.875,-94.875,3,0,3
2013-05,23,13,23.875,-94.625,5,0,5
2013-05,24,13,24.125,-94.625,8,0,8
2013-05,24,45,24.125,-86.625,11,0,11
2013-05,24,46,24.125,-86.375,2,0,2
2013-05,24,54,24.125,-84.375,0,6,6
2013-05,24,55,24.125,-84.125,0,25,25
2013-05,24,61,24.125,-82.625,2,0,2
2013-05,24,63,24.125,-82.125,10,0,10
2013-05,24,64,24.125,-81.875,1,0,1
2013-05,25,13,24.375,-94.625,4,0,4
2013-05,25,45,24.375,-86.625,10,0,10
2013-05,25,60,24.375,-82.875,3,0,3
2013-05,25,61,24.375,-82.625,2,0,2
2013-05,25,63,24.375,-82.125,6,0,6
2013-05,25,64,24.375,-81.875,3,0,3
2013-05,26,45,24.625,-86.625,8,0,8
2013-05,26,60,24.625,-82.875,1,0,1
2013-05,28,24,25.125,-91.875,6,0,6
2013-05,28,25,25.125,-91.625,1,0,1
2013-05,29,24,25.375,-91.875,8,0,8
2013-05,29,25,25.375,-91.625,6,0,6
2013-05,30,23,25.625,-92.125,4,0,4
2013-05,30,24,25.625,-91.875,6,0,6
2013-05,32,10,26.125,-95.375,0,14,14
2013-05,32,11,26.125,-95.125,0,2,2
2013-05,32,12,26.125,-94.875,0,3,3
2013-05,32,13,26.125,-94.625,0,2,2
2013-05,32,37,26.125,-88.625,0,2,2
2013-05,32,50,26.125,-85.375,0,2,2
2013-05,32,51,26.125,-85.125,0,3,3
2013-05,33,10,26.375,-95.375,0,1,1
2013-05,33,11,26.375,-95.125,0,6,6
2013-05,33,12,26.375,-94.875,0,3,3
2013-05,33,37,26.375,-88.625,0,2,2
2013-05,33,38,26.375,-88.375,0,4,4
2013-05,33,51,26.375,-85.125,0,3,3
2013-05,34,38,26.625,-88.375,0,3,3
2013-05,34,39,26.625,-88.125,0,3,3
2013-05,34,40,26.625,-87.875,0,4,4
2013-05,34,41,26.625,-87.625,0,1,1
2013-05,34,51,26.625,-85.125,0,3,3
2013-05,35,41,26.875,-87.625,0,6,6
2013-05,35,42,26.875,-87.375,0,6,6
2013-05,35,51,26.875,-85.125,0,2,2
2013-05,37,22,27.375,-92.375,0,2,2
2013-05,37,24,27.375,-91.875,0,4,4
2013-05,37,25,27.375,-91.625,0,4,4
2013-05,37,46,27.375,-86.375,1,0,1
2013-05,38,21,27.625,-92.625,0,7,7
2013-05,38,22,27.625,-92.375,0,3,3
2013-05,38,25,27.625,-91.625,0,4,4
2013-05,38,46,27.625,-86.375,1,0,1
2013-05,39,24,27.875,-91.875,0,1,1
2013-05,39,45,27.875,-86.625,9,0,9
2013-05,40,44,28.125,-86.875,5,0,5
2013-05,41,42,28.375,-87.375,1,0,1
2013-05,41,43,28.375,-87.125,2,0,2
2013-05,41,44,28.375,-86.875,3,0,3
2013-06,0,44,18.125,-86.875,1,0,1
2013-06,2,44,18.625,-86.875,2,0,2
2013-06,3,44,18.875,-86.875,2,0,2
2013-06,4,44,19.125,-86.875,1,0,1
2013-06,4,52,19.125,-84.875,0,4,4
2013-06,4,53,19.125,-84.625,0,4,4
2013-06,4,54,19.125,-84.375,0,4,4
2013-06,4,55,19.125,-84.125,0,1,1
2013-06,4,66,19.125,-81.375,2,0,2
2013-06,4,67,19.125,-81.125,4,0,4
2013-06,5,44,19.375,-86.875,1,0,1
2013-06,5,51,19.375,-85.125,0,2,2
2013-06,5,52,19.375,-84.875,0,3,3
2013-06,5,62,19.375,-82.375,5,0,5
2013-06,5,63,19.375,-82.125,4,0,4
2013-06,5,64,19.375,-81.875,3,0,3
2013-06,5,65,19.375,-81.625,3,0,3
2013-06,6,44,19.625,-86.875,2,0,2
2013-06,6,45,19.625,-86.625,1,0,1
2013-06,10,7,20.625,-96.125,4,0,4
2013-06,10,58,20.625,-83.375,0,3,3
2013-06,10,59,20.625,-83.125,0,2,2
2013-06,11,7,20.875,-96.125,8,0,8
2013-06,11,9,20.875,-95.625,2,0,2
2013-06,12,8,21.125,-95.875,7,0,7
2013-06,12,9,21.125,-95.625,2,0,2
2013-06,12,16,21.125,-93.875,0,2,2
2013-06,12,51,21.125,-85.125,1,0,1
2013-06,12,52,21.125,-84.875,2,0,2
2013-06,13,14,21.375,-94.375,0,1,1
2013-06,13,15,21.375,-94.125,0,2,2
2013-06,13,16,21.375,-93.875,0,11,11
2013-06,13,17,21.375,-93.625,0,1,1
2013-06,13,51,21.375,-85.125,3,0,3
2013-06,14,16,21.625,-93.875,0,13,13
2013-06,17,4,22.375,-96.875,0,11,11
2013-06,18,4,22.625,-96.875,0,2,2
2013-06,19,4,22.875,-96.875,0,2,2
2013-06,19,5,22.875,-96.625,0,2,2
2013-06,20,8,23.125,-95.875,9,0,9
2013-06,20,9,23.125,-95.625,12,0,12
2013-06,20,10,23.125,-95.375,5,0,5
2013-06,21,10,23.375,-95.375,1,0,1
2013-06,21,11,23.375,-95.125,1,0,1
2013-06,23,54,23.875,-84.375,0,1,1
2013-06,23,55,23.875,-84.125,0,9,9
2013-06,24,54,24.125,-84.375,0,7,7
2013-06,24,55,24.125,-84.125,0,13,13
2013-06,24,61,24.125,-82.625,1,0,1
2013-06,24,62,24.125,-82.375,4,0,4
2013-06,24,63,24.125,-82.125,8,0,8
2013-06,24,64,24.125,-81.875,3,0,3
2013-06,24,65,24.125,-81.625,2,0,2
2013-06,24,66,24.125,-81.375,3,0,3
2013-06,24,67,24.125,-81.125,1,0,1
2013-06,24,68,24.125,-80.875,2,0,2
2013-06,25,63,24.375,-82.125,1,0,1
2013-06,25,68,24.375,-80.875,2,0,2
2013-06,25,69,24.375,-80.625,1,0,1
2013-06,26,45,24.625,-86.625,1,0,1
2013-06,27,45,24.875,-86.625,17,0,17
2013-06,27,46,24.875,-86.375,10,0,10
2013-06,28,19,25.125,-93.125,1,0,1
2013-06,28,46,25.125,-86.375,2,0,2
2013-06,29,19,25.375,-93.125,3,0,3
2013-06,29,20,25.375,-92.875,11,0,11
2013-06,29,21,25.375,-92.625,8,0,8
2013-06,29,22,25.375,-92.375,3,0,3
2013-06,29,34,25.375,-89.375,0,2,2
2013-06,30,22,25.625,-92.375,3,0,3
2013-06,30,23,25.625,-92.125,1,0,1
2013-06,30,34,25.625,-89.375,0,3,3
2013-06,30,35,25.625,-89.125,0,10,10
2013-06,30,36,25.625,-88.875,0,5,5
2013-06,31,9,25.875,-95.625,0,8,8
2013-06,31,10,25.875,-95.375,0,10,10
2013-06,31,36,25.875,-88.875,0,4,4
2013-06,31,37,25.875,-88.625,0,3,3
2013-06,32,9,26.125,-95.625,0,3,3
2013-06,32,10,26.125,-95.375,0,9,9
2013-06,32,37,26.125,-88.625,0,3,3
2013-06,35,50,26.875,-85.375,0,11,11
2013-06,35,51,26.875,-85.125,0,13,13
2013-06,36,19,27.125,-93.125,0,2,2
2013-06,36,20,27.125,-92.875,0,5,5
2013-06,36,21,27.125,-92.625,0,4,4
2013-06,36,22,27.125,-92.375,0,10,10
2013-06,36,23,27.125,-92.125,0,2,2
2013-06,36,51,27.125,-85.125,0,3,3
2013-06,37,21,27.375,-92.625,0,1,1
2013-06,37,23,27.375,-92.125,0,6,6
2013-06,37,50,27.375,-85.375,0,1,1
2013-06,37,51,27.375,-85.125,0,2,2
2013-07,1,53,18.375,-84.625,1,0,1
2013-07,1,54,18.375,-84.375,3,0,3
2013-07,2,56,18.625,-83.875,3,0,3
2013-07,2,57,18.625,-83.625,4,0,4
2013-07,2,58,18.625,-83.375,4,0,4
2013-07,3,58,18.875,-83.375,2,0,2
2013-07,3,59,18.875,-83.125,2,0,2
2013-07,4,59,19.125,-83.125,2,0,2
2013-07,5,49,19.375,-85.625,0,4,4
2013-07,5,50,19.375,-85.375,0,7,7
2013-07,5,51,19.375,-85.125,0,2,2
2013-07,5,59,19.375,-83.125,3,0,3
2013-07,5,60,19.375,-82.875,3,0,3
2013-07,5,61,19.375,-82.625,4,0,4
2013-07,6,11,19.625,-95.125,2,0,2
2013-07,6,12,19.625,-94.875,9,0,9
2013-07,6,48,19.625,-85.875,0,1,1
2013-07,6,49,19.625,-85.625,0,1,1
2013-07,6,71,19.625,-80.125,0,3,3
2013-07,7,12,19.875,-94.875,2,0,2
2013-07,8,12,20.125,-94.875,4,0,4
2013-07,9,11,20.375,-95.125,1,0,1
2013-07,9,12,20.375,-94.875,3,0,3
2013-07,10,11,20.625,-95.125,4,0,4
2013-07,13,11,21.375,-95.125,0,2,2
2013-07,13,12,21.375,-94.875,0,8,8
2013-07,13,13,21.375,-94.625,0,4,4
2013-07,13,14,21.375,-94.375,0,1,1
2013-07,14,10,21.625,-95.375,0,1,1
2013-07,14,11,21.625,-95.125,0,5,5
2013-07,15,10,21.875,-95.375,0,1,1
2013-07,15,11,21.875,-95.125,0,8,8
2013-07,20,8,23.125,-95.875,4,0,4
2013-07,21,6,23.375,-96.375,3,0,3
2013-07,21,7,23.375,-96.125,12,0,12
2013-07,21,8,23.375,-95.875,1,0,1
2013-07,22,6,23.625,-96.375,11,0,11
2013-07,23,55,23.875,-84.125,0,18,18
2013-07,23,56,23.875,-83.875,0,4,4
2013-07,23,64,23.875,-81.875,5,0,5
2013-07,23,65,23.875,-81.625,5,0,5
2013-07,23,66,23.875,-81.375,2,0,2
2013-07,24,55,24.125,-84.125,0,9,9
2013-07,24,64,24.125,-81.875,6,0,6
2013-07,24,66,24.125,-81.375,2,0,2
2013-07,24,67,24.125,-81.125,4,0,4
2013-07,25,45,24.375,-86.625,1,0,1
2013-07,25,64,24.375,-81.875,1,0,1
2013-07,25,68,24.375,-80.875,1,0,1
2013-07,25,69,24.375,-80.625,1,0,1
2013-07,26,45,24.625,-86.625,10,0,10
2013-07,26,69,24.625,-80.625,2,0,2
2013-07,26,70,24.625,-80.375,2,0,2
2013-07,27,17,24.875,-93.625,7,0,7
2013-07,27,18,24.875,-93.375,3,0,3
2013-07,28,18,25.125,-93.375,12,0,12
2013-07,28,19,25.125,-93.125,9,0,9
2013-07,28,46,25.125,-86.375,9,0,9
2013-07,29,31,25.375,-90.125,0,1,1
2013-07,29,32,25.375,-89.875,0,6,6
2013-07,29,33,25.375,-89.625,0,7,7
2013-07,29,34,25.375,-89.375,0,6,6
2013-07,29,45,25.375,-86.625,7,0,7
2013-07,29,46,25.375,-86.375,4,0,4
2013-07,30,31,25.625,-90.125,0,1,1
2013-07,30,34,25.625,-89.375,0,10,10
2013-07,31,9,25.875,-95.625,0,9,9
2013-07,32,9,26.125,-95.625,0,1,1
2013-07,32,10,26.125,-95.375,0,10,10
2013-07,33,10,26.375,-95.375,0,11,11
2013-07,36,19,27.125,-93.125,0,1,1
2013-07,37,51,27.375,-85.125,0,1,1
2013-07,38,50,27.625,-85.375,0,2,2
2013-07,39,48,27.875,-85.875,0,6,6
2013-07,39,49,27.875,-85.625,0,16,16
2013-07,40,48,28.125,-85.875,0,4,4
2013-07,40,49,28.125,-85.625,0,1,1
2013-07,41,48,28.375,-85.875,0,1,1
2013-08,0,45,18.125,-86.625,3,0,3
2013-08,0,56,18.125,-83.875,2,0,2
2013-08,1,53,18.375,-84.625,2,0,2
2013-08,1,54,18.375,-84.375,2,0,2
2013-08,1,55,18.375,-84.125,2,0,2
2013-08,1,56,18.375,-83.875,1,0,1
2013-08,2,50,18.625,-85.375,1,0,1
2013-08,2,51,18.625,-85.125,1,0,1
2013-08,2,52,18.625,-84.875,2,0,2
2013-08,2,53,18.625,-84.625,2,0,2
2013-08,2,54,18.625,-84.375,1,0,1
2013-08,4,54,19.125,-84.375,0,4,4
2013-08,4,55,19.125,-84.125,0,2,2
2013-08,4,56,19.125,-83.875,0,1,1
2013-08,5,55,19.375,-84.125,0,1,1
2013-08,5,56,19.375,-83.875,0,2,2
2013-08,5,57,19.375,-83.625,0,1,1
2013-08,5,69,19.375,-80.625,0,1,1
2013-08,7,20,19.875,-92.875,2,0,2
2013-08,8,19,20.125,-93.125,2,0,2
2013-08,8,20,20.125,-92.875,3,0,3
2013-08,8,57,20.125,-83.625,2,0,2
2013-08,8,58,20.125,-83.375,4,0,4
2013-08,9,8,20.375,-95.875,5,0,5
2013-08,9,19,20.375,-93.125,1,0,1
2013-08,9,20,20.375,-92.875,1,0,1
2013-08,10,8,20.625,-95.875,1,0,1
2013-08,10,9,20.625,-95.625,7,0,7
2013-08,10,10,20.625,-95.375,3,0,3
2013-08,10,69,20.625,-80.625,6,0,6
2013-08,10,70,20.625,-80.375,4,0,4
2013-08,10,71,20.625,-80.125,2,0,2
2013-08,11,67,20.875,-81.125,2,0,2
2013-08,11,68,20.875,-80.875,2,0,2
2013-08,15,9,21.875,-95.625,0,11,11
2013-08,15,11,21.875,-95.125,0,5,5
2013-08,16,9,22.125,-95.625,0,2,2
2013-08,16,10,22.125,-95.375,0,8,8
2013-08,16,11,22.125,-95.125,0,5,5
2013-08,22,6,23.625,-96.375,3,0,3
2013-08,23,55,23.875,-84.125,0,5,5
2013-08,23,64,23.875,-81.875,0,1,1
2013-08,23,65,23.875,-81.625,0,7,7
2013-08,23,66,23.875,-81.375,0,5,5
2013-08,24,54,24.125,-84.375,0,5,5
2013-08,24,66,24.125,-81.375,0,2,2
2013-08,24,67,24.125,-81.125,0,2,2
2013-08,25,10,24.375,-95.375,1,0,1
2013-08,25,11,24.375,-95.125,6,0,6
2013-08,25,53,24.375,-84.625,0,2,2
2013-08,25,54,24.375,-84.375,0,2,2
2013-08,26,11,24.625,-95.125,3,0,3
2013-08,26,12,24.625,-94.875,3,0,3
2013-08,26,13,24.625,-94.625,7,0,7
2013-08,26,45,24.625,-86.625,12,0,12
2013-08,26,53,24.625,-84.625,0,8,8
2013-08,27,14,24.875,-94.375,1,0,1
2013-08,27,15,24.875,-94.125,1,0,1
2013-08,27,16,24.875,-93.875,6,0,6
2013-08,27,17,24.875,-93.625,3,0,3
2013-08,27,45,24.875,-86.625,9,0,9
2013-08,27,53,24.875,-84.625,0,2,2
2013-08,27,54,24.875,-84.375,0,7,7
2013-08,28,45,25.125,-86.625,10,0,10
2013-08,29,28,25.375,-90.875,0,8,8
2013-08,29,29,25.375,-90.625,0,10,10
2013-08,30,31,25.625,-90.125,0,3,3
2013-08,33,10,26.375,-95.375,0,31,31
2013-08,39,46,27.875,-86.375,0,2,2
2013-08,39,48,27.875,-85.875,0,2,2
2013-08,40,45,28.125,-86.625,0,8,8
2013-08,40,46,28.125,-86.375,0,3,3
2013-08,40,47,28.125,-86.125,0,2,2
2013-08,41,45,28.375,-86.625,0,3,3
2013-08,42,45,28.625,-86.625,0,11,11
2013-09,4,53,19.125,-84.625,0,4,4
2013-09,5,50,19.375,-85.375,1,0,1
2013-09,5,51,19.375,-85.125,3,0,3
2013-09,5,52,19.375,-84.875,3,5,8
2013-09,5,53,19.375,-84.625,2,2,4
2013-09,5,54,19.375,-84.375,2,0,2
2013-09,6,49,19.625,-85.625,2,0,2
2013-09,6,50,19.625,-85.375,2,1,3
2013-09,6,51,19.625,-85.125,0,5,5
2013-09,6,54,19.625,-84.375,1,0,1
2013-09,6,55,19.625,-84.125,3,0,3
2013-09,6,56,19.625,-83.875,5,0,5
2013-09,6,62,19.625,-82.375,1,0,1
2013-09,6,63,19.625,-82.125,1,0,1
2013-09,7,10,19.875,-95.375,3,0,3
2013-09,7,11,19.875,-95.125,6,0,6
2013-09,7,50,19.875,-85.375,0,2,2
2013-09,7,51,19.875,-85.125,0,1,1
2013-09,7,57,19.875,-83.625,4,0,4
2013-09,7,62,19.875,-82.375,1,0,1
2013-09,8,11,20.125,-95.125,7,0,7
2013-09,8,12,20.125,-94.875,9,0,9
2013-09,8,19,20.125,-93.125,1,0,1
2013-09,8,20,20.125,-92.875,1,0,1
2013-09,8,51,20.125,-85.125,0,1,1
2013-09,8,57,20.125,-83.625,2,0,2
2013-09,8,63,20.125,-82.125,3,0,3
2013-09,8,65,20.125,-81.625,1,0,1
2013-09,8,66,20.125,-81.375,1,0,1
2013-09,9,14,20.375,-94.375,1,0,1
2013-09,9,19,20.375,-93.125,5,0,5
2013-09,9,20,20.375,-92.875,7,0,7
2013-09,9,21,20.375,-92.625,5,0,5
2013-09,9,22,20.375,-92.375,6,0,6
2013-09,9,54,20.375,-84.375,0,5,5
2013-09,9,63,20.375,-82.125,1,0,1
2013-09,9,64,20.375,-81.875,4,0,4
2013-09,9,65,20.375,-81.625,3,0,3
2013-09,9,66,20.375,-81.375,2,0,2
2013-09,10,22,20.625,-92.375,2,0,2
2013-09,10,53,20.625,-84.625,0,3,3
2013-09,10,65,20.625,-81.625,3,0,3
2013-09,10,66,20.625,-81.375,3,0,3
2013-09,11,66,20.875,-81.375,3,0,3
2013-09,11,67,20.875,-81.125,3,0,3
2013-09,12,6,21.125,-96.375,0,1,1
2013-09,13,6,21.375,-96.375,0,3,3
2013-09,13,7,21.375,-96.125,0,1,1
2013-09,14,7,21.625,-96.125,0,1,1
2013-09,14,8,21.625,-95.875,0,4,4
2013-09,14,9,21.625,-95.625,0,1,1
2013-09,14,12,21.625,-94.875,0,7,7
2013-09,15,9,21.875,-95.625,0,2,2
2013-09,20,41,23.125,-87.625,0,5,5
2013-09,21,40,23.375,-87.875,0,10,10
2013-09,21,41,23.375,-87.625,0,2,2
2013-09,22,39,23.625,-88.125,0,5,5
2013-09,22,40,23.625,-87.875,0,5,5
2013-09,23,39,23.875,-88.125,0,2,2
2013-09,23,63,23.875,-82.125,1,0,1
2013-09,23,64,23.875,-81.875,5,0,5
2013-09,23,65,23.875,-81.625,7,0,7
2013-09,24,54,24.125,-84.375,0,9,9
2013-09,24,55,24.125,-84.125,0,10,10
2013-09,24,66,24.125,-81.375,3,0,3
2013-09,24,67,24.125,-81.125,4,0,4
2013-09,24,68,24.125,-80.875,3,1,4
2013-09,24,69,24.125,-80.625,0,4,4
2013-09,25,9,24.375,-95.625,3,0,3
2013-09,25,10,24.375,-95.375,16,0,16
2013-09,25,69,24.375,-80.625,2,5,7
2013-09,26,54,24.625,-84.375,0,4,4
2013-09,27,10,24.875,-95.375,11,0,11
2013-09,27,54,24.875,-84.375,0,5,5
2013-09,27,55,24.875,-84.125,0,2,2
2013-09,28,23,25.125,-92.125,0,1,1
2013-09,28,24,25.125,-91.875,0,2,2
2013-09,29,24,25.375,-91.875,0,6,6
2013-09,29,25,25.375,-91.625,0,6,6
2013-09,29,26,25.375,-91.375,0,7,7
2013-09,29,27,25.375,-91.125,0,8,8
2013-09,29,43,25.375,-87.125,4,0,4
2013-09,29,44,25.375,-86.875,10,0,10
2013-09,29,45,25.375,-86.625,8,0,8
2013-09,30,43,25.625,-87.125,6,0,6
2013-09,30,44,25.625,-86.875,2,0,2
2013-09,33,8,26.375,-95.875,0,5,5
2013-09,33,9,26.375,-95.625,0,18,18
2013-09,33,10,26.375,-95.375,0,3,3
2013-09,42,42,28.625,-87.375,0,16,16
2013-09,42,43,28.625,-87.125,0,2,2
2013-09,42,44,28.625,-86.875,0,4,4
2013-09,42,45,28.625,-86.625,0,8,8
2013-10,3,52,18.875,-84.875,1,0,1
2013-10,3,53,18.875,-84.625,3,0,3
2013-10,3,54,18.875,-84.375,2,0,2
2013-10,3,55,18.875,-84.125,3,0,3
2013-10,3,56,18.875,-83.875,1,0,1
2013-10,3,57,18.875,-83.625,1,0,1
2013-10,4,57,19.125,-83.625,1,0,1
2013-10,4,58,19.125,-83.375,2,0,2
2013-10,4,59,19.125,-83.125,2,0,2
2013-10,4,60,19.125,-82.875,1,0,1
2013-10,5,60,19.375,-82.875,1,0,1
2013-10,5,61,19.375,-82.625,4,0,4
2013-10,6,45,19.625,-86.625,0,1,1
2013-10,6,46,19.625,-86.375,0,2,2
2013-10,6,47,19.625,-86.125,0,1,1
2013-10,6,49,19.625,-85.625,1,0,1
2013-10,6,62,19.625,-82.375,5,0,5
2013-10,6,63,19.625,-82.125,3,0,3
2013-10,7,45,19.875,-86.625,0,1,1
2013-10,7,46,19.875,-86.375,0,1,1
2013-10,7,48,19.875,-85.875,6,1,7
2013-10,7,62,19.875,-82.375,1,0,1
2013-10,8,47,20.125,-86.125,4,0,4
2013-10,8,48,20.125,-85.875,0,2,2
2013-10,8,49,20.125,-85.625,0,2,2
2013-10,8,50,20.125,-85.375,0,3,3
2013-10,8,51,20.125,-85.125,0,3,3
2013-10,8,52,20.125,-84.875,0,2,2
2013-10,8,53,20.125,-84.625,0,2,2
2013-10,8,54,20.125,-84.375,0,3,3
2013-10,9,14,20.375,-94.375,5,0,5
2013-10,9,47,20.375,-86.125,1,0,1
2013-10,9,52,20.375,-84.875,0,2,2
2013-10,9,53,20.375,-84.625,0,2,2
2013-10,9,54,20.375,-84.375,0,1,1
2013-10,10,14,20.625,-94.375,3,0,3
2013-10,10,15,20.625,-94.125,3,0,3
2013-10,10,66,20.625,-81.375,4,0,4
2013-10,10,67,20.625,-81.125,5,0,5
2013-10,12,9,21.125,-95.625,0,6,6
2013-10,12,10,21.125,-95.375,0,6,6
2013-10,12,11,21.125,-95.125,0,2,2
2013-10,13,11,21.375,-95.125,0,2,2
2013-10,13,12,21.375,-94.875,0,10,10
2013-10,20,41,23.125,-87.625,0,3,3
2013-10,23,62,23.875,-82.375,19,0,19
2013-10,23,63,23.875,-82.125,4,0,4
2013-10,24,54,24.125,-84.375,0,14,14
2013-10,24,62,24.125,-82.375,2,0,2
2013-10,24,63,24.125,-82.125,1,0,1
2013-10,25,54,24.375,-84.375,0,4,4
2013-10,26,9,24.625,-95.625,21,0,21
2013-10,26,10,24.625,-95.375,9,0,9
2013-10,26,20,24.625,-92.875,0,1,1
2013-10,26,54,24.625,-84.375,0,5,5
2013-10,26,70,24.625,-80.375,2,0,2
2013-10,27,10,24.875,-95.375,1,0,1
2013-10,27,19,24.875,-93.125,0,2,2
2013-10,27,20,24.875,-92.875,0,6,6
2013-10,27,21,24.875,-92.625,0,7,7
2013-10,27,22,24.875,-92.375,0,2,2
2013-10,27,44,24.875,-86.875,12,0,12
2013-10,27,45,24.875,-86.625,5,0,5
2013-10,27,54,24.875,-84.375,0,7,7
2013-10,27,55,24.875,-84.125,0,1,1
2013-10,27,71,24.875,-80.125,1,0,1
2013-10,28,22,25.125,-92.375,0,5,5
2013-10,28,23,25.125,-92.125,0,8,8
2013-10,28,44,25.125,-86.875,4,0,4
2013-10,28,45,25.125,-86.625,10,0,10
2013-10,29,31,25.375,-90.125,3,0,3
2013-10,30,31,25.625,-90.125,9,0,9
2013-10,30,32,25.625,-89.875,4,0,4
2013-10,39,43,27.875,-87.125,0,2,2
2013-10,41,41,28.375,-87.625,0,1,1
2013-10,42,41,28.625,-87.625,0,1,1
2013-10,42,42,28.625,-87.375,0,5,5
2013-11,3,50,18.875,-85.375,2,0,2
2013-11,3,51,18.875,-85.125,1,0,1
2013-11,3,52,18.875,-84.875,1,0,1
2013-11,3,54,18.875,-84.375,4,0,4
2013-11,4,49,19.125,-85.625,1,0,1
2013-11,4,50,19.125,-85.375,1,0,1
2013-11,6,47,19.625,-86.125,3,0,3
2013-11,6,48,19.625,-85.875,1,0,1
2013-11,7,47,19.875,-86.125,2,0,2
2013-11,7,59,19.875,-83.125,1,0,1
2013-11,7,60,19.875,-82.875,2,0,2
2013-11,7,71,19.875,-80.125,0,3,3
2013-11,8,47,20.125,-86.125,5,0,5
2013-11,8,60,20.125,-82.875,1,0,1
2013-11,8,61,20.125,-82.625,4,0,4
2013-11,8,62,20.125,-82.375,4,0,4
2013-11,8,70,20.125,-80.375,0,1,1
2013-11,8,71,20.125,-80.125,0,7,7
2013-11,9,13,20.375,-94.625,1,0,1
2013-11,9,14,20.375,-94.375,5,0,5
2013-11,9,47,20.375,-86.125,2,0,2
2013-11,9,63,20.375,-82.125,4,0,4
2013-11,9,64,20.375,-81.875,2,0,2
2013-11,9,70,20.375,-80.375,0,5,5
2013-11,9,71,20.375,-80.125,0,2,2
2013-11,10,14,20.625,-94.375,10,0,10
2013-11,10,15,20.625,-94.125,4,0,4
2013-11,10,48,20.625,-85.875,3,0,3
2013-11,10,65,20.625,-81.625,4,0,4
2013-11,10,66,20.625,-81.375,4,0,4
2013-11,11,14,20.875,-94.375,4,0,4
2013-11,11,15,20.875,-94.125,1,0,1
2013-11,11,49,20.875,-85.625,2,0,2
2013-11,11,50,20.875,-85.375,1,0,1
2013-11,12,16,21.125,-93.875,3,0,3
2013-11,12,50,21.125,-85.375,5,0,5
2013-11,13,16,21.375,-93.875,1,0,1
2013-11,23,55,23.875,-84.125,0,8,8
2013-11,23,63,23.875,-82.125,3,0,3
2013-11,23,64,23.875,-81.875,1,0,1
2013-11,23,66,23.875,-81.375,14,0,14
2013-11,23,67,23.875,-81.125,2,0,2
2013-11,24,63,24.125,-82.125,2,0,2
2013-11,25,54,24.375,-84.375,0,1,1
2013-11,26,8,24.625,-95.875,9,0,9
2013-11,26,18,24.625,-93.375,0,3,3
2013-11,26,54,24.625,-84.375,0,7,7
2013-11,26,55,24.625,-84.125,0,9,9
2013-11,27,6,24.875,-96.375,1,0,1
2013-11,27,7,24.875,-96.125,13,0,13
2013-11,27,8,24.875,-95.875,4,0,4
2013-11,27,13,24.875,-94.625,0,2,2
2013-11,27,14,24.875,-94.375,0,6,6
2013-11,27,15,24.875,-94.125,0,6,6
2013-11,27,16,24.875,-93.875,0,4,4
2013-11,27,17,24.875,-93.625,0,4,4
2013-11,27,18,24.875,-93.375,0,1,1
2013-11,27,19,24.875,-93.125,0,4,4
2013-11,27,55,24.875,-84.125,0,5,5
2013-11,28,31,25.125,-90.125,12,0,12
2013-11,28,32,25.125,-89.875,7,0,7
2013-11,28,45,25.125,-86.625,21,0,21
2013-11,29,7,25.375,-96.125,3,0,3
2013-11,29,31,25.375,-90.125,6,0,6
2013-11,29,32,25.375,-89.875,3,0,3
2013-11,29,45,25.375,-86.625,9,0,9
2013-11,38,42,27.625,-87.375,0,2,2
2013-11,38,43,27.625,-87.125,0,9,9
2013-11,39,41,27.875,-87.625,0,2,2
2013-11,39,42,27.875,-87.375,0,5,5
2013-11,39,43,27.875,-87.125,0,12,12
2013-12,0,67,18.125,-81.125,1,0,1
2013-12,0,68,18.125,-80.875,2,0,2
2013-12,1,66,18.375,-81.375,3,0,3
2013-12,1,67,18.375,-81.125,1,0,1
2013-12,3,54,18.875,-84.375,4,0,4
2013-12,4,54,19.125,-84.375,4,0,4
2013-12,5,49,19.375,-85.625,4,0,4
2013-12,5,50,19.375,-85.375,5,0,5
2013-12,5,51,19.375,-85.125,5,0,5
2013-12,5,52,19.375,-84.875,3,0,3
2013-12,5,53,19.375,-84.625,4,0,4
2013-12,7,68,19.875,-80.875,0,1,1
2013-12,7,69,19.875,-80.625,0,3,3
2013-12,7,70,19.875,-80.375,0,1,1
2013-12,8,68,20.125,-80.875,0,3,3
2013-12,8,69,20.125,-80.625,0,6,6
2013-12,8,70,20.125,-80.375,0,4,4
2013-12,8,71,20.125,-80.125,0,5,5
2013-12,12,22,21.125,-92.375,0,3,3
2013-12,12,51,21.125,-85.125,1,0,1
2013-12,13,14,21.375,-94.375,1,0,1
2013-12,13,15,21.375,-94.125,4,0,4
2013-12,13,16,21.375,-93.875,2,0,2
2013-12,13,21,21.375,-92.625,0,4,4
2013-12,13,22,21.375,-92.375,0,3,3
2013-12,14,13,21.625,-94.625,1,0,1
2013-12,14,14,21.625,-94.375,12,0,12
2013-12,15,13,21.875,-94.625,7,0,7
2013-12,15,14,21.875,-94.375,1,0,1
2013-12,23,52,23.875,-84.875,0,1,1
2013-12,23,53,23.875,-84.625,0,4,4
2013-12,23,54,23.875,-84.375,0,4,4
2013-12,23,55,23.875,-84.125,0,5,5
2013-12,23,63,23.875,-82.125,13,0,13
2013-12,23,64,23.875,-81.875,4,0,4
2013-12,23,66,23.875,-81.375,1,0,1
2013-12,24,51,24.125,-85.125,0,10,10
2013-12,24,52,24.125,-84.875,0,7,7
2013-12,24,69,24.125,-80.625,1,0,1
2013-12,24,70,24.125,-80.375,2,0,2
2013-12,25,71,24.375,-80.125,1,0,1
2013-12,28,6,25.125,-96.375,2,0,2
2013-12,28,13,25.125,-94.625,0,9,9
2013-12,29,7,25.375,-96.125,3,0,3
2013-12,29,13,25.375,-94.625,0,12,12
2013-12,29,32,25.375,-89.875,1,0,1
2013-12,29,45,25.375,-86.625,4,0,4
2013-12,30,7,25.625,-96.125,1,0,1
2013-12,30,13,25.625,-94.625,0,10,10
2013-12,30,43,25.625,-87.125,5,0,5
2013-12,30,44,25.625,-86.875,21,0,21
2013-12,30,45,25.625,-86.625,1,0,1
2013-12,32,27,26.125,-91.125,15,0,15
2013-12,32,28,26.125,-90.875,4,0,4
2013-12,33,29,26.375,-90.625,4,0,4
2013-12,34,9,26.625,-95.625,4,0,4
2013-12,35,9,26.875,-95.625,5,0,5
2013-12,35,10,26.875,-95.375,1,0,1
2013-12,36,9,27.125,-95.625,1,0,1
2013-12,36,10,27.125,-95.375,1,0,1
2013-12,37,10,27.375,-95.375,3,0,3
2013-12,39,39,27.875,-88.125,0,5,5
2013-12,39,40,27.875,-87.875,0,3,3
2013-12,40,38,28.125,-88.375,0,1,1
2013-12,40,39,28.125,-88.125,0,9,9
2013-12,40,40,28.125,-87.875,0,10,10
2013-12,40,41,28.125,-87.625,0,2,2
2013-12,41,40,28.375,-87.875,0,1,1
2014-01,0,47,18.125,-86.125,0,3,3
2014-01,0,48,18.125,-85.875,0,1,1
2014-01,0,49,18.125,-85.625,0,2,2
2014-01,0,50,18.125,-85.375,0,3,3
2014-01,0,51,18.125,-85.125,0,3,3
2014-01,0,52,18.125,-84.875,0,3,3
2014-01,0,53,18.125,-84.625,0,1,1
2014-01,1,48,18.375,-85.875,0,3,3
2014-01,1,49,18.375,-85.625,0,1,1
2014-01,1,65,18.375,-81.625,2,0,2
2014-01,1,66,18.375,-81.375,1,0,1
2014-01,2,63,18.625,-82.125,2,0,2
2014-01,2,64,18.625,-81.875,4,0,4
2014-01,2,65,18.625,-81.625,1,0,1
2014-01,3,45,18.875,-86.625,2,0,2
2014-01,3,46,18.875,-86.375,1,0,1
2014-01,3,62,18.875,-82.375,1,2,3
2014-01,3,70,18.875,-80.375,0,4,4
2014-01,3,71,18.875,-80.125,0,6,6
2014-01,4,64,19.125,-81.875,0,4,4
2014-01,4,65,19.125,-81.625,0,3,3
2014-01,4,66,19.125,-81.375,0,2,2
2014-01,4,67,19.125,-81.125,0,3,3
2014-01,4,68,19.125,-80.875,0,4,4
2014-01,5,45,19.375,-86.625,1,0,1
2014-01,5,46,19.375,-86.375,2,0,2
2014-01,5,59,19.375,-83.125,1,0,1
2014-01,5,68,19.375,-80.875,0,1,1
2014-01,6,57,19.625,-83.625,1,0,1
2014-01,6,58,19.625,-83.375,1,0,1
2014-01,7,46,19.875,-86.375,1,0,1
2014-01,8,47,20.125,-86.125,2,0,2
2014-01,9,46,20.375,-86.375,4,0,4
2014-01,9,47,20.375,-86.125,1,0,1
2014-01,9,67,20.375,-81.125,0,1,1
2014-01,10,67,20.625,-81.125,0,1,1
2014-01,11,18,20.875,-93.375,0,1,1
2014-01,11,19,20.875,-93.125,0,1,1
2014-01,12,18,21.125,-93.375,0,1,1
2014-01,12,19,21.125,-93.125,0,3,3
2014-01,12,20,21.125,-92.875,0,1,1
2014-01,13,18,21.375,-93.375,0,1,1
2014-01,13,21,21.375,-92.625,0,1,1
2014-01,13,22,21.375,-92.375,0,2,2
2014-01,14,12,21.625,-94.875,1,0,1
2014-01,14,13,21.625,-94.625,4,0,4
2014-01,14,18,21.625,-93.375,0,4,4
2014-01,14,19,21.625,-93.125,0,1,1
2014-01,14,20,21.625,-92.875,0,2,2
2014-01,14,21,21.625,-92.625,0,2,2
2014-01,14,22,21.625,-92.375,0,1,1
2014-01,14,23,21.625,-92.125,0,3,3
2014-01,14,24,21.625,-91.875,0,3,3
2014-01,15,12,21.875,-94.875,8,0,8
2014-01,15,18,21.875,-93.375,0,1,1
2014-01,15,19,21.875,-93.125,0,1,1
2014-01,15,20,21.875,-92.875,0,1,1
2014-01,16,12,22.125,-94.875,4,0,4
2014-01,17,10,22.375,-95.375,3,0,3
2014-01,17,11,22.375,-95.125,6,0,6
2014-01,17,12,22.375,-94.875,4,0,4
2014-01,24,48,24.125,-85.875,0,4,4
2014-01,24,49,24.125,-85.625,0,4,4
2014-01,24,51,24.125,-85.125,0,8,8
2014-01,25,51,24.375,-85.125,0,12,12
2014-01,29,12,25.375,-94.875,0,14,14
2014-01,29,13,25.375,-94.625,0,11,11
2014-01,30,13,25.625,-94.625,0,6,6
2014-01,30,44,25.625,-86.875,4,0,4
2014-01,31,26,25.875,-91.375,1,0,1
2014-01,31,27,25.875,-91.125,20,0,20
2014-01,31,28,25.875,-90.875,2,0,2
2014-01,31,43,25.875,-87.125,11,0,11
2014-01,31,44,25.875,-86.875,16,0,16
2014-01,32,26,26.125,-91.375,5,0,5
2014-01,32,27,26.125,-91.125,1,0,1
2014-01,35,20,26.875,-92.875,0,3,3
2014-01,36,11,27.125,-95.125,3,0,3
2014-01,36,12,27.125,-94.875,6,0,6
2014-01,36,13,27.125,-94.625,1,0,1
2014-01,36,14,27.125,-94.375,1,0,1
2014-01,36,15,27.125,-94.125,1,0,1
2014-01,36,20,27.125,-92.875,0,4,4
2014-01,37,18,27.375,-93.375,0,4,4
2014-01,37,19,27.375,-93.125,0,7,7
2014-01,37,20,27.375,-92.875,0,4,4
2014-01,38,19,27.625,-93.125,0,4,4
2014-01,38,35,27.625,-89.125,0,1,1
2014-01,38,36,27.625,-88.875,0,6,6
2014-01,38,37,27.625,-88.625,0,4,4
2014-01,39,37,27.875,-88.625,0,1,1
2014-01,39,38,27.875,-88.375,0,15,15
2014-01,39,39,27.875,-88.125,0,4,4
2014-02,0,46,18.125,-86.375,0,5,5
2014-02,0,47,18.125,-86.125,0,1,1
2014-02,0,48,18.125,-85.875,0,1,1
2014-02,0,53,18.125,-84.625,3,0,3
2014-02,0,54,18.125,-84.375,2,0,2
2014-02,0,55,18.125,-84.125,1,0,1
2014-02,0,68,18.125,-80.875,3,0,3
2014-02,1,46,18.375,-86.375,0,2,2
2014-02,1,47,18.375,-86.125,0,3,3
2014-02,1,49,18.375,-85.625,0,1,1
2014-02,1,50,18.375,-85.375,0,1,1
2014-02,1,69,18.375,-80.625,1,0,1
2014-02,2,47,18.625,-86.125,0,1,1
2014-02,2,48,18.625,-85.875,0,2,2
2014-02,2,71,18.625,-80.125,2,0,2
2014-02,3,46,18.875,-86.375,0,4,4
2014-02,3,47,18.875,-86.125,0,3,3
2014-02,3,60,18.875,-82.875,0,1,1
2014-02,3,61,18.875,-82.625,0,1,1
2014-02,3,62,18.875,-82.375,0,2,2
2014-02,4,58,19.125,-83.375,0,2,2
2014-02,4,59,19.125,-83.125,0,1,1
2014-02,6,63,19.625,-82.125,0,1,1
2014-02,7,60,19.875,-82.875,0,3,3
2014-02,7,61,19.875,-82.625,0,3,3
2014-02,7,62,19.875,-82.375,0,3,3
2014-02,7,63,19.875,-82.125,0,1,1
2014-02,9,61,20.375,-82.625,0,1,1
2014-02,10,62,20.625,-82.375,0,5,5
2014-02,10,63,20.625,-82.125,0,1,1
2014-02,10,66,20.625,-81.375,0,3,3
2014-02,10,67,20.625,-81.125,0,1,1
2014-02,10,68,20.625,-80.875,1,0,1
2014-02,10,69,20.625,-80.625,3,0,3
2014-02,10,70,20.625,-80.375,2,0,2
2014-02,11,69,20.875,-80.625,1,0,1
2014-02,13,67,21.375,-81.125,7,0,7
2014-02,13,68,21.375,-80.875,5,0,5
2014-02,14,16,21.625,-93.875,0,4,4
2014-02,14,17,21.625,-93.625,0,6,6
2014-02,14,18,21.625,-93.375,0,9,9
2014-02,15,16,21.875,-93.875,0,6,6
2014-02,15,18,21.875,-93.375,0,3,3
2014-02,16,8,22.125,-95.875,6,0,6
2014-02,16,9,22.125,-95.625,3,0,3
2014-02,17,9,22.375,-95.625,12,0,12
2014-02,17,10,22.375,-95.375,3,0,3
2014-02,18,9,22.625,-95.625,4,0,4
2014-02,21,25,23.375,-91.625,0,6,6
2014-02,22,34,23.625,-89.375,0,3,3
2014-02,23,35,23.875,-89.125,0,7,7
2014-02,24,48,24.125,-85.875,0,4,4
2014-02,24,49,24.125,-85.625,0,7,7
2014-02,25,48,24.375,-85.875,0,6,6
2014-02,26,47,24.625,-86.125,0,1,1
2014-02,26,48,24.625,-85.875,0,2,2
2014-02,27,46,24.875,-86.375,0,1,1
2014-02,27,47,24.875,-86.125,0,4,4
2014-02,27,53,24.875,-84.625,1,0,1
2014-02,28,46,25.125,-86.375,0,1,1
2014-02,28,47,25.125,-86.125,0,2,2
2014-02,28,53,25.125,-84.625,2,0,2
2014-02,29,12,25.375,-94.875,0,28,28
2014-02,29,53,25.375,-84.625,5,0,5
2014-02,30,40,25.625,-87.875,7,0,7
2014-02,30,41,25.625,-87.625,9,0,9
2014-02,30,52,25.625,-84.875,3,0,3
2014-02,30,53,25.625,-84.625,5,0,5
2014-02,31,40,25.875,-87.875,6,0,6
2014-02,31,44,25.875,-86.875,3,0,3
2014-02,31,50,25.875,-85.375,2,0,2
2014-02,31,51,25.875,-85.125,3,0,3
2014-02,31,52,25.875,-84.875,3,0,3
2014-02,32,40,26.125,-87.875,1,0,1
2014-02,37,17,27.375,-93.625,0,3,3
2014-02,37,18,27.375,-93.375,0,2,2
2014-02,38,35,27.625,-89.125,0,4,4
2014-02,38,36,27.625,-88.875,0,4,4
2014-02,39,34,27.875,-89.375,0,4,4
2014-02,39,35,27.875,-89.125,0,16,16
2014-02,41,49,28.375,-85.625,2,0,2
2014-02,41,50,28.375,-85.375,3,0,3
2014-02,42,49,28.625,-85.625,5,0,5
2014-02,42,50,28.625,-85.375,2,0,2
2014-02,43,48,28.875,-85.875,1,0,1
2014-02,43,49,28.875,-85.625,1,0,1
2014-03,3,45,18.875,-86.625,0,1,1
2014-03,3,46,18.875,-86.375,0,1,1
2014-03,4,45,19.125,-86.625,0,3,3
2014-03,5,45,19.375,-86.625,0,3,3
2014-03,5,65,19.375,-81.625,0,5,5
2014-03,6,12,19.625,-94.875,4,0,4
2014-03,6,63,19.625,-82.125,0,3,3
2014-03,6,64,19.625,-81.875,0,2,2
2014-03,6,65,19.625,-81.625,0,1,1
2014-03,7,12,19.875,-94.875,8,0,8
2014-03,7,13,19.875,-94.625,3,0,3
2014-03,7,58,19.875,-83.375,0,3,3
2014-03,7,59,19.875,-83.125,0,3,3
2014-03,8,11,20.125,-95.125,2,0,2
2014-03,8,13,20.125,-94.625,4,0,4
2014-03,8,53,20.125,-84.625,1,0,1
2014-03,8,58,20.125,-83.375,0,4,4
2014-03,8,59,20.125,-83.125,0,1,1
2014-03,9,13,20.375,-94.625,2,0,2
2014-03,9,14,20.375,-94.375,1,0,1
2014-03,9,53,20.375,-84.625,1,0,1
2014-03,9,59,20.375,-83.125,0,9,9
2014-03,9,67,20.375,-81.125,4,0,4
2014-03,9,68,20.375,-80.875,1,0,1
2014-03,10,13,20.625,-94.625,1,0,1
2014-03,10,14,20.625,-94.375,3,0,3
2014-03,10,52,20.625,-84.875,11,0,11
2014-03,10,53,20.625,-84.625,2,0,2
2014-03,10,67,20.625,-81.125,7,0,7
2014-03,10,68,20.625,-80.875,11,0,11
2014-03,11,52,20.875,-84.875,6,0,6
2014-03,11,67,20.875,-81.125,2,0,2
2014-03,11,68,20.875,-80.875,6,0,6
2014-03,12,52,21.125,-84.875,2,0,2
2014-03,15,15,21.875,-94.125,0,6,6
2014-03,15,16,21.875,-93.875,0,1,1
2014-03,16,13,22.125,-94.625,0,4,4
2014-03,16,14,22.125,-94.375,0,7,7
2014-03,16,15,22.125,-94.125,0,2,2
2014-03,17,12,22.375,-94.875,0,3,3
2014-03,17,13,22.375,-94.625,0,5,5
2014-03,18,11,22.625,-95.125,0,2,2
2014-03,18,12,22.625,-94.875,0,1,1
2014-03,20,8,23.125,-95.875,4,0,4
2014-03,20,9,23.125,-95.625,8,0,8
2014-03,21,6,23.375,-96.375,2,0,2
2014-03,21,7,23.375,-96.125,10,0,10
2014-03,21,8,23.375,-95.875,5,0,5
2014-03,21,21,23.375,-92.625,0,2,2
2014-03,21,22,23.375,-92.375,0,1,1
2014-03,21,24,23.375,-91.875,0,1,1
2014-03,22,6,23.625,-96.375,2,0,2
2014-03,22,22,23.625,-92.375,0,8,8
2014-03,22,23,23.625,-92.125,0,7,7
2014-03,22,24,23.625,-91.875,0,6,6
2014-03,22,53,23.625,-84.625,3,0,3
2014-03,22,54,23.625,-84.375,6,0,6
2014-03,23,35,23.875,-89.125,0,2,2
2014-03,23,53,23.875,-84.625,3,0,3
2014-03,23,54,23.875,-84.375,4,0,4
2014-03,24,34,24.125,-89.375,0,5,5
2014-03,24,35,24.125,-89.125,0,4,4
2014-03,24,54,24.125,-84.375,4,0,4
2014-03,25,34,24.375,-89.375,0,8,8
2014-03,25,53,24.375,-84.625,2,0,2
2014-03,25,54,24.375,-84.375,3,0,3
2014-03,26,53,24.625,-84.625,4,0,4
2014-03,27,13,24.875,-94.625,0,1,1
2014-03,27,53,24.875,-84.625,2,0,2
2014-03,28,12,25.125,-94.875,0,3,3
2014-03,28,13,25.125,-94.625,0,6,6
2014-03,28,46,25.125,-86.375,0,16,16
2014-03,28,47,25.125,-86.125,0,7,7
2014-03,29,11,25.375,-95.125,0,3,3
2014-03,29,12,25.375,-94.875,0,18,18
2014-03,29,21,25.375,-92.625,5,0,5
2014-03,29,22,25.375,-92.375,17,0,17
2014-03,29,47,25.375,-86.125,0,8,8
2014-03,30,22,25.625,-92.375,3,0,3
2014-03,31,38,25.875,-88.375,10,0,10
2014-03,31,39,25.875,-88.125,1,0,1
2014-03,32,38,26.125,-88.375,6,0,6
2014-03,32,39,26.125,-88.125,12,0,12
2014-03,32,40,26.125,-87.875,2,0,2
2014-03,35,12,26.875,-94.875,1,0,1
2014-03,35,13,26.875,-94.625,12,0,12
2014-03,35,14,26.875,-94.375,12,0,12
2014-03,37,34,27.375,-89.375,0,5,5
2014-03,38,33,27.625,-89.625,0,4,4
2014-03,38,34,27.625,-89.375,0,16,16
2014-03,39,34,27.875,-89.375,0,6,6
2014-03,41,50,28.375,-85.375,10,0,10
2014-03,42,49,28.625,-85.625,6,0,6
2014-03,42,50,28.625,-85.375,1,0,1
2014-04,0,46,18.125,-86.375,9,0,9
2014-04,2,71,18.625,-80.125,0,2,2
2014-04,5,55,19.375,-84.125,0,5,5
2014-04,5,56,19.375,-83.875,0,1,1
2014-04,5,58,19.375,-83.375,0,1,1
2014-04,6,56,19.625,-83.875,0,9,9
2014-04,6,57,19.625,-83.625,0,2,2
2014-04,6,58,19.625,-83.375,0,2,2
2014-04,6,59,19.625,-83.125,0,3,3
2014-04,6,60,19.625,-82.875,0,1,1
2014-04,6,61,19.625,-82.625,0,3,3
2014-04,6,62,19.625,-82.375,0,3,3
2014-04,7,66,19.875,-81.375,2,0,2
2014-04,8,10,20.125,-95.375,1,0,1
2014-04,8,66,20.125,-81.375,2,0,2
2014-04,9,10,20.375,-95.375,7,0,7
2014-04,10,10,20.625,-95.375,5,0,5
2014-04,10,11,20.625,-95.125,7,0,7
2014-04,10,12,20.625,-94.875,5,0,5
2014-04,10,13,20.625,-94.625,5,0,5
2014-04,10,66,20.625,-81.375,1,0,1
2014-04,10,67,20.625,-81.125,6,0,6
2014-04,10,68,20.625,-80.875,2,0,2
2014-04,11,67,20.875,-81.125,1,0,1
2014-04,11,68,20.875,-80.875,6,0,6
2014-04,12,52,21.125,-84.875,4,0,4
2014-04,12,58,21.125,-83.375,8,0,8
2014-04,13,52,21.375,-84.875,2,0,2
2014-04,13,58,21.375,-83.375,2,0,2
2014-04,13,59,21.375,-83.125,2,0,2
2014-04,18,10,22.625,-95.375,0,4,4
2014-04,18,11,22.625,-95.125,0,2,2
2014-04,18,13,22.625,-94.625,0,5,5
2014-04,18,14,22.625,-94.375,0,1,1
2014-04,19,14,22.875,-94.375,0,3,3
2014-04,20,13,23.125,-94.625,0,1,1
2014-04,21,13,23.375,-94.625,0,5,5
2014-04,21,55,23.375,-84.125,2,0,2
2014-04,21,56,23.375,-83.875,2,0,2
2014-04,22,12,23.625,-94.875,0,2,2
2014-04,22,13,23.625,-94.625,0,3,3
2014-04,22,54,23.625,-84.375,1,0,1
2014-04,22,55,23.625,-84.125,3,0,3
2014-04,22,56,23.625,-83.875,2,0,2
2014-04,23,6,23.875,-96.375,5,0,5
2014-04,23,12,23.875,-94.875,0,3,3
2014-04,23,28,23.875,-90.875,0,2,2
2014-04,23,29,23.875,-90.625,0,1,1
2014-04,23,54,23.875,-84.375,2,0,2
2014-04,23,56,23.875,-83.875,3,0,3
2014-04,24,6,24.125,-96.375,8,0,8
2014-04,24,12,24.125,-94.875,0,1,1
2014-04,24,27,24.125,-91.125,0,12,12
2014-04,24,29,24.125,-90.625,0,1,1
2014-04,24,30,24.125,-90.375,0,1,1
2014-04,24,54,24.125,-84.375,7,0,7
2014-04,25,6,24.375,-96.375,6,0,6
2014-04,25,26,24.375,-91.375,0,3,3
2014-04,25,27,24.375,-91.125,0,5,5
2014-04,25,54,24.375,-84.375,3,0,3
2014-04,26,6,24.625,-96.375,2,0,2
2014-04,26,7,24.625,-96.125,4,0,4
2014-04,27,8,24.875,-95.875,5,0,5
2014-04,27,13,24.875,-94.625,0,6,6
2014-04,28,19,25.125,-93.125,7,0,7
2014-04,28,20,25.125,-92.875,11,0,11
2014-04,28,21,25.125,-92.625,8,0,8
2014-04,28,46,25.125,-86.375,0,7,7
2014-04,29,21,25.375,-92.625,3,0,3
2014-04,29,22,25.375,-92.375,1,0,1
2014-04,29,45,25.375,-86.625,0,5,5
2014-04,29,46,25.375,-86.375,0,3,3
2014-04,30,45,25.625,-86.625,0,6,6
2014-04,31,45,25.875,-86.625,0,3,3
2014-04,31,46,25.875,-86.375,0,1,1
2014-04,32,38,26.125,-88.375,13,0,13
2014-04,32,39,26.125,-88.125,8,0,8
2014-04,32,46,26.125,-86.375,0,5,5
2014-04,33,11,26.375,-95.125,2,0,2
2014-04,33,38,26.375,-88.375,4,0,4
2014-04,33,39,26.375,-88.125,2,0,2
2014-04,34,11,26.625,-95.125,18,0,18
2014-04,34,12,26.625,-94.875,1,0,1
2014-04,34,39,26.625,-88.125,3,0,3
2014-04,35,12,26.875,-94.875,9,0,9
2014-04,35,30,26.875,-90.375,0,3,3
2014-04,35,31,26.875,-90.125,0,2,2
2014-04,36,29,27.125,-90.625,0,8,8
2014-04,36,30,27.125,-90.375,0,2,2
2014-04,36,31,27.125,-90.125,0,6,6
2014-04,36,33,27.125,-89.625,0,4,4
2014-04,36,34,27.125,-89.375,0,3,3
2014-04,37,30,27.375,-90.375,0,1,1
2014-04,37,34,27.375,-89.375,0,1,1
2014-05,0,43,18.125,-87.125,3,0,3
2014-05,0,44,18.125,-86.875,7,0,7
2014-05,0,45,18.125,-86.625,2,0,2
2014-05,0,46,18.125,-86.375,1,0,1
2014-05,1,45,18.375,-86.625,6,0,6
2014-05,1,46,18.375,-86.375,3,0,3
2014-05,3,67,18.875,-81.125,0,3,3
2014-05,3,68,18.875,-80.875,0,3,3
2014-05,3,69,18.875,-80.625,0,2,2
2014-05,3,70,18.875,-80.375,0,4,4
2014-05,3,71,18.875,-80.125,0,4,4
2014-05,4,50,19.125,-85.375,0,2,2
2014-05,4,51,19.125,-85.125,0,6,6
2014-05,4,52,19.125,-84.875,0,7,7
2014-05,4,53,19.125,-84.625,0,5,5
2014-05,4,54,19.125,-84.375,0,8,8
2014-05,4,64,19.125,-81.875,0,1,1
2014-05,4,65,19.125,-81.625,0,3,3
2014-05,4,66,19.125,-81.375,0,2,2
2014-05,5,54,19.375,-84.375,0,2,2
2014-05,5,63,19.375,-82.125,0,2,2
2014-05,5,64,19.375,-81.875,0,2,2
2014-05,7,11,19.875,-95.125,3,0,3
2014-05,8,11,20.125,-95.125,12,0,12
2014-05,8,12,20.125,-94.875,16,0,16
2014-05,9,57,20.375,-83.625,14,0,14
2014-05,9,58,20.375,-83.375,7,0,7
2014-05,10,58,20.625,-83.375,4,0,4
2014-05,11,58,20.875,-83.375,5,0,5
2014-05,12,58,21.125,-83.375,1,0,1
2014-05,16,10,22.125,-95.375,0,1,1
2014-05,17,11,22.375,-95.125,0,6,6
2014-05,17,12,22.375,-94.875,0,8,8
2014-05,17,13,22.375,-94.625,0,2,2
2014-05,18,12,22.625,-94.875,0,8,8
2014-05,18,13,22.625,-94.625,0,6,6
2014-05,20,49,23.125,-85.625,1,0,1
2014-05,21,34,23.375,-89.375,0,1,1
2014-05,21,35,23.375,-89.125,0,7,7
2014-05,21,36,23.375,-88.875,0,9,9
2014-05,21,37,23.375,-88.625,0,2,2
2014-05,21,49,23.375,-85.625,5,0,5
2014-05,21,50,23.375,-85.375,1,0,1
2014-05,22,23,23.625,-92.125,0,1,1
2014-05,22,24,23.625,-91.875,0,13,13
2014-05,22,50,23.625,-85.375,5,0,5
2014-05,22,51,23.625,-85.125,1,0,1
2014-05,23,25,23.875,-91.625,0,4,4
2014-05,23,51,23.875,-85.125,8,0,8
2014-05,23,52,23.875,-84.875,3,0,3
2014-05,23,54,23.875,-84.375,5,0,5
2014-05,24,53,24.125,-84.625,1,0,1
2014-05,24,54,24.125,-84.375,1,0,1
2014-05,25,26,24.375,-91.375,0,8,8
2014-05,27,8,24.875,-95.875,2,0,2
2014-05,27,32,24.875,-89.875,2,0,2
2014-05,27,33,24.875,-89.625,3,0,3
2014-05,28,14,25.125,-94.375,10,0,10
2014-05,28,18,25.125,-93.375,6,0,6
2014-05,28,19,25.125,-93.125,1,0,1
2014-05,28,33,25.125,-89.625,8,0,8
2014-05,29,15,25.375,-94.125,14,0,14
2014-05,29,32,25.375,-89.875,1,0,1
2014-05,29,44,25.375,-86.875,0,4,4
2014-05,29,45,25.375,-86.625,0,2,2
2014-05,30,10,25.625,-95.375,1,0,1
2014-05,30,45,25.625,-86.625,0,3,3
2014-05,30,46,25.625,-86.375,0,5,5
2014-05,31,46,25.875,-86.375,0,2,2
2014-05,31,47,25.875,-86.125,0,11,11
2014-05,32,46,26.125,-86.375,0,4,4
2014-05,33,11,26.375,-95.125,2,0,2
2014-05,34,25,26.625,-91.625,0,1,1
2014-05,34,26,26.625,-91.375,0,8,8
2014-05,34,27,26.625,-91.125,0,9,9
2014-05,34,28,26.625,-90.875,0,4,4
2014-05,35,28,26.875,-90.875,0,6,6
2014-05,35,39,26.875,-88.125,1,0,1
2014-05,36,28,27.125,-90.875,0,3,3
2014-05,36,40,27.125,-87.875,1,0,1
2014-05,37,40,27.375,-87.875,2,0,2
2014-05,37,41,27.375,-87.625,3,0,3
2014-05,37,43,27.375,-87.125,2,0,2
2014-05,37,44,27.375,-86.875,4,0,4
2014-05,37,45,27.375,-86.625,3,0,3
2014-05,38,41,27.625,-87.625,2,0,2
2014-05,38,42,27.625,-87.375,5,0,5
2014-05,38,43,27.625,-87.125,8,0,8
2014-06,3,45,18.875,-86.625,0,1,1
2014-06,3,46,18.875,-86.375,0,5,5
2014-06,3,47,18.875,-86.125,0,1,1
2014-06,3,48,18.875,-85.875,0,4,4
2014-06,3,55,18.875,-84.125,1,0,1
2014-06,3,56,18.875,-83.875,5,0,5
2014-06,3,57,18.875,-83.625,5,0,5
2014-06,3,58,18.875,-83.375,4,0,4
2014-06,4,45,19.125,-86.625,0,2,2
2014-06,4,47,19.125,-86.125,0,2,2
2014-06,4,48,19.125,-85.875,0,5,5
2014-06,4,49,19.125,-85.625,0,4,4
2014-06,4,50,19.125,-85.375,0,1,1
2014-06,4,53,19.125,-84.625,0,4,4
2014-06,6,11,19.625,-95.125,6,0,6
2014-06,6,63,19.625,-82.125,0,3,3
2014-06,6,64,19.625,-81.875,0,2,2
2014-06,7,10,19.875,-95.375,6,0,6
2014-06,7,11,19.875,-95.125,18,0,18
2014-06,7,63,19.875,-82.125,0,2,2
2014-06,7,64,19.875,-81.875,0,1,1
2014-06,8,55,20.125,-84.125,3,0,3
2014-06,8,56,20.125,-83.875,3,0,3
2014-06,9,56,20.375,-83.875,3,0,3
2014-06,9,57,20.375,-83.625,6,0,6
2014-06,16,9,22.125,-95.625,0,17,17
2014-06,16,10,22.125,-95.375,0,11,11
2014-06,17,8,22.375,-95.875,0,2,2
2014-06,20,32,23.125,-89.875,0,1,1
2014-06,20,33,23.125,-89.625,0,11,11
2014-06,20,34,23.125,-89.375,0,3,3
2014-06,20,35,23.125,-89.125,0,1,1
2014-06,20,44,23.125,-86.875,1,0,1
2014-06,20,45,23.125,-86.625,1,0,1
2014-06,20,46,23.125,-86.375,1,0,1
2014-06,20,49,23.125,-85.625,7,0,7
2014-06,21,34,23.375,-89.375,0,1,1
2014-06,21,35,23.375,-89.125,0,10,10
2014-06,21,43,23.375,-87.125,1,0,1
2014-06,21,44,23.375,-86.875,1,0,1
2014-06,22,23,23.625,-92.125,0,3,3
2014-06,22,24,23.625,-91.875,0,7,7
2014-06,22,42,23.625,-87.375,1,0,1
2014-06,22,43,23.625,-87.125,2,0,2
2014-06,23,42,23.875,-87.375,2,0,2
2014-06,24,50,24.125,-85.375,0,1,1
2014-06,25,50,24.375,-85.375,0,6,6
2014-06,25,51,24.375,-85.125,0,3,3
2014-06,26,50,24.625,-85.375,0,3,3
2014-06,26,51,24.625,-85.125,0,1,1
2014-06,27,50,24.875,-85.375,0,6,6
2014-06,28,14,25.125,-94.375,4,0,4
2014-06,29,13,25.375,-94.625,12,0,12
2014-06,29,14,25.375,-94.375,14,0,14
2014-06,29,32,25.375,-89.875,8,0,8
2014-06,29,44,25.375,-86.875,0,10,10
2014-06,30,32,25.625,-89.875,9,0,9
2014-06,30,33,25.625,-89.625,2,0,2
2014-06,30,41,25.625,-87.625,0,1,1
2014-06,31,40,25.875,-87.875,0,1,1
2014-06,31,41,25.875,-87.625,0,2,2
2014-06,32,40,26.125,-87.875,0,4,4
2014-06,33,23,26.375,-92.125,0,4,4
2014-06,33,24,26.375,-91.875,0,3,3
2014-06,33,39,26.375,-88.125,0,3,3
2014-06,33,40,26.375,-87.875,0,1,1
2014-06,33,48,26.375,-85.875,5,0,5
2014-06,34,24,26.625,-91.875,0,13,13
2014-06,34,38,26.625,-88.375,0,3,3
2014-06,34,48,26.625,-85.875,5,0,5
2014-06,35,24,26.875,-91.875,0,2,2
2014-06,35,25,26.875,-91.625,0,8,8
2014-06,35,37,26.875,-88.625,0,1,1
2014-06,35,46,26.875,-86.375,1,0,1
2014-06,35,47,26.875,-86.125,6,0,6
2014-06,36,6,27.125,-96.375,0,8,8
2014-06,36,45,27.125,-86.625,2,0,2
2014-06,36,46,27.125,-86.375,10,0,10
2014-06,37,7,27.375,-96.125,0,10,10
2014-06,37,45,27.375,-86.625,1,0,1
2014-07,3,44,18.875,-86.875,0,2,2
2014-07,3,53,18.875,-84.625,2,0,2
2014-07,3,54,18.875,-84.375,3,0,3
2014-07,3,55,18.875,-84.125,1,0,1
2014-07,4,50,19.125,-85.375,1,0,1
2014-07,4,51,19.125,-85.125,1,0,1
2014-07,4,52,19.125,-84.875,2,0,2
2014-07,4,60,19.125,-82.875,0,1,1
2014-07,4,61,19.125,-82.625,0,3,3
2014-07,5,49,19.375,-85.625,3,0,3
2014-07,5,50,19.375,-85.375,1,0,1
2014-07,5,57,19.375,-83.625,0,2,2
2014-07,5,58,19.375,-83.375,0,5,5
2014-07,5,61,19.375,-82.625,0,2,2
2014-07,5,62,19.375,-82.375,0,4,4
2014-07,6,47,19.625,-86.125,1,0,1
2014-07,6,48,19.625,-85.875,4,0,4
2014-07,6,62,19.625,-82.375,0,9,9
2014-07,6,63,19.625,-82.125,0,5,5
2014-07,7,9,19.875,-95.625,10,0,10
2014-07,7,10,19.875,-95.375,13,0,13
2014-07,7,11,19.875,-95.125,1,0,1
2014-07,7,47,19.875,-86.125,3,0,3
2014-07,7,53,19.875,-84.625,4,0,4
2014-07,7,54,19.875,-84.375,6,0,6
2014-07,7,68,19.875,-80.875,3,0,3
2014-07,7,69,19.875,-80.625,4,0,4
2014-07,8,46,20.125,-86.375,3,0,3
2014-07,8,69,20.125,-80.625,1,0,1
2014-07,8,70,20.125,-80.375,4,0,4
2014-07,8,71,20.125,-80.125,17,0,17
2014-07,9,46,20.375,-86.375,1,0,1
2014-07,9,47,20.375,-86.125,1,0,1
2014-07,12,13,21.125,-94.625,0,4,4
2014-07,13,13,21.375,-94.625,0,4,4
2014-07,13,14,21.375,-94.375,0,5,5
2014-07,14,14,21.625,-94.375,0,3,3
2014-07,15,14,21.875,-94.375,0,4,4
2014-07,17,6,22.375,-96.375,0,1,1
2014-07,17,8,22.375,-95.875,0,5,5
2014-07,18,6,22.625,-96.375,0,2,2
2014-07,19,5,22.875,-96.625,0,3,3
2014-07,20,5,23.125,-96.625,0,2,2
2014-07,20,6,23.125,-96.375,0,4,4
2014-07,20,32,23.125,-89.875,0,1,1
2014-07,21,6,23.375,-96.375,0,8,8
2014-07,21,34,23.375,-89.375,0,3,3
2014-07,22,7,23.625,-96.125,0,4,4
2014-07,22,34,23.625,-89.375,0,3,3
2014-07,23,7,23.875,-96.125,0,2,2
2014-07,23,61,23.875,-82.625,1,0,1
2014-07,23,62,23.875,-82.375,7,0,7
2014-07,24,49,24.125,-85.625,0,2,2
2014-07,24,50,24.125,-85.375,0,19,19
2014-07,24,64,24.125,-81.875,2,0,2
2014-07,24,65,24.125,-81.625,5,0,5
2014-07,24,66,24.125,-81.375,2,0,2
2014-07,24,67,24.125,-81.125,1,0,1
2014-07,24,68,24.125,-80.875,1,0,1
2014-07,25,47,24.375,-86.125,0,2,2
2014-07,25,48,24.375,-85.875,0,1,1
2014-07,25,49,24.375,-85.625,0,3,3
2014-07,25,62,24.375,-82.375,5,0,5
2014-07,25,63,24.375,-82.125,1,0,1
2014-07,26,46,24.625,-86.375,0,4,4
2014-07,28,28,25.125,-90.875,6,0,6
2014-07,28,53,25.125,-84.625,1,0,1
2014-07,28,54,25.125,-84.375,2,0,2
2014-07,29,12,25.375,-94.875,7,0,7
2014-07,29,13,25.375,-94.625,12,0,12
2014-07,29,28,25.375,-90.875,2,0,2
2014-07,29,29,25.375,-90.625,7,0,7
2014-07,29,30,25.375,-90.375,2,0,2
2014-07,29,39,25.375,-88.125,2,0,2
2014-07,29,53,25.375,-84.625,2,0,2
2014-07,29,54,25.375,-84.375,1,0,1
2014-07,29,55,25.375,-84.125,4,0,4
2014-07,30,13,25.625,-94.625,5,0,5
2014-07,30,37,25.625,-88.625,1,0,1
2014-07,30,38,25.625,-88.375,2,0,2
2014-07,30,39,25.625,-88.125,2,0,2
2014-07,30,40,25.625,-87.875,1,0,1
2014-07,31,13,25.875,-94.625,6,0,6
2014-07,31,41,25.875,-87.625,5,0,5
2014-07,31,42,25.875,-87.375,6,0,6
2014-07,31,43,25.875,-87.125,3,0,3
2014-07,32,13,26.125,-94.625,1,0,1
2014-07,33,21,26.375,-92.625,0,16,16
2014-07,33,22,26.375,-92.375,0,10,10
2014-07,33,23,26.375,-92.125,0,5,5
2014-07,33,46,26.375,-86.375,1,0,1
2014-07,33,47,26.375,-86.125,5,0,5
2014-07,33,48,26.375,-85.875,3,0,3
2014-07,35,7,26.875,-96.125,0,12,12
2014-07,35,36,26.875,-88.875,0,1,1
2014-07,35,37,26.875,-88.625,0,2,2
2014-07,36,7,27.125,-96.125,0,9,9
2014-07,36,8,27.125,-95.875,0,6,6
2014-07,36,36,27.125,-88.875,0,5,5
2014-07,37,7,27.375,-96.125,0,2,2
2014-07,37,35,27.375,-89.125,0,8,8
2014-07,37,36,27.375,-88.875,0,15,15
2014-08,3,51,18.875,-85.125,0,1,1
2014-08,3,58,18.875,-83.375,0,1,1
2014-08,3,59,18.875,-83.125,0,1,1
2014-08,4,49,19.125,-85.625,0,3,3
2014-08,4,50,19.125,-85.375,0,6,6
2014-08,4,51,19.125,-85.125,0,1,1
2014-08,4,52,19.125,-84.875,0,1,1
2014-08,4,53,19.125,-84.625,0,3,3
2014-08,4,54,19.125,-84.375,0,2,2
2014-08,4,55,19.125,-84.125,0,3,3
2014-08,4,56,19.125,-83.875,0,2,2
2014-08,4,57,19.125,-83.625,0,2,2
2014-08,4,63,19.125,-82.125,1,0,1
2014-08,4,64,19.125,-81.875,1,0,1
2014-08,4,65,19.125,-81.625,3,0,3
2014-08,5,50,19.375,-85.375,0,5,5
2014-08,5,62,19.375,-82.375,5,0,5
2014-08,5,63,19.375,-82.125,2,0,2
2014-08,5,64,19.375,-81.875,1,0,1
2014-08,7,53,19.875,-84.625,2,0,2
2014-08,7,65,19.875,-81.625,4,0,4
2014-08,7,66,19.875,-81.375,5,0,5
2014-08,7,67,19.875,-81.125,6,0,6
2014-08,7,68,19.875,-80.875,3,0,3
2014-08,8,53,20.125,-84.625,2,0,2
2014-08,9,53,20.375,-84.625,3,0,3
2014-08,10,13,20.625,-94.625,0,15,15
2014-08,10,53,20.625,-84.625,1,0,1
2014-08,10,54,20.625,-84.375,8,0,8
2014-08,11,6,20.875,-96.375,1,0,1
2014-08,11,13,20.875,-94.625,0,1,1
2014-08,11,14,20.875,-94.375,0,10,10
2014-08,11,54,20.875,-84.375,2,0,2
2014-08,12,6,21.125,-96.375,1,0,1
2014-08,12,7,21.125,-96.125,2,0,2
2014-08,12,13,21.125,-94.625,0,3,3
2014-08,12,15,21.125,-94.125,0,1,1
2014-08,13,13,21.375,-94.625,0,1,1
2014-08,14,19,21.625,-93.125,6,0,6
2014-08,22,8,23.625,-95.875,0,14,14
2014-08,23,8,23.875,-95.875,0,14,14
2014-08,24,8,24.125,-95.875,0,3,3
2014-08,24,68,24.125,-80.875,1,0,1
2014-08,25,53,24.375,-84.625,2,0,2
2014-08,25,54,24.375,-84.375,3,0,3
2014-08,25,68,24.375,-80.875,1,0,1
2014-08,25,69,24.375,-80.625,3,0,3
2014-08,25,70,24.375,-80.375,2,0,2
2014-08,26,46,24.625,-86.375,0,3,3
2014-08,26,52,24.625,-84.875,6,0,6
2014-08,26,54,24.625,-84.375,6,0,6
2014-08,27,45,24.875,-86.625,0,8,8
2014-08,27,54,24.875,-84.375,4,0,4
2014-08,28,27,25.125,-91.125,11,0,11
2014-08,28,28,25.125,-90.875,2,0,2
2014-08,28,44,25.125,-86.875,0,5,5
2014-08,28,45,25.125,-86.625,0,2,2
2014-08,28,53,25.125,-84.625,1,0,1
2014-08,28,54,25.125,-84.375,2,0,2
2014-08,29,36,25.375,-88.875,2,0,2
2014-08,29,44,25.375,-86.875,0,1,1
2014-08,29,54,25.375,-84.375,2,0,2
2014-08,30,36,25.625,-88.875,8,0,8
2014-08,30,37,25.625,-88.625,3,0,3
2014-08,32,11,26.125,-95.125,7,0,7
2014-08,32,13,26.125,-94.625,6,0,6
2014-08,33,11,26.375,-95.125,10,0,10
2014-08,33,12,26.375,-94.875,8,0,8
2014-08,33,21,26.375,-92.625,0,15,15
2014-08,34,20,26.625,-92.875,0,5,5
2014-08,34,21,26.625,-92.625,0,11,11
2014-08,35,39,26.875,-88.125,0,3,3
2014-08,35,40,26.875,-87.875,0,9,9
2014-08,36,8,27.125,-95.875,0,12,12
2014-08,36,38,27.125,-88.375,0,3,3
2014-08,37,8,27.375,-95.875,0,8,8
2014-08,37,35,27.375,-89.125,0,11,11
2014-08,37,36,27.375,-88.875,0,3,3
2014-08,37,37,27.375,-88.625,0,2,2
2014-08,44,40,29.125,-87.875,2,0,2
2014-08,45,40,29.375,-87.875,4,0,4
2014-08,46,39,29.625,-88.125,1,0,1
2014-09,2,44,18.625,-86.875,0,2,2
2014-09,2,53,18.625,-84.625,1,0,1
2014-09,2,54,18.625,-84.375,2,0,2
2014-09,2,55,18.625,-84.125,1,0,1
2014-09,2,56,18.625,-83.875,3,0,3
2014-09,2,57,18.625,-83.625,2,0,2
2014-09,2,58,18.625,-83.375,3,0,3
2014-09,2,59,18.625,-83.125,2,0,2
2014-09,3,45,18.875,-86.625,0,3,3
2014-09,3,46,18.875,-86.375,0,1,1
2014-09,3,51,18.875,-85.125,2,0,2
2014-09,3,52,18.875,-84.875,2,0,2
2014-09,3,53,18.875,-84.625,2,0,2
2014-09,4,46,19.125,-86.375,0,2,2
2014-09,4,47,19.125,-86.125,0,3,3
2014-09,4,48,19.125,-85.875,0,2,2
2014-09,4,49,19.125,-85.625,2,0,2
2014-09,4,50,19.125,-85.375,2,0,2
2014-09,4,51,19.125,-85.125,1,0,1
2014-09,5,48,19.375,-85.875,0,1,1
2014-09,5,49,19.375,-85.625,0,3,3
2014-09,5,50,19.375,-85.375,0,1,1
2014-09,5,61,19.375,-82.625,4,0,4
2014-09,8,12,20.125,-94.875,0,8,8
2014-09,9,12,20.375,-94.875,0,3,3
2014-09,9,69,20.375,-80.625,2,0,2
2014-09,9,70,20.375,-80.375,6,0,6
2014-09,10,12,20.625,-94.875,0,12,12
2014-09,10,13,20.625,-94.625,0,7,7
2014-09,10,63,20.625,-82.125,1,0,1
2014-09,10,64,20.625,-81.875,1,0,1
2014-09,10,65,20.625,-81.625,2,0,2
2014-09,10,69,20.625,-80.625,2,0,2
2014-09,10,70,20.625,-80.375,3,0,3
2014-09,11,6,20.875,-96.375,1,0,1
2014-09,11,66,20.875,-81.375,2,0,2
2014-09,11,67,20.875,-81.125,1,0,1
2014-09,11,68,20.875,-80.875,3,0,3
2014-09,11,69,20.875,-80.625,3,0,3
2014-09,12,6,21.125,-96.375,23,0,23
2014-09,14,19,21.625,-93.125,3,0,3
2014-09,15,18,21.875,-93.375,4,0,4
2014-09,15,19,21.875,-93.125,1,0,1
2014-09,16,17,22.125,-93.625,1,0,1
2014-09,16,18,22.125,-93.375,5,0,5
2014-09,17,16,22.375,-93.875,1,0,1
2014-09,17,17,22.375,-93.625,14,0,14
2014-09,19,41,22.875,-87.625,7,0,7
2014-09,19,42,22.875,-87.375,1,0,1
2014-09,20,42,23.125,-87.375,3,0,3
2014-09,21,8,23.375,-95.875,0,5,5
2014-09,21,41,23.375,-87.625,1,0,1
2014-09,21,47,23.375,-86.125,0,1,1
2014-09,21,48,23.375,-85.875,0,3,3
2014-09,21,49,23.375,-85.625,0,6,6
2014-09,22,9,23.625,-95.625,0,1,1
2014-09,22,41,23.625,-87.625,2,0,2
2014-09,22,47,23.625,-86.125,0,2,2
2014-09,22,49,23.625,-85.625,0,4,4
2014-09,22,50,23.625,-85.375,0,4,4
2014-09,23,8,23.875,-95.875,0,10,10
2014-09,23,9,23.875,-95.625,0,8,8
2014-09,23,46,23.875,-86.375,0,1,1
2014-09,24,9,24.125,-95.625,0,6,6
2014-09,24,42,24.125,-87.375,1,0,1
2014-09,25,42,24.375,-87.375,3,0,3
2014-09,26,42,24.625,-87.375,1,0,1
2014-09,27,23,24.875,-92.125,2,0,2
2014-09,27,24,24.875,-91.875,4,0,4
2014-09,28,24,25.125,-91.875,2,0,2
2014-09,28,25,25.125,-91.625,4,0,4
2014-09,28,26,25.125,-91.375,4,0,4
2014-09,28,27,25.125,-91.125,2,0,2
2014-09,29,26,25.375,-91.375,1,0,1
2014-09,29,27,25.375,-91.125,4,0,4
2014-09,29,28,25.375,-90.875,1,0,1
2014-09,33,9,26.375,-95.625,6,0,6
2014-09,33,10,26.375,-95.375,6,0,6
2014-09,33,11,26.375,-95.125,3,0,3
2014-09,34,10,26.625,-95.375,9,0,9
2014-09,34,17,26.625,-93.625,0,2,2
2014-09,34,18,26.625,-93.375,0,14,14
2014-09,34,19,26.625,-93.125,0,7,7
2014-09,34,20,26.625,-92.875,0,7,7
2014-09,35,38,26.875,-88.375,0,6,6
2014-09,35,39,26.875,-88.125,0,10,10
2014-09,35,40,26.875,-87.875,0,14,14
2014-09,41,43,28.375,-87.125,1,0,1
2014-09,42,42,28.625,-87.375,1,0,1
2014-09,42,43,28.625,-87.125,3,0,3
2014-09,43,39,28.875,-88.125,1,0,1
2014-09,43,40,28.875,-87.875,1,0,1
2014-09,43,41,28.875,-87.625,1,0,1
2014-09,43,42,28.875,-87.375,1,0,1
2014-09,44,39,29.125,-88.125,19,0,19
2014-09,44,40,29.125,-87.875,2,0,2
2014-10,2,53,18.625,-84.625,0,2,2
2014-10,2,54,18.625,-84.375,0,3,3
2014-10,2,55,18.625,-84.125,0,1,1
2014-10,2,56,18.625,-83.875,0,3,3
2014-10,2,57,18.625,-83.625,0,3,3
2014-10,3,51,18.875,-85.125,0,2,2
2014-10,3,52,18.875,-84.875,0,1,1
2014-10,3,53,18.875,-84.625,0,1,1
2014-10,3,57,18.875,-83.625,0,2,2
2014-10,3,58,18.875,-83.375,0,1,1
2014-10,4,50,19.125,-85.375,0,1,1
2014-10,4,58,19.125,-83.375,0,1,1
2014-10,5,48,19.375,-85.875,1,0,1
2014-10,5,49,19.375,-85.625,2,0,2
2014-10,5,57,19.375,-83.625,0,1,1
2014-10,5,59,19.375,-83.125,1,0,1
2014-10,5,60,19.375,-82.875,4,0,4
2014-10,5,61,19.375,-82.625,2,0,2
2014-10,6,17,19.625,-93.625,1,0,1
2014-10,6,18,19.625,-93.375,2,0,2
2014-10,6,19,19.625,-93.125,1,0,1
2014-10,6,47,19.625,-86.125,6,0,6
2014-10,6,48,19.625,-85.875,4,0,4
2014-10,6,62,19.625,-82.375,2,0,2
2014-10,7,17,19.875,-93.625,1,0,1
2014-10,7,20,19.875,-92.875,1,0,1
2014-10,7,47,19.875,-86.125,6,0,6
2014-10,7,63,19.875,-82.125,3,0,3
2014-10,7,64,19.875,-81.875,3,0,3
2014-10,8,13,20.125,-94.625,0,7,7
2014-10,8,14,20.125,-94.375,0,13,13
2014-10,8,15,20.125,-94.125,0,1,1
2014-10,8,21,20.125,-92.625,3,0,3
2014-10,8,22,20.125,-92.375,1,0,1
2014-10,8,23,20.125,-92.125,1,0,1
2014-10,8,24,20.125,-91.875,2,0,2
2014-10,8,47,20.125,-86.125,1,0,1
2014-10,8,65,20.125,-81.625,5,0,5
2014-10,8,67,20.125,-81.125,2,0,2
2014-10,8,68,20.125,-80.875,1,0,1
2014-10,9,65,20.375,-81.625,2,0,2
2014-10,9,66,20.375,-81.375,5,0,5
2014-10,9,68,20.375,-80.875,1,0,1
2014-10,10,48,20.625,-85.875,1,0,1
2014-10,11,48,20.875,-85.875,4,0,4
2014-10,11,49,20.875,-85.625,1,0,1
2014-10,12,48,21.125,-85.875,3,0,3
2014-10,12,49,21.125,-85.625,2,0,2
2014-10,15,13,21.875,-94.625,1,0,1
2014-10,15,14,21.875,-94.375,5,0,5
2014-10,16,14,22.125,-94.375,3,0,3
2014-10,16,15,22.125,-94.125,6,0,6
2014-10,16,16,22.125,-93.875,4,0,4
2014-10,17,16,22.375,-93.875,5,0,5
2014-10,18,7,22.625,-96.125,0,10,10
2014-10,18,27,22.625,-91.125,0,2,2
2014-10,18,28,22.625,-90.875,0,5,5
2014-10,19,7,22.875,-96.125,0,12,12
2014-10,19,27,22.875,-91.125,0,1,1
2014-10,19,28,22.875,-90.875,0,7,7
2014-10,20,7,23.125,-96.125,0,2,2
2014-10,20,8,23.125,-95.875,0,4,4
2014-10,20,28,23.125,-90.875,0,10,10
2014-10,21,8,23.375,-95.875,0,3,3
2014-10,22,49,23.625,-85.625,0,2,2
2014-10,22,50,23.625,-85.375,0,5,5
2014-10,23,47,23.875,-86.125,0,1,1
2014-10,23,56,23.875,-83.875,5,0,5
2014-10,24,47,24.125,-86.125,0,1,1
2014-10,24,56,24.125,-83.875,3,0,3
2014-10,25,48,24.375,-85.875,0,1,1
2014-10,25,49,24.375,-85.625,0,1,1
2014-10,26,11,24.625,-95.125,6,0,6
2014-10,26,21,24.625,-92.625,2,0,2
2014-10,26,22,24.625,-92.375,2,0,2
2014-10,26,48,24.625,-85.875,0,2,2
2014-10,26,56,24.625,-83.875,3,0,3
2014-10,27,11,24.875,-95.125,9,0,9
2014-10,27,12,24.875,-94.875,5,0,5
2014-10,27,20,24.875,-92.875,2,0,2
2014-10,27,22,24.875,-92.375,3,0,3
2014-10,27,49,24.875,-85.625,0,3,3
2014-10,27,56,24.875,-83.875,3,0,3
2014-10,28,12,25.125,-94.875,5,0,5
2014-10,28,37,25.125,-88.625,1,0,1
2014-10,28,38,25.125,-88.375,4,0,4
2014-10,28,40,25.125,-87.875,2,0,2
2014-10,28,47,25.125,-86.125,0,2,2
2014-10,28,48,25.125,-85.875,0,8,8
2014-10,28,49,25.125,-85.625,0,1,1
2014-10,28,55,25.125,-84.125,1,0,1
2014-10,28,56,25.125,-83.875,7,0,7
2014-10,29,35,25.375,-89.125,1,0,1
2014-10,29,36,25.375,-88.875,3,0,3
2014-10,29,37,25.375,-88.625,4,0,4
2014-10,29,47,25.375,-86.125,0,4,4
2014-10,29,56,25.375,-83.875,1,0,1
2014-10,30,31,25.625,-90.125,3,0,3
2014-10,30,32,25.625,-89.875,6,0,6
2014-10,30,33,25.625,-89.625,2,0,2
2014-10,30,34,25.625,-89.375,4,0,4
2014-10,30,35,25.625,-89.125,1,0,1
2014-10,32,48,26.125,-85.875,3,0,3
2014-10,33,48,26.375,-85.875,6,0,6
2014-10,34,10,26.625,-95.375,0,1,1
2014-10,34,11,26.625,-95.125,0,4,4
2014-10,34,12,26.625,-94.875,0,6,6
2014-10,34,13,26.625,-94.625,0,6,6
2014-10,34,14,26.625,-94.375,0,3,3
2014-10,34,15,26.625,-94.125,0,4,4
2014-10,34,16,26.625,-93.875,0,4,4
2014-10,34,17,26.625,-93.625,0,3,3
2014-10,34,47,26.625,-86.125,1,0,1
2014-10,34,48,26.625,-85.875,2,0,2
2014-10,35,41,26.875,-87.625,0,5,5
2014-10,35,47,26.875,-86.125,2,0,2
2014-10,36,35,27.125,-89.125,0,12,12
2014-10,36,36,27.125,-88.875,0,5,5
2014-10,36,37,27.125,-88.625,0,8,8
2014-10,37,30,27.375,-90.375,0,5,5
2014-10,37,35,27.375,-89.125,0,1,1
2014-10,39,44,27.875,-86.875,1,0,1
2014-10,39,46,27.875,-86.375,4,0,4
2014-10,39,47,27.875,-86.125,1,0,1
2014-10,40,45,28.125,-86.625,2,0,2
2014-10,40,46,28.125,-86.375,2,0,2
2014-10,41,40,28.375,-87.875,8,0,8
2014-10,41,41,28.375,-87.625,2,0,2
2014-10,41,43,28.375,-87.125,1,0,1
2014-10,41,44,28.375,-86.875,2,0,2
2014-10,42,40,28.625,-87.875,1,0,1
2014-10,42,41,28.625,-87.625,1,0,1
2014-11,0,49,18.125,-85.625,2,0,2
2014-11,1,49,18.375,-85.625,2,0,2
2014-11,1,50,18.375,-85.375,2,0,2
2014-11,1,51,18.375,-85.125,2,0,2
2014-11,1,52,18.375,-84.875,2,0,2
2014-11,1,53,18.375,-84.625,2,0,2
2014-11,2,54,18.625,-84.375,2,0,2
2014-11,2,55,18.625,-84.125,2,0,2
2014-11,2,56,18.625,-83.875,1,0,1
2014-11,3,56,18.875,-83.875,1,0,1
2014-11,3,57,18.875,-83.625,2,0,2
2014-11,4,46,19.125,-86.375,0,1,1
2014-11,4,47,19.125,-86.125,0,2,2
2014-11,4,48,19.125,-85.875,0,2,2
2014-11,4,49,19.125,-85.625,0,2,2
2014-11,4,50,19.125,-85.375,0,2,2
2014-11,4,58,19.125,-83.375,1,0,1
2014-11,4,59,19.125,-83.125,1,0,1
2014-11,5,45,19.375,-86.625,0,1,1
2014-11,5,46,19.375,-86.375,0,2,2
2014-11,6,45,19.625,-86.625,0,1,1
2014-11,6,46,19.625,-86.375,0,1,1
2014-11,6,47,19.625,-86.125,0,1,1
2014-11,7,15,19.875,-94.125,1,0,1
2014-11,7,16,19.875,-93.875,4,0,4
2014-11,7,17,19.875,-93.625,2,0,2
2014-11,7,18,19.875,-93.375,4,0,4
2014-11,7,68,19.875,-80.875,0,8,8
2014-11,7,69,19.875,-80.625,0,11,11
2014-11,7,70,19.875,-80.375,0,3,3
2014-11,7,71,19.875,-80.125,0,2,2
2014-11,8,12,20.125,-94.875,3,0,3
2014-11,8,13,20.125,-94.625,2,0,2
2014-11,8,17,20.125,-93.625,3,0,3
2014-11,8,18,20.125,-93.375,4,0,4
2014-11,8,68,20.125,-80.875,0,2,2
2014-11,9,12,20.375,-94.875,7,0,7
2014-11,9,59,20.375,-83.125,0,1,1
2014-11,12,48,21.125,-85.875,2,0,2
2014-11,13,24,21.375,-91.875,0,1,1
2014-11,13,48,21.375,-85.875,4,0,4
2014-11,14,24,21.625,-91.875,0,4,4
2014-11,14,47,21.625,-86.125,2,0,2
2014-11,14,48,21.625,-85.875,1,0,1
2014-11,15,23,21.875,-92.125,0,2,2
2014-11,15,24,21.875,-91.875,0,1,1
2014-11,15,25,21.875,-91.625,0,3,3
2014-11,15,46,21.875,-86.375,3,0,3
2014-11,16,23,22.125,-92.125,0,5,5
2014-11,16,24,22.125,-91.875,0,2,2
2014-11,16,25,22.125,-91.625,0,1,1
2014-11,16,45,22.125,-86.625,1,0,1
2014-11,16,46,22.125,-86.375,3,0,3
2014-11,17,44,22.375,-86.875,1,0,1
2014-11,17,45,22.375,-86.625,7,0,7
2014-11,18,10,22.625,-95.375,0,4,4
2014-11,18,11,22.625,-95.125,0,5,5
2014-11,18,28,22.625,-90.875,0,2,2
2014-11,18,43,22.625,-87.125,1,0,1
2014-11,18,44,22.625,-86.875,2,0,2
2014-11,19,7,22.875,-96.125,0,5,5
2014-11,19,8,22.875,-95.875,0,3,3
2014-11,19,9,22.875,-95.625,0,8,8
2014-11,19,10,22.875,-95.375,0,3,3
2014-11,19,28,22.875,-90.875,0,4,4
2014-11,19,29,22.875,-90.625,0,1,1
2014-11,19,42,22.875,-87.375,1,0,1
2014-11,19,43,22.875,-87.125,1,0,1
2014-11,20,28,23.125,-90.875,0,1,1
2014-11,20,29,23.125,-90.625,0,1,1
2014-11,20,41,23.125,-87.625,1,0,1
2014-11,22,57,23.625,-83.625,6,0,6
2014-11,22,58,23.625,-83.375,5,0,5
2014-11,22,59,23.625,-83.125,2,0,2
2014-11,23,54,23.875,-84.375,0,2,2
2014-11,23,57,23.875,-83.625,2,0,2
2014-11,24,11,24.125,-95.125,11,0,11
2014-11,24,12,24.125,-94.875,10,0,10
2014-11,25,11,24.375,-95.125,5,0,5
2014-11,25,46,24.375,-86.375,0,1,1
2014-11,25,47,24.375,-86.125,0,1,1
2014-11,25,48,24.375,-85.875,0,1,1
2014-11,25,49,24.375,-85.625,0,8,8
2014-11,25,50,24.375,-85.375,0,13,13
2014-11,26,11,24.625,-95.125,4,0,4
2014-11,26,44,24.625,-86.875,0,1,1
2014-11,26,45,24.625,-86.625,0,1,1
2014-11,27,44,24.875,-86.875,0,1,1
2014-11,28,44,25.125,-86.875,0,3,3
2014-11,30,29,25.625,-90.625,6,0,6
2014-11,30,30,25.625,-90.375,14,0,14
2014-11,30,31,25.625,-90.125,3,0,3
2014-11,30,51,25.625,-85.125,1,0,1
2014-11,31,29,25.875,-90.625,6,0,6
2014-11,31,50,25.875,-85.375,2,0,2
2014-11,31,51,25.875,-85.125,5,0,5
2014-11,32,8,26.125,-95.875,0,11,11
2014-11,32,48,26.125,-85.875,2,0,2
2014-11,32,49,26.125,-85.625,13,0,13
2014-11,32,50,26.125,-85.375,7,0,7
2014-11,33,8,26.375,-95.875,0,4,4
2014-11,33,9,26.375,-95.625,0,10,10
2014-11,34,10,26.625,-95.375,0,5,5
2014-11,35,40,26.875,-87.875,0,2,2
2014-11,35,41,26.875,-87.625,0,24,24
2014-11,36,40,27.125,-87.875,0,3,3
2014-11,37,22,27.375,-92.375,0,1,1
2014-11,37,29,27.375,-90.625,0,1,1
2014-11,37,30,27.375,-90.375,0,4,4
2014-11,37,40,27.375,-87.875,0,1,1
2014-11,38,22,27.625,-92.375,0,3,3
2014-11,38,23,27.625,-92.125,0,7,7
2014-11,38,24,27.625,-91.875,0,2,2
2014-11,38,25,27.625,-91.625,0,1,1
2014-11,38,26,27.625,-91.375,0,3,3
2014-11,38,27,27.625,-91.125,0,4,4
2014-11,38,28,27.625,-90.875,0,1,1
2014-11,38,29,27.625,-90.625,0,3,3
2014-11,40,41,28.125,-87.625,12,0,12
2014-11,41,40,28.375,-87.875,2,0,2
2014-11,41,41,28.375,-87.625,6,0,6
2014-11,41,42,28.375,-87.375,8,0,8
2014-11,42,40,28.625,-87.875,1,0,1
2014-11,42,41,28.625,-87.625,1,0,1
2014-12,0,67,18.125,-81.125,7,0,7
2014-12,0,68,18.125,-80.875,4,0,4
2014-12,1,67,18.375,-81.125,1,0,1
2014-12,1,68,18.375,-80.875,3,0,3
2014-12,2,50,18.625,-85.375,2,0,2
2014-12,2,51,18.625,-85.125,3,0,3
2014-12,2,52,18.625,-84.875,3,0,3
2014-12,2,53,18.625,-84.625,2,0,2
2014-12,2,65,18.625,-81.625,1,0,1
2014-12,2,66,18.625,-81.375,3,0,3
2014-12,2,67,18.625,-81.125,4,0,4
2014-12,2,68,18.625,-80.875,1,0,1
2014-12,3,47,18.875,-86.125,5,0,5
2014-12,3,48,18.875,-85.875,4,0,4
2014-12,3,49,18.875,-85.625,4,0,4
2014-12,3,50,18.875,-85.375,3,0,3
2014-12,7,70,19.875,-80.375,0,2,2
2014-12,7,71,19.875,-80.125,0,7,7
2014-12,8,13,20.125,-94.625,6,0,6
2014-12,8,67,20.125,-81.125,0,3,3
2014-12,8,68,20.125,-80.875,0,3,3
2014-12,9,12,20.375,-94.875,4,0,4
2014-12,9,13,20.375,-94.625,3,0,3
2014-12,9,57,20.375,-83.625,0,1,1
2014-12,9,58,20.375,-83.375,0,5,5
2014-12,9,59,20.375,-83.125,0,5,5
2014-12,9,60,20.375,-82.875,0,1,1
2014-12,10,12,20.625,-94.875,5,0,5
2014-12,10,55,20.625,-84.125,0,5,5
2014-12,10,56,20.625,-83.875,0,3,3
2014-12,10,57,20.625,-83.625,0,1,1
2014-12,11,12,20.875,-94.875,4,0,4
2014-12,12,11,21.125,-95.125,5,0,5
2014-12,13,11,21.375,-95.125,4,0,4
2014-12,15,17,21.875,-93.625,0,15,15
2014-12,16,23,22.125,-92.125,0,1,1
2014-12,16,24,22.125,-91.875,0,2,2
2014-12,17,11,22.375,-95.125,0,1,1
2014-12,17,22,22.375,-92.375,0,1,1
2014-12,17,23,22.375,-92.125,0,2,2
2014-12,18,11,22.625,-95.125,0,5,5
2014-12,18,19,22.625,-93.125,0,1,1
2014-12,18,20,22.625,-92.875,0,2,2
2014-12,19,17,22.875,-93.625,0,1,1
2014-12,19,18,22.875,-93.375,0,3,3
2014-12,19,19,22.875,-93.125,0,3,3
2014-12,20,39,23.125,-88.125,4,0,4
2014-12,20,40,23.125,-87.875,2,0,2
2014-12,21,39,23.375,-88.125,6,0,6
2014-12,23,54,23.875,-84.375,0,1,1
2014-12,23,55,23.875,-84.125,0,3,3
2014-12,23,56,23.875,-83.875,0,1,1
2014-12,23,59,23.875,-83.125,0,2,2
2014-12,23,60,23.875,-82.875,0,9,9
2014-12,24,11,24.125,-95.125,6,0,6
2014-12,24,57,24.125,-83.625,0,3,3
2014-12,24,58,24.125,-83.375,0,5,5
2014-12,24,60,24.125,-82.875,0,1,1
2014-12,25,11,24.375,-95.125,7,0,7
2014-12,25,58,24.375,-83.375,0,1,1
2014-12,25,60,24.375,-82.875,0,3,3
2014-12,26,11,24.625,-95.125,15,0,15
2014-12,26,59,24.625,-83.125,0,1,1
2014-12,27,11,24.875,-95.125,1,0,1
2014-12,27,12,24.875,-94.875,2,0,2
2014-12,27,43,24.875,-87.125,0,1,1
2014-12,28,42,25.125,-87.375,0,4,4
2014-12,28,43,25.125,-87.125,0,4,4
2014-12,28,44,25.125,-86.875,0,5,5
2014-12,29,41,25.375,-87.625,0,6,6
2014-12,29,49,25.375,-85.625,3,0,3
2014-12,29,50,25.375,-85.375,7,0,7
2014-12,29,51,25.375,-85.125,4,0,4
2014-12,30,40,25.625,-87.875,0,4,4
2014-12,30,51,25.625,-85.125,8,0,8
2014-12,31,28,25.875,-90.875,16,0,16
2014-12,31,29,25.875,-90.625,10,0,10
2014-12,31,39,25.875,-88.125,0,4,4
2014-12,31,40,25.875,-87.875,0,1,1
2014-12,31,51,25.875,-85.125,7,0,7
2014-12,32,28,26.125,-90.875,2,0,2
2014-12,32,29,26.125,-90.625,3,0,3
2014-12,32,38,26.125,-88.375,0,1,1
2014-12,32,39,26.125,-88.125,0,1,1
2014-12,32,51,26.125,-85.125,2,0,2
2014-12,33,8,26.375,-95.875,0,12,12
2014-12,33,56,26.375,-83.875,0,2,2
2014-12,34,8,26.625,-95.875,0,3,3
2014-12,34,9,26.625,-95.625,0,2,2
2014-12,35,8,26.875,-95.875,0,10,10
2014-12,35,20,26.875,-92.875,0,4,4
2014-12,36,22,27.125,-92.375,0,2,2
2014-12,37,20,27.375,-92.875,0,13,13
2014-12,37,21,27.375,-92.625,0,3,3
2014-12,37,22,27.375,-92.375,0,8,8
2014-12,37,40,27.375,-87.875,0,3,3
2014-12,37,45,27.375,-86.625,0,5,5
2014-12,38,46,27.625,-86.375,0,5,5
2014-12,38,47,27.625,-86.125,0,12,12
2014-12,39,40,27.875,-87.875,5,0,5
2014-12,40,40,28.125,-87.875,3,0,3
2014-12,40,41,28.125,-87.625,4,0,4
2014-12,41,41,28.375,-87.625,6,0,6
2014-12,41,42,28.375,-87.375,1,0,1
2014-12,42,41,28.625,-87.625,7,0,7
2014-12,42,42,28.625,-87.375,2,0,2
2014-12,43,41,28.875,-87.625,2,0,2
2015-01,0,45,18.125,-86.625,1,0,1
2015-01,0,48,18.125,-85.875,5,0,5
2015-01,0,58,18.125,-83.375,3,0,3
2015-01,0,59,18.125,-83.125,2,0,2
2015-01,1,45,18.375,-86.625,1,0,1
2015-01,1,46,18.375,-86.375,4,0,4
2015-01,1,47,18.375,-86.125,4,0,4
2015-01,1,48,18.375,-85.875,2,0,2
2015-01,1,58,18.375,-83.375,1,0,1
2015-01,2,63,18.625,-82.125,2,0,2
2015-01,2,64,18.625,-81.875,3,0,3
2015-01,2,65,18.625,-81.625,2,0,2
2015-01,3,46,18.875,-86.375,2,0,2
2015-01,4,18,19.125,-93.375,0,2,2
2015-01,4,46,19.125,-86.375,1,0,1
2015-01,4,62,19.125,-82.375,0,1,1
2015-01,5,18,19.375,-93.375,0,1,1
2015-01,5,46,19.375,-86.375,2,0,2
2015-01,5,62,19.375,-82.375,0,6,6
2015-01,5,69,19.375,-80.625,3,0,3
2015-01,5,70,19.375,-80.375,5,0,5
2015-01,6,46,19.625,-86.375,2,0,2
2015-01,6,61,19.625,-82.625,0,1,1
2015-01,6,62,19.625,-82.375,0,1,1
2015-01,6,71,19.625,-80.125,3,0,3
2015-01,7,45,19.875,-86.625,1,0,1
2015-01,7,46,19.875,-86.375,6,0,6
2015-01,7,61,19.875,-82.625,0,2,2
2015-01,8,45,20.125,-86.625,2,0,2
2015-01,8,46,20.125,-86.375,1,0,1
2015-01,8,59,20.125,-83.125,0,1,1
2015-01,8,60,20.125,-82.875,0,7,7
2015-01,8,61,20.125,-82.625,0,2,2
2015-01,8,62,20.125,-82.375,0,8,8
2015-01,9,46,20.375,-86.375,1,0,1
2015-01,9,59,20.375,-83.125,0,1,1
2015-01,9,61,20.375,-82.625,0,1,1
2015-01,13,10,21.375,-95.375,1,0,1
2015-01,13,11,21.375,-95.125,1,0,1
2015-01,14,10,21.625,-95.375,5,0,5
2015-01,15,9,21.875,-95.625,2,0,2
2015-01,15,10,21.875,-95.375,3,0,3
2015-01,15,17,21.875,-93.625,0,2,2
2015-01,15,21,21.875,-92.625,0,1,1
2015-01,16,9,22.125,-95.625,3,0,3
2015-01,16,16,22.125,-93.875,0,2,2
2015-01,16,17,22.125,-93.625,0,4,4
2015-01,16,20,22.125,-92.875,0,1,1
2015-01,16,21,22.125,-92.625,0,1,1
2015-01,17,9,22.375,-95.625,4,0,4
2015-01,17,16,22.375,-93.875,0,11,11
2015-01,17,17,22.375,-93.625,0,1,1
2015-01,17,18,22.375,-93.375,0,6,6
2015-01,17,20,22.375,-92.875,0,2,2
2015-01,18,8,22.625,-95.875,4,0,4
2015-01,18,9,22.625,-95.625,2,0,2
2015-01,19,8,22.875,-95.875,3,0,3
2015-01,19,30,22.875,-90.375,0,1,1
2015-01,20,30,23.125,-90.375,0,1,1
2015-01,20,48,23.125,-85.875,0,12,12
2015-01,21,46,23.375,-86.375,0,1,1
2015-01,21,47,23.375,-86.125,0,3,3
2015-01,21,48,23.375,-85.875,0,5,5
2015-01,22,48,23.625,-85.875,0,1,1
2015-01,23,9,23.875,-95.625,3,0,3
2015-01,23,60,23.875,-82.875,0,1,1
2015-01,23,61,23.875,-82.625,0,11,11
2015-01,23,62,23.875,-82.375,0,4,4
2015-01,23,63,23.875,-82.125,0,4,4
2015-01,23,64,23.875,-81.875,0,3,3
2015-01,23,65,23.875,-81.625,0,4,4
2015-01,24,66,24.125,-81.375,0,1,1
2015-01,27,12,24.875,-94.875,7,0,7
2015-01,27,13,24.875,-94.625,3,0,3
2015-01,27,14,24.875,-94.375,3,0,3
2015-01,27,15,24.875,-94.125,2,0,2
2015-01,27,16,24.875,-93.875,6,0,6
2015-01,27,20,24.875,-92.875,1,0,1
2015-01,28,21,25.125,-92.625,9,0,9
2015-01,29,45,25.375,-86.625,5,0,5
2015-01,29,46,25.375,-86.375,1,0,1
2015-01,29,47,25.375,-86.125,1,0,1
2015-01,29,48,25.375,-85.875,5,0,5
2015-01,29,49,25.375,-85.625,3,0,3
2015-01,30,46,25.625,-86.375,10,0,10
2015-01,30,47,25.625,-86.125,4,0,4
2015-01,30,48,25.625,-85.875,2,0,2
2015-01,31,28,25.875,-90.875,3,0,3
2015-01,32,24,26.125,-91.875,2,0,2
2015-01,32,28,26.125,-90.875,2,0,2
2015-01,32,38,26.125,-88.375,0,1,1
2015-01,33,16,26.375,-93.875,0,1,1
2015-01,33,17,26.375,-93.625,0,4,4
2015-01,33,28,26.375,-90.875,3,0,3
2015-01,33,38,26.375,-88.375,0,6,6
2015-01,33,57,26.375,-83.625,0,1,1
2015-01,34,17,26.625,-93.625,0,5,5
2015-01,34,18,26.625,-93.375,0,5,5
2015-01,34,27,26.625,-91.125,5,0,5
2015-01,34,38,26.625,-88.375,0,8,8
2015-01,34,56,26.625,-83.875,0,4,4
2015-01,34,57,26.625,-83.625,0,1,1
2015-01,34,58,26.625,-83.375,0,3,3
2015-01,35,18,26.875,-93.375,0,5,5
2015-01,35,19,26.875,-93.125,0,8,8
2015-01,35,20,26.875,-92.875,0,1,1
2015-01,35,27,26.875,-91.125,4,0,4
2015-01,35,36,26.875,-88.875,0,1,1
2015-01,35,37,26.875,-88.625,0,15,15
2015-01,35,56,26.875,-83.875,0,3,3
2015-01,35,57,26.875,-83.625,0,2,2
2015-01,35,58,26.875,-83.375,0,1,1
2015-01,36,58,27.125,-83.375,0,2,2
2015-01,37,57,27.375,-83.625,0,1,1
2015-01,37,58,27.375,-83.375,0,3,3
2015-01,38,47,27.625,-86.125,0,5,5
2015-01,38,48,27.625,-85.875,0,10,10
2015-01,41,44,28.375,-86.875,8,0,8
2015-01,41,45,28.375,-86.625,5,0,5
2015-01,42,41,28.625,-87.625,8,0,8
2015-01,42,42,28.625,-87.375,3,0,3
2015-01,42,43,28.625,-87.125,7,0,7
2015-02,0,48,18.125,-85.875,2,0,2
2015-02,0,49,18.125,-85.625,1,0,1
2015-02,0,54,18.125,-84.375,1,0,1
2015-02,0,55,18.125,-84.125,4,0,4
2015-02,0,56,18.125,-83.875,2,0,2
2015-02,0,57,18.125,-83.625,1,0,1
2015-02,0,67,18.125,-81.125,0,1,1
2015-02,0,68,18.125,-80.875,0,3,3
2015-02,1,45,18.375,-86.625,4,0,4
2015-02,1,56,18.375,-83.875,1,0,1
2015-02,1,57,18.375,-83.625,2,0,2
2015-02,1,67,18.375,-81.125,0,7,7
2015-02,2,67,18.625,-81.125,0,2,2
2015-02,3,56,18.875,-83.875,0,1,1
2015-02,3,57,18.875,-83.625,0,1,1
2015-02,4,57,19.125,-83.625,0,2,2
2015-02,4,58,19.125,-83.375,0,3,3
2015-02,4,69,19.125,-80.625,1,0,1
2015-02,5,17,19.375,-93.625,0,4,4
2015-02,5,18,19.375,-93.375,0,1,1
2015-02,5,58,19.375,-83.375,0,2,2
2015-02,5,60,19.375,-82.875,0,1,1
2015-02,5,61,19.375,-82.625,0,3,3
2015-02,5,62,19.375,-82.375,0,2,2
2015-02,5,68,19.375,-80.875,2,0,2
2015-02,5,69,19.375,-80.625,5,0,5
2015-02,6,17,19.625,-93.625,0,3,3
2015-02,6,59,19.625,-83.125,0,1,1
2015-02,6,61,19.625,-82.625,0,6,6
2015-02,6,68,19.625,-80.875,5,0,5
2015-02,7,59,19.875,-83.125,0,3,3
2015-02,7,64,19.875,-81.875,2,0,2
2015-02,7,65,19.875,-81.625,1,0,1
2015-02,7,66,19.875,-81.375,3,0,3
2015-02,7,67,19.875,-81.125,3,0,3
2015-02,7,68,19.875,-80.875,6,0,6
2015-02,8,16,20.125,-93.875,0,7,7
2015-02,8,17,20.125,-93.625,0,10,10
2015-02,8,18,20.125,-93.375,0,3,3
2015-02,8,58,20.125,-83.375,0,2,2
2015-02,17,17,22.375,-93.625,0,3,3
2015-02,18,15,22.625,-94.125,0,9,9
2015-02,18,16,22.625,-93.875,0,8,8
2015-02,18,17,22.625,-93.625,0,5,5
2015-02,18,42,22.625,-87.375,5,0,5
2015-02,18,43,22.625,-87.125,8,0,8
2015-02,19,15,22.875,-94.125,0,2,2
2015-02,19,16,22.875,-93.875,0,1,1
2015-02,20,30,23.125,-90.375,0,2,2
2015-02,21,28,23.375,-90.875,0,1,1
2015-02,21,31,23.375,-90.125,0,4,4
2015-02,22,28,23.625,-90.875,0,6,6
2015-02,22,29,23.625,-90.625,0,3,3
2015-02,22,30,23.625,-90.375,0,5,5
2015-02,22,31,23.625,-90.125,0,1,1
2015-02,22,47,23.625,-86.125,0,1,1
2015-02,22,48,23.625,-85.875,0,5,5
2015-02,22,55,23.625,-84.125,1,0,1
2015-02,22,56,23.625,-83.875,2,0,2
2015-02,23,8,23.875,-95.875,1,0,1
2015-02,23,9,23.875,-95.625,1,0,1
2015-02,23,28,23.875,-90.875,0,4,4
2015-02,23,46,23.875,-86.375,0,3,3
2015-02,23,47,23.875,-86.125,0,5,5
2015-02,23,55,23.875,-84.125,5,0,5
2015-02,24,8,24.125,-95.875,23,0,23
2015-02,24,9,24.125,-95.625,1,0,1
2015-02,24,45,24.125,-86.625,0,10,10
2015-02,24,46,24.125,-86.375,0,2,2
2015-02,24,55,24.125,-84.125,7,0,7
2015-02,25,8,24.375,-95.875,2,0,2
2015-02,25,46,24.375,-86.375,0,2,2
2015-02,25,55,24.375,-84.125,1,0,1
2015-02,26,35,24.625,-89.125,2,0,2
2015-02,26,36,24.625,-88.875,4,0,4
2015-02,26,37,24.625,-88.625,3,0,3
2015-02,26,38,24.625,-88.375,2,0,2
2015-02,27,33,24.875,-89.625,1,0,1
2015-02,27,34,24.875,-89.375,4,0,4
2015-02,27,39,24.875,-88.125,5,0,5
2015-02,27,40,24.875,-87.875,2,0,2
2015-02,28,20,25.125,-92.875,6,0,6
2015-02,28,21,25.125,-92.625,19,0,19
2015-02,29,21,25.375,-92.625,3,0,3
2015-02,29,45,25.375,-86.625,5,0,5
2015-02,31,13,25.875,-94.625,0,9,9
2015-02,31,14,25.875,-94.375,0,5,5
2015-02,32,14,26.125,-94.375,0,2,2
2015-02,32,15,26.125,-94.125,0,8,8
2015-02,32,16,26.125,-93.875,0,2,2
2015-02,33,16,26.375,-93.875,0,2,2
2015-02,35,26,26.875,-91.375,0,1,1
2015-02,35,34,26.875,-89.375,0,3,3
2015-02,35,35,26.875,-89.125,0,17,17
2015-02,35,36,26.875,-88.875,0,8,8
2015-02,35,45,26.875,-86.625,3,0,3
2015-02,36,44,27.125,-86.875,8,0,8
2015-02,37,43,27.375,-87.125,2,0,2
2015-02,37,44,27.375,-86.875,1,0,1
2015-02,38,43,27.625,-87.125,2,0,2
2015-02,39,43,27.875,-87.125,2,0,2
2015-02,41,44,28.375,-86.875,2,0,2
2015-02,42,36,28.625,-88.875,1,0,1
2015-02,43,36,28.875,-88.875,5,0,5
2015-02,43,37,28.875,-88.625,1,0,1
2015-03,0,47,18.125,-86.125,1,0,1
2015-03,1,46,18.375,-86.375,3,0,3
2015-03,1,52,18.375,-84.875,0,1,1
2015-03,1,67,18.375,-81.125,0,3,3
2015-03,2,46,18.625,-86.375,2,0,2
2015-03,2,51,18.625,-85.125,0,3,3
2015-03,2,52,18.625,-84.875,0,8,8
2015-03,2,53,18.625,-84.625,0,6,6
2015-03,2,54,18.625,-84.375,0,4,4
2015-03,2,55,18.625,-84.125,0,4,4
2015-03,2,65,18.625,-81.625,0,1,1
2015-03,2,66,18.625,-81.375,0,1,1
2015-03,2,67,18.625,-81.125,0,2,2
2015-03,3,46,18.875,-86.375,4,0,4
2015-03,3,51,18.875,-85.125,0,2,2
2015-03,3,56,18.875,-83.875,0,3,3
2015-03,3,65,18.875,-81.625,0,3,3
2015-03,3,66,18.875,-81.375,0,6,6
2015-03,3,67,18.875,-81.125,0,3,3
2015-03,4,45,19.125,-86.625,1,0,1
2015-03,4,46,19.125,-86.375,1,0,1
2015-03,4,59,19.125,-83.125,1,0,1
2015-03,4,66,19.125,-81.375,0,3,3
2015-03,5,45,19.375,-86.625,2,0,2
2015-03,5,46,19.375,-86.375,2,0,2
2015-03,5,61,19.375,-82.625,4,0,4
2015-03,6,45,19.625,-86.625,1,0,1
2015-03,6,46,19.625,-86.375,3,0,3
2015-03,6,62,19.625,-82.375,4,0,4
2015-03,6,63,19.625,-82.125,3,0,3
2015-03,7,45,19.875,-86.625,4,0,4
2015-03,7,46,19.875,-86.375,1,0,1
2015-03,8,16,20.125,-93.875,0,1,1
2015-03,9,16,20.375,-93.875,0,4,4
2015-03,9,17,20.375,-93.625,0,1,1
2015-03,10,16,20.625,-93.875,0,3,3
2015-03,12,57,21.125,-83.625,2,0,2
2015-03,12,58,21.125,-83.375,5,0,5
2015-03,16,11,22.125,-95.125,0,6,6
2015-03,16,12,22.125,-94.875,0,6,6
2015-03,16,13,22.125,-94.625,0,2,2
2015-03,16,14,22.125,-94.375,0,1,1
2015-03,17,12,22.375,-94.875,0,3,3
2015-03,17,13,22.375,-94.625,0,4,4
2015-03,18,42,22.625,-87.375,3,0,3
2015-03,19,13,22.875,-94.625,0,4,4
2015-03,19,14,22.875,-94.375,0,5,5
2015-03,19,41,22.875,-87.625,3,0,3
2015-03,19,42,22.875,-87.375,2,0,2
2015-03,20,41,23.125,-87.625,8,0,8
2015-03,20,42,23.125,-87.375,9,0,9
2015-03,22,25,23.625,-91.625,0,2,2
2015-03,22,26,23.625,-91.375,0,1,1
2015-03,22,56,23.625,-83.875,17,0,17
2015-03,22,57,23.625,-83.625,7,0,7
2015-03,22,58,23.625,-83.375,7,0,7
2015-03,23,26,23.875,-91.375,0,4,4
2015-03,23,27,23.875,-91.125,0,8,8
2015-03,25,6,24.375,-96.375,2,0,2
2015-03,25,7,24.375,-96.125,20,0,20
2015-03,25,8,24.375,-95.875,9,0,9
2015-03,25,46,24.375,-86.375,0,2,2
2015-03,25,47,24.375,-86.125,0,7,7
2015-03,25,48,24.375,-85.875,0,16,16
2015-03,26,40,24.625,-87.875,1,0,1
2015-03,26,41,24.625,-87.625,2,0,2
2015-03,26,45,24.625,-86.625,0,2,2
2015-03,26,47,24.625,-86.125,0,1,1
2015-03,26,48,24.625,-85.875,0,1,1
2015-03,27,30,24.875,-90.375,3,0,3
2015-03,27,32,24.875,-89.875,3,0,3
2015-03,27,33,24.875,-89.625,2,0,2
2015-03,27,36,24.875,-88.875,3,0,3
2015-03,27,37,24.875,-88.625,5,0,5
2015-03,28,18,25.125,-93.375,2,0,2
2015-03,28,19,25.125,-93.125,8,0,8
2015-03,28,20,25.125,-92.875,3,0,3
2015-03,28,28,25.125,-90.875,2,0,2
2015-03,28,30,25.125,-90.375,6,0,6
2015-03,28,31,25.125,-90.125,3,0,3
2015-03,28,32,25.125,-89.875,2,0,2
2015-03,29,17,25.375,-93.625,3,0,3
2015-03,29,18,25.375,-93.375,6,0,6
2015-03,30,12,25.625,-94.875,0,5,5
2015-03,30,13,25.625,-94.625,0,6,6
2015-03,30,16,25.625,-93.875,4,0,4
2015-03,30,17,25.625,-93.625,4,0,4
2015-03,31,49,25.875,-85.625,3,0,3
2015-03,31,50,25.875,-85.375,3,0,3
2015-03,32,47,26.125,-86.125,1,0,1
2015-03,32,48,26.125,-85.875,4,0,4
2015-03,32,49,26.125,-85.625,1,0,1
2015-03,33,45,26.375,-86.625,12,0,12
2015-03,33,46,26.375,-86.375,4,0,4
2015-03,33,47,26.375,-86.125,1,0,1
2015-03,34,34,26.625,-89.375,0,5,5
2015-03,34,35,26.625,-89.125,0,5,5
2015-03,34,36,26.625,-88.875,0,9,9
2015-03,35,22,26.875,-92.375,0,1,1
2015-03,35,23,26.875,-92.125,0,3,3
2015-03,35,24,26.875,-91.875,0,2,2
2015-03,35,25,26.875,-91.625,0,2,2
2015-03,35,26,26.875,-91.375,0,7,7
2015-03,35,27,26.875,-91.125,0,1,1
2015-03,35,34,26.875,-89.375,0,10,10
2015-03,35,36,26.875,-88.875,0,2,2
2015-03,35,45,26.875,-86.625,2,0,2
2015-03,36,20,27.125,-92.875,0,4,4
2015-03,36,21,27.125,-92.625,0,7,7
2015-03,36,22,27.125,-92.375,0,2,2
2015-03,36,41,27.125,-87.625,1,0,1
2015-03,37,40,27.375,-87.875,1,0,1
2015-03,37,41,27.375,-87.625,4,0,4
2015-03,37,47,27.375,-86.125,0,2,2
2015-03,38,39,27.625,-88.125,2,0,2
2015-03,38,40,27.625,-87.875,2,0,2
2015-03,38,48,27.625,-85.875,0,13,13
2015-03,39,38,27.875,-88.375,1,0,1
2015-03,39,39,27.875,-88.125,2,0,2
2015-03,40,38,28.125,-88.375,5,0,5
2015-03,41,35,28.375,-89.125,1,0,1
2015-03,41,36,28.375,-88.875,1,0,1
2015-03,41,37,28.375,-88.625,2,0,2
2015-03,42,34,28.625,-89.375,5,0,5
2015-03,43,36,28.875,-88.875,4,0,4
2015-04,0,58,18.125,-83.375,1,0,1
2015-04,0,59,18.125,-83.125,3,0,3
2015-04,0,60,18.125,-82.875,4,0,4
2015-04,0,61,18.125,-82.625,3,0,3
2015-04,0,62,18.125,-82.375,3,0,3
2015-04,0,71,18.125,-80.125,0,2,2
2015-04,1,56,18.375,-83.875,4,0,4
2015-04,1,57,18.375,-83.625,4,0,4
2015-04,1,58,18.375,-83.375,2,0,2
2015-04,1,70,18.375,-80.375,0,2,2
2015-04,2,45,18.625,-86.625,0,3,3
2015-04,2,46,18.625,-86.375,0,3,3
2015-04,2,47,18.625,-86.125,0,7,7
2015-04,2,63,18.625,-82.125,2,0,2
2015-04,2,64,18.625,-81.875,2,0,2
2015-04,2,69,18.625,-80.625,0,4,4
2015-04,3,48,18.875,-85.875,0,5,5
2015-04,3,49,18.875,-85.625,0,6,6
2015-04,3,50,18.875,-85.375,0,5,5
2015-04,3,51,18.875,-85.125,0,1,1
2015-04,3,66,18.875,-81.375,0,4,4
2015-04,3,67,18.875,-81.125,0,2,2
2015-04,3,68,18.875,-80.875,0,2,2
2015-04,4,65,19.125,-81.625,0,3,3
2015-04,4,66,19.125,-81.375,0,2,2
2015-04,4,67,19.125,-81.125,0,2,2
2015-04,5,64,19.375,-81.875,0,1,1
2015-04,11,55,20.875,-84.125,7,0,7
2015-04,12,55,21.125,-84.125,5,0,5
2015-04,12,56,21.125,-83.875,9,0,9
2015-04,12,57,21.125,-83.625,6,0,6
2015-04,16,11,22.125,-95.125,0,3,3
2015-04,16,12,22.125,-94.875,0,7,7
2015-04,17,10,22.375,-95.375,0,3,3
2015-04,17,11,22.375,-95.125,0,11,11
2015-04,17,12,22.375,-94.875,0,6,6
2015-04,22,59,23.625,-83.125,1,0,1
2015-04,24,6,24.125,-96.375,8,0,8
2015-04,24,49,24.125,-85.625,0,3,3
2015-04,24,50,24.125,-85.375,0,14,14
2015-04,25,6,24.375,-96.375,9,0,9
2015-04,25,7,24.375,-96.125,8,0,8
2015-04,25,33,24.375,-89.625,3,0,3
2015-04,25,34,24.375,-89.375,4,0,4
2015-04,25,36,24.375,-88.875,2,0,2
2015-04,25,49,24.375,-85.625,0,1,1
2015-04,27,34,24.875,-89.375,2,0,2
2015-04,27,35,24.875,-89.125,1,0,1
2015-04,27,36,24.875,-88.875,1,0,1
2015-04,28,33,25.125,-89.625,4,0,4
2015-04,28,34,25.125,-89.375,3,0,3
2015-04,28,35,25.125,-89.125,1,0,1
2015-04,29,9,25.375,-95.625,2,0,2
2015-04,29,10,25.375,-95.375,2,0,2
2015-04,30,15,25.625,-94.125,2,0,2
2015-04,30,16,25.625,-93.875,2,0,2
2015-04,31,14,25.875,-94.375,1,0,1
2015-04,31,15,25.875,-94.125,3,0,3
2015-04,31,43,25.875,-87.125,1,0,1
2015-04,31,44,25.875,-86.875,2,0,2
2015-04,31,50,25.875,-85.375,4,0,4
2015-04,32,13,26.125,-94.625,4,0,4
2015-04,32,14,26.125,-94.375,1,0,1
2015-04,32,44,26.125,-86.875,2,0,2
2015-04,32,45,26.125,-86.625,2,0,2
2015-04,32,46,26.125,-86.375,7,0,7
2015-04,32,47,26.125,-86.125,8,0,8
2015-04,32,48,26.125,-85.875,3,0,3
2015-04,33,12,26.375,-94.875,3,0,3
2015-04,33,13,26.375,-94.625,9,0,9
2015-04,33,34,26.375,-89.375,0,1,1
2015-04,34,18,26.625,-93.375,0,5,5
2015-04,34,19,26.625,-93.125,0,2,2
2015-04,34,34,26.625,-89.375,0,2,2
2015-04,34,35,26.625,-89.125,0,10,10
2015-04,34,36,26.625,-88.875,0,11,11
2015-04,35,19,26.875,-93.125,0,11,11
2015-04,35,20,26.875,-92.875,0,1,1
2015-04,35,34,26.875,-89.375,0,3,3
2015-04,35,35,26.875,-89.125,0,3,3
2015-04,36,19,27.125,-93.125,0,1,1
2015-04,36,20,27.125,-92.875,0,10,10
2015-04,36,41,27.125,-87.625,2,0,2
2015-04,37,40,27.375,-87.875,2,0,2
2015-04,38,25,27.625,-91.625,1,0,1
2015-04,38,26,27.625,-91.375,1,0,1
2015-04,38,46,27.625,-86.375,0,4,4
2015-04,38,47,27.625,-86.125,0,15,15
2015-04,38,48,27.625,-85.875,0,4,4
2015-04,39,26,27.875,-91.375,1,0,1
2015-05,0,56,18.125,-83.875,1,0,1
2015-05,1,44,18.375,-86.875,0,5,5
2015-05,1,45,18.375,-86.625,0,1,1
2015-05,2,54,18.625,-84.375,3,0,3
2015-05,2,55,18.625,-84.125,4,0,4
2015-05,3,52,18.875,-84.875,1,0,1
2015-05,3,53,18.875,-84.625,2,0,2
2015-05,3,54,18.875,-84.375,1,0,1
2015-05,4,51,19.125,-85.125,2,0,2
2015-05,4,52,19.125,-84.875,2,0,2
2015-05,5,50,19.375,-85.375,2,0,2
2015-05,5,51,19.375,-85.125,2,0,2
2015-05,5,63,19.375,-82.125,0,1,1
2015-05,5,64,19.375,-81.875,0,1,1
2015-05,6,47,19.625,-86.125,1,0,1
2015-05,6,48,19.625,-85.875,4,0,4
2015-05,6,49,19.625,-85.625,5,0,5
2015-05,6,50,19.625,-85.375,1,0,1
2015-05,6,62,19.625,-82.375,0,1,1
2015-05,6,63,19.625,-82.125,0,2,2
2015-05,7,57,19.875,-83.625,0,1,1
2015-05,7,61,19.875,-82.625,0,1,1
2015-05,7,62,19.875,-82.375,0,1,1
2015-05,8,57,20.125,-83.625,0,5,5
2015-05,8,58,20.125,-83.375,0,2,2
2015-05,8,60,20.125,-82.875,0,1,1
2015-05,8,61,20.125,-82.625,0,3,3
2015-05,8,69,20.125,-80.625,3,0,3
2015-05,8,70,20.125,-80.375,3,0,3
2015-05,8,71,20.125,-80.125,6,0,6
2015-05,9,58,20.375,-83.375,0,2,2
2015-05,9,59,20.375,-83.125,0,4,4
2015-05,9,60,20.375,-82.875,0,6,6
2015-05,9,67,20.375,-81.125,1,0,1
2015-05,9,68,20.375,-80.875,4,0,4
2015-05,11,55,20.875,-84.125,1,0,1
2015-05,13,16,21.375,-93.875,4,0,4
2015-05,13,17,21.375,-93.625,7,0,7
2015-05,13,18,21.375,-93.375,9,0,9
2015-05,16,7,22.125,-96.125,0,2,2
2015-05,16,8,22.125,-95.875,0,12,12
2015-05,16,9,22.125,-95.625,0,1,1
2015-05,17,9,22.375,-95.625,0,8,8
2015-05,17,10,22.375,-95.375,0,8,8
2015-05,22,28,23.625,-90.875,0,5,5
2015-05,22,49,23.625,-85.625,0,2,2
2015-05,22,51,23.625,-85.125,0,4,4
2015-05,23,50,23.875,-85.375,0,1,1
2015-05,25,48,24.375,-85.875,0,10,10
2015-05,25,49,24.375,-85.625,0,5,5
2015-05,26,39,24.625,-88.125,3,0,3
2015-05,26,40,24.625,-87.875,2,0,2
2015-05,26,48,24.625,-85.875,0,1,1
2015-05,27,36,24.875,-88.875,2,0,2
2015-05,27,37,24.875,-88.625,5,0,5
2015-05,27,38,24.875,-88.375,3,0,3
2015-05,27,39,24.875,-88.125,1,0,1
2015-05,27,40,24.875,-87.875,3,0,3
2015-05,28,35,25.125,-89.125,7,0,7
2015-05,28,36,25.125,-88.875,3,0,3
2015-05,29,10,25.375,-95.375,24,0,24
2015-05,29,11,25.375,-95.125,1,0,1
2015-05,30,10,25.625,-95.375,4,0,4
2015-05,30,11,25.625,-95.125,2,0,2
2015-05,30,43,25.625,-87.125,1,0,1
2015-05,30,51,25.625,-85.125,7,0,7
2015-05,31,29,25.875,-90.625,0,2,2
2015-05,31,43,25.875,-87.125,1,0,1
2015-05,31,51,25.875,-85.125,3,0,3
2015-05,32,28,26.125,-90.875,0,3,3
2015-05,32,29,26.125,-90.625,0,5,5
2015-05,32,30,26.125,-90.375,0,6,6
2015-05,32,51,26.125,-85.125,3,0,3
2015-05,32,52,26.125,-84.875,1,0,1
2015-05,33,16,26.375,-93.875,0,3,3
2015-05,33,17,26.375,-93.625,0,4,4
2015-05,33,30,26.375,-90.375,0,1,1
2015-05,33,31,26.375,-90.125,0,3,3
2015-05,33,33,26.375,-89.625,0,3,3
2015-05,33,34,26.375,-89.375,0,2,2
2015-05,33,43,26.375,-87.125,0,1,1
2015-05,33,48,26.375,-85.875,2,0,2
2015-05,33,50,26.375,-85.375,2,0,2
2015-05,33,51,26.375,-85.125,2,0,2
2015-05,33,52,26.375,-84.875,6,0,6
2015-05,34,17,26.625,-93.625,0,13,13
2015-05,34,18,26.625,-93.375,0,4,4
2015-05,34,32,26.625,-89.875,0,1,1
2015-05,34,33,26.625,-89.625,0,4,4
2015-05,34,34,26.625,-89.375,0,1,1
2015-05,34,43,26.625,-87.125,0,8,8
2015-05,34,44,26.625,-86.875,0,2,2
2015-05,35,17,26.875,-93.625,0,7,7
2015-05,35,44,26.875,-86.875,0,4,4
2015-05,37,36,27.375,-88.875,2,0,2
2015-05,38,36,27.625,-88.875,2,0,2
2015-05,39,26,27.875,-91.375,2,0,2
2015-05,39,27,27.875,-91.125,2,0,2
2015-05,39,28,27.875,-90.875,1,0,1
2015-05,39,36,27.875,-88.875,1,0,1
2015-05,40,28,28.125,-90.875,1,0,1
2015-05,40,29,28.125,-90.625,1,0,1
2015-05,40,30,28.125,-90.375,1,0,1
2015-05,40,31,28.125,-90.125,1,0,1
2015-05,40,32,28.125,-89.875,1,0,1
2015-05,40,33,28.125,-89.625,3,0,3
2015-05,40,35,28.125,-89.125,11,0,11
2015-05,40,36,28.125,-88.875,2,0,2
2015-06,0,60,18.125,-82.875,2,0,2
2015-06,2,70,18.625,-80.375,0,2,2
2015-06,2,71,18.625,-80.125,0,3,3
2015-06,3,68,18.875,-80.875,0,1,1
2015-06,3,69,18.875,-80.625,0,4,4
2015-06,3,70,18.875,-80.375,0,2,2
2015-06,4,67,19.125,-81.125,0,3,3
2015-06,4,68,19.125,-80.875,0,3,3
2015-06,5,45,19.375,-86.625,8,0,8
2015-06,6,45,19.625,-86.625,2,0,2
2015-06,6,46,19.625,-86.375,4,0,4
2015-06,6,47,19.625,-86.125,3,0,3
2015-06,6,50,19.625,-85.375,0,3,3
2015-06,6,51,19.625,-85.125,0,6,6
2015-06,6,52,19.625,-84.875,0,5,5
2015-06,6,53,19.625,-84.625,0,4,4
2015-06,6,54,19.625,-84.375,0,4,4
2015-06,6,55,19.625,-84.125,0,1,1
2015-06,7,55,19.875,-84.125,0,3,3
2015-06,7,56,19.875,-83.875,0,4,4
2015-06,8,59,20.125,-83.125,1,0,1
2015-06,8,64,20.125,-81.875,1,0,1
2015-06,8,65,20.125,-81.625,2,0,2
2015-06,9,62,20.375,-82.375,2,0,2
2015-06,9,63,20.375,-82.125,2,0,2
2015-06,9,64,20.375,-81.875,10,0,10
2015-06,9,65,20.375,-81.625,7,0,7
2015-06,9,67,20.375,-81.125,2,0,2
2015-06,10,21,20.625,-92.625,0,1,1
2015-06,10,22,20.625,-92.375,0,3,3
2015-06,10,69,20.625,-80.625,1,0,1
2015-06,10,70,20.625,-80.375,1,0,1
2015-06,10,71,20.625,-80.125,2,0,2
2015-06,11,19,20.875,-93.125,0,4,4
2015-06,11,20,20.875,-92.875,0,1,1
2015-06,11,21,20.875,-92.625,0,3,3
2015-06,11,22,20.875,-92.375,0,1,1
2015-06,12,15,21.125,-94.125,4,0,4
2015-06,12,19,21.125,-93.125,0,1,1
2015-06,13,15,21.375,-94.125,2,0,2
2015-06,16,6,22.125,-96.375,0,6,6
2015-06,16,7,22.125,-96.125,0,13,13
2015-06,17,6,22.375,-96.375,0,8,8
2015-06,18,6,22.625,-96.375,0,3,3
2015-06,21,16,23.375,-93.875,1,0,1
2015-06,21,23,23.375,-92.125,0,3,3
2015-06,21,24,23.375,-91.875,0,4,4
2015-06,22,15,23.625,-94.125,10,0,10
2015-06,22,16,23.625,-93.875,4,0,4
2015-06,22,24,23.625,-91.875,0,4,4
2015-06,22,25,23.625,-91.625,0,5,5
2015-06,22,26,23.625,-91.375,0,6,6
2015-06,22,27,23.625,-91.125,0,7,7
2015-06,22,28,23.625,-90.875,0,1,1
2015-06,22,56,23.625,-83.875,0,14,14
2015-06,22,57,23.625,-83.625,0,4,4
2015-06,24,47,24.125,-86.125,1,0,1
2015-06,25,47,24.375,-86.125,1,0,1
2015-06,25,48,24.375,-85.875,1,0,1
2015-06,26,48,24.625,-85.875,2,0,2
2015-06,27,48,24.875,-85.875,1,0,1
2015-06,27,49,24.875,-85.625,2,0,2
2015-06,28,10,25.125,-95.375,10,0,10
2015-06,28,35,25.125,-89.125,1,0,1
2015-06,28,49,25.125,-85.625,2,0,2
2015-06,28,50,25.125,-85.375,5,0,5
2015-06,28,51,25.125,-85.125,2,0,2
2015-06,29,9,25.375,-95.625,1,0,1
2015-06,29,10,25.375,-95.375,6,0,6
2015-06,29,11,25.375,-95.125,2,0,2
2015-06,29,51,25.375,-85.125,13,0,13
2015-06,30,9,25.625,-95.625,10,0,10
2015-06,31,9,25.875,-95.625,1,0,1
2015-06,31,26,25.875,-91.375,0,7,7
2015-06,31,27,25.875,-91.125,0,7,7
2015-06,31,34,25.875,-89.375,1,0,1
2015-06,31,35,25.875,-89.125,3,0,3
2015-06,32,16,26.125,-93.875,0,8,8
2015-06,32,27,26.125,-91.125,0,10,10
2015-06,32,28,26.125,-90.875,0,6,6
2015-06,33,16,26.375,-93.875,0,22,22
2015-06,34,43,26.625,-87.125,0,13,13
2015-06,34,44,26.625,-86.875,0,6,6
2015-06,35,44,26.875,-86.875,0,11,11
2015-06,37,36,27.375,-88.875,1,0,1
2015-07,0,54,18.125,-84.375,1,0,1
2015-07,0,56,18.125,-83.875,2,0,2
2015-07,0,59,18.125,-83.125,5,0,5
2015-07,0,60,18.125,-82.875,1,0,1
2015-07,3,64,18.875,-81.875,0,1,1
2015-07,3,65,18.875,-81.625,0,3,3
2015-07,3,66,18.875,-81.375,0,6,6
2015-07,4,62,19.125,-82.375,0,2,2
2015-07,4,63,19.125,-82.125,0,2,2
2015-07,4,64,19.125,-81.875,0,1,1
2015-07,4,66,19.125,-81.375,0,1,1
2015-07,4,67,19.125,-81.125,0,5,5
2015-07,4,71,19.125,-80.125,1,0,1
2015-07,5,59,19.375,-83.125,0,1,1
2015-07,5,60,19.375,-82.875,0,2,2
2015-07,5,61,19.375,-82.625,0,1,1
2015-07,5,71,19.375,-80.125,1,0,1
2015-07,6,48,19.625,-85.875,0,2,2
2015-07,6,49,19.625,-85.625,0,6,6
2015-07,6,50,19.625,-85.375,0,2,2
2015-07,6,56,19.625,-83.875,0,1,1
2015-07,6,57,19.625,-83.625,0,2,2
2015-07,6,58,19.625,-83.375,0,2,2
2015-07,6,59,19.625,-83.125,0,1,1
2015-07,6,71,19.625,-80.125,1,0,1
2015-07,8,15,20.125,-94.125,0,9,9
2015-07,8,16,20.125,-93.875,0,2,2
2015-07,8,49,20.125,-85.625,0,5,5
2015-07,9,18,20.375,-93.375,0,4,4
2015-07,9,19,20.375,-93.125,0,6,6
2015-07,9,49,20.375,-85.625,0,2,2
2015-07,9,54,20.375,-84.375,3,0,3
2015-07,9,71,20.375,-80.125,2,0,2
2015-07,10,19,20.625,-93.125,0,4,4
2015-07,10,49,20.625,-85.625,0,2,2
2015-07,10,54,20.625,-84.375,3,0,3
2015-07,10,71,20.625,-80.125,1,0,1
2015-07,11,19,20.875,-93.125,0,6,6
2015-07,11,49,20.875,-85.625,0,6,6
2015-07,11,54,20.875,-84.375,6,0,6
2015-07,12,49,21.125,-85.625,0,1,1
2015-07,12,54,21.125,-84.375,1,0,1
2015-07,17,6,22.375,-96.375,0,5,5
2015-07,18,6,22.625,-96.375,0,2,2
2015-07,18,11,22.625,-95.125,2,0,2
2015-07,18,12,22.625,-94.875,6,0,6
2015-07,18,13,22.625,-94.625,4,0,4
2015-07,18,14,22.625,-94.375,1,0,1
2015-07,19,6,22.875,-96.375,0,4,4
2015-07,19,13,22.875,-94.625,1,0,1
2015-07,19,14,22.875,-94.375,8,0,8
2015-07,20,6,23.125,-96.375,0,3,3
2015-07,20,14,23.125,-94.375,2,0,2
2015-07,20,44,23.125,-86.875,1,0,1
2015-07,21,6,23.375,-96.375,0,1,1
2015-07,21,14,23.375,-94.375,2,0,2
2015-07,21,19,23.375,-93.125,0,4,4
2015-07,21,20,23.375,-92.875,0,7,7
2015-07,21,21,23.375,-92.625,0,6,6
2015-07,21,22,23.375,-92.375,0,6,6
2015-07,21,23,23.375,-92.125,0,8,8
2015-07,21,42,23.375,-87.375,1,0,1
2015-07,21,43,23.375,-87.125,4,0,4
2015-07,21,44,23.375,-86.875,3,0,3
2015-07,22,6,23.625,-96.375,0,3,3
2015-07,22,15,23.625,-94.125,2,0,2
2015-07,22,41,23.625,-87.625,1,0,1
2015-07,22,42,23.625,-87.375,2,0,2
2015-07,22,43,23.625,-87.125,3,0,3
2015-07,22,57,23.625,-83.625,0,7,7
2015-07,22,58,23.625,-83.375,0,1,1
2015-07,23,45,23.875,-86.625,1,0,1
2015-07,23,46,23.875,-86.375,1,0,1
2015-07,24,6,24.125,-96.375,0,2,2
2015-07,24,7,24.125,-96.125,0,2,2
2015-07,24,46,24.125,-86.375,3,0,3
2015-07,25,7,24.375,-96.125,0,2,2
2015-07,25,8,24.375,-95.875,0,1,1
2015-07,25,37,24.375,-88.625,1,0,1
2015-07,26,8,24.625,-95.875,0,1,1
2015-07,26,9,24.625,-95.625,0,2,2
2015-07,26,36,24.625,-88.875,2,0,2
2015-07,26,54,24.625,-84.375,1,0,1
2015-07,27,10,24.875,-95.375,0,1,1
2015-07,27,36,24.875,-88.875,2,0,2
2015-07,27,54,24.875,-84.375,7,0,7
2015-07,28,54,25.125,-84.375,3,0,3
2015-07,29,34,25.375,-89.375,2,0,2
2015-07,29,35,25.375,-89.125,2,0,2
2015-07,29,53,25.375,-84.625,1,0,1
2015-07,29,54,25.375,-84.375,1,0,1
2015-07,30,8,25.625,-95.875,1,0,1
2015-07,30,33,25.625,-89.625,1,0,1
2015-07,30,34,25.625,-89.375,3,0,3
2015-07,30,53,25.625,-84.625,2,0,2
2015-07,30,54,25.625,-84.375,9,0,9
2015-07,31,9,25.875,-95.625,3,0,3
2015-07,32,9,26.125,-95.625,12,0,12
2015-07,32,19,26.125,-93.125,0,3,3
2015-07,32,20,26.125,-92.875,0,3,3
2015-07,32,21,26.125,-92.625,0,5,5
2015-07,32,22,26.125,-92.375,0,4,4
2015-07,32,23,26.125,-92.125,0,6,6
2015-07,32,24,26.125,-91.875,0,6,6
2015-07,33,9,26.375,-95.625,15,0,15
2015-07,33,19,26.375,-93.125,0,3,3
2015-07,33,20,26.375,-92.875,0,1,1
2015-07,33,41,26.375,-87.625,0,5,5
2015-07,33,42,26.375,-87.375,0,5,5
2015-07,33,43,26.375,-87.125,0,10,10
2015-07,34,43,26.625,-87.125,0,11,11
2015-07,41,22,28.375,-92.375,0,1,1
